序号,发送->接收,接收->转发,转发->接收,接收->处理,总计
1,0,50,8,16,74
2,8,16,18,16,58
3,16,34,15,19,84
5,16,34,33,17,100
6,84,18,15,18,135
7,69,18,15,18,120
9,102,14,19,15,150
11,67,14,19,15,115
12,49,14,19,15,97
13,34,14,19,15,82
14,16,14,19,15,64
15,33,15,34,19,101
16,19,15,34,19,87
17,15,34,19,15,83
18,34,34,16,21,105
19,14,34,16,21,85
22,16,21,11,19,67
23,21,30,15,18,84
24,45,18,17,15,95
25,34,18,17,15,84
26,15,18,17,15,65
27,35,15,33,18,101
30,19,14,37,15,85
33,0,19,33,16,68
34,149,15,17,17,198
35,134,15,17,17,183
37,100,15,17,17,149
39,115,34,48,20,217
40,101,34,48,20,203
43,49,34,48,20,151
44,34,34,48,20,136
45,17,34,48,20,119
46,34,31,17,20,102
47,147,37,79,18,281
49,200,19,14,18,251
51,166,19,14,18,217
52,146,19,14,18,197
53,133,19,14,18,184
54,116,19,14,18,167
56,116,18,19,15,168
58,79,18,19,15,131
60,48,18,19,15,100
61,134,18,17,16,185
62,115,18,17,16,166
63,101,18,17,16,152
64,83,18,17,16,134
65,82,33,16,19,150
67,49,33,16,19,117
68,35,33,16,19,103
69,18,33,16,19,86
70,133,34,15,19,201
71,116,34,15,19,184
72,100,34,15,19,168
73,84,34,15,19,152
75,49,34,15,19,117
76,34,34,15,19,102
77,15,34,15,19,83
79,15,34,17,16,82
81,19,33,84,15,151
82,0,33,84,15,132
83,16,32,52,15,115
84,0,32,52,15,99
88,19,15,32,19,85
89,81,34,18,17,150
90,66,34,18,17,135
92,34,34,18,17,103
93,33,16,18,17,84
94,18,16,18,17,69
96,84,15,19,15,133
97,81,34,16,19,150
98,64,34,16,19,133
100,34,34,16,19,103
101,15,34,16,19,84
102,19,15,16,19,69
103,15,35,82,18,150
104,0,35,82,18,135
105,19,31,51,18,119
106,0,31,51,18,100
108,18,15,18,18,69
109,15,36,15,16,82
111,18,31,16,18,83
112,65,34,18,16,133
113,50,34,18,16,118
114,34,34,18,16,102
115,18,34,18,16,86
116,19,15,18,16,68
117,15,34,15,19,83
118,18,16,15,19,68
120,15,19,15,18,67
122,15,18,16,15,64
124,31,35,15,19,100
125,15,35,15,19,84
126,0,35,15,19,69
128,34,31,19,18,102
129,19,31,19,18,87
130,15,16,19,18,68
131,0,16,19,18,53
132,37,31,67,15,150
134,31,34,33,15,113
135,18,34,33,15,100
136,0,34,33,15,82
138,33,34,16,15,98
140,15,19,16,15,65
142,0,31,102,5,138
143,15,102,5,29,151
144,18,84,5,29,136
146,34,31,19,16,100
148,19,31,19,16,85
149,0,31,19,16,66
151,19,16,15,19,69
152,50,30,19,18,117
153,34,30,19,18,101
154,19,30,19,18,86
157,19,18,12,21,70
158,18,33,17,14,82
159,12,21,17,14,64
160,21,31,19,17,88
161,31,36,14,17,98
162,64,17,16,16,113
163,50,17,16,16,99
164,31,17,16,16,80
165,14,17,16,16,63
166,17,32,17,19,85
168,33,19,18,15,85
169,36,33,49,16,134
170,101,16,36,14,167
171,82,16,36,14,148
172,64,16,36,14,130
173,49,16,36,14,115
174,84,31,17,16,148
175,70,31,17,16,134
177,36,31,17,16,100
178,19,31,17,16,83
180,17,33,17,16,83
181,17,16,17,16,66
182,121,30,49,17,217
183,105,30,49,17,201
184,88,30,49,17,184
185,84,18,49,17,168
188,31,18,49,17,115
189,45,18,16,17,96
192,83,33,19,15,150
193,65,33,19,15,132
195,51,14,19,15,99
196,100,19,15,18,152
197,84,19,15,18,136
198,65,19,15,18,117
199,51,19,15,18,103
200,32,19,15,18,84
203,15,18,16,18,67
204,34,18,16,15,83
205,16,18,16,15,65
206,18,31,19,14,82
207,50,14,88,31,183
208,34,14,88,31,167
209,19,14,88,31,152
210,80,22,129,18,249
212,50,22,129,18,219
213,32,22,129,18,201
215,22,44,85,18,169
216,12,32,85,18,147
217,32,35,50,18,135
218,64,18,16,18,116
220,32,18,16,18,84
221,16,18,16,18,68
225,0,34,132,15,181
226,32,19,99,15,165
228,0,19,99,15,133
229,33,31,35,15,114
230,18,31,35,15,99
231,167,32,47,20,266
232,152,32,47,20,251
233,136,32,47,20,235
234,116,32,47,20,215
236,86,32,47,20,185
237,69,32,47,20,168
238,52,32,47,20,151
239,35,32,47,20,134
240,35,16,47,20,118
242,83,31,35,16,165
243,67,31,35,16,149
245,35,31,35,16,117
246,20,31,35,16,102
248,15,35,16,19,85
249,19,16,16,19,70
250,32,19,15,18,84
252,170,12,19,18,219
253,151,12,19,18,200
258,71,12,19,18,120
259,51,12,19,18,100
260,36,12,19,18,85
261,80,19,16,15,130
262,63,19,16,15,113
265,14,19,16,15,64
266,19,31,36,13,99
267,31,36,13,21,101
268,33,18,13,21,85
269,18,18,13,21,70
270,18,34,51,30,133
271,13,21,51,30,115
272,0,21,51,30,102
274,17,21,12,18,68
275,21,46,34,19,120
276,12,34,34,19,99
277,18,16,34,19,87
279,19,15,167,17,218
281,82,18,67,17,184
283,47,18,67,17,149
284,32,18,67,17,134
287,17,18,32,17,84
288,18,32,17,15,82
289,16,16,17,15,64
290,33,15,19,15,82
292,0,15,19,15,49
293,34,34,15,18,101
294,15,34,15,18,82
297,15,18,19,13,65
298,37,13,85,17,152
299,19,13,85,17,134
300,13,35,50,17,115
301,35,34,250,15,334
302,18,34,250,15,317
304,16,33,217,15,281
307,15,18,184,15,232
309,32,34,118,15,199
311,53,14,85,15,167
312,36,14,85,15,150
313,19,14,85,15,133
314,14,36,49,15,114
315,16,20,49,15,100
316,20,33,16,15,84
317,16,17,16,15,64
318,17,31,119,14,181
319,16,15,119,14,164
321,35,31,53,14,133
322,17,31,53,14,115
324,13,34,19,14,80
325,18,16,19,14,67
327,19,14,36,17,86
329,36,34,16,17,103
330,18,34,16,17,85
332,17,33,16,17,83
334,17,33,15,16,81
335,16,17,15,16,64
336,17,31,17,16,81
337,15,16,17,16,64
338,84,33,49,16,182
339,284,19,132,16,451
341,251,19,132,16,418
342,233,19,132,16,400
343,216,19,132,16,383
345,183,19,132,16,350
346,167,19,132,16,334
347,151,19,132,16,318
348,134,19,132,16,301
350,99,19,132,16,266
351,81,19,132,16,248
353,48,19,132,16,215
354,32,19,132,16,199
355,37,32,100,16,185
356,19,32,100,16,167
357,14,18,100,16,148
360,16,33,34,16,99
361,83,16,18,15,132
362,65,16,18,15,114
365,16,16,18,15,65
367,33,35,17,18,103
369,0,35,17,18,70
370,20,35,14,18,87
371,35,32,50,15,132
373,14,18,50,15,97
375,16,16,18,15,65
377,18,15,18,18,69
378,33,18,13,20,84
379,86,14,19,15,134
380,68,14,19,15,116
381,83,15,16,18,132
384,82,35,83,13,213
386,49,35,83,13,180
389,35,31,52,13,131
390,32,18,52,13,115
391,13,18,52,13,96
392,18,33,19,13,83
393,82,16,52,17,167
394,64,16,52,17,149
395,49,16,52,17,134
396,30,16,52,17,115
397,17,16,52,17,102
399,22,47,17,15,101
400,0,47,17,15,79
401,18,17,17,15,67
402,0,17,17,15,49
403,17,15,19,16,67
404,34,16,48,18,116
406,0,16,48,18,82
407,0,31,17,18,66
408,15,35,16,20,86
409,35,36,30,18,119
410,34,20,30,18,102
413,15,15,35,17,82
414,15,35,17,16,83
415,18,17,17,16,68
416,0,17,17,16,50
417,17,16,16,15,64
419,31,35,33,19,118
420,15,35,33,19,102
421,20,15,33,19,87
424,0,17,34,16,67
425,19,15,31,19,84
426,131,18,16,15,180
427,116,18,16,15,165
428,100,18,16,15,149
429,85,18,16,15,134
430,66,18,16,15,115
431,51,18,16,15,100
432,34,18,16,15,83
434,18,31,84,16,149
435,31,34,50,16,131
436,15,34,50,16,115
437,16,18,50,16,100
438,18,35,31,20,104
439,19,16,31,20,86
440,16,31,35,15,97
442,16,35,15,16,82
443,0,35,15,16,66
444,15,31,18,18,82
445,15,16,18,18,67
447,87,15,16,19,137
448,69,15,16,19,119
449,165,36,47,19,267
450,149,36,47,19,251
451,216,19,15,16,266
452,197,19,15,16,247
453,182,19,15,16,232
454,166,19,15,16,216
458,98,19,15,16,148
459,83,19,15,16,133
460,66,19,15,16,116
461,47,19,15,16,97
463,68,33,18,18,137
464,50,33,18,18,119
465,31,33,18,18,100
466,16,33,18,18,85
467,0,33,18,18,69
468,34,18,49,16,117
469,101,35,82,15,233
472,49,35,82,15,181
473,34,35,82,15,166
474,32,19,82,15,148
475,16,19,82,15,132
476,19,31,221,34,305
478,16,33,188,34,271
481,18,15,155,34,222
483,20,15,120,34,189
485,17,18,85,34,154
486,18,31,54,34,137
487,31,33,21,34,119
488,16,33,21,34,104
489,18,15,21,34,88
490,15,21,14,20,70
491,86,17,114,19,236
492,65,17,114,19,215
493,51,17,114,19,201
494,31,17,114,19,181
495,16,17,114,19,166
496,47,35,49,19,150
498,17,35,49,19,120
499,19,16,49,19,103
500,16,32,17,19,84
501,32,36,17,15,100
502,16,36,17,15,84
503,36,32,35,16,119
504,19,32,35,16,102
505,0,32,35,16,83
507,84,16,15,20,135
508,68,16,15,20,119
509,49,16,15,20,100
511,17,16,15,20,68
514,35,18,182,16,251
515,33,32,150,16,231
517,16,16,150,16,198
518,32,19,115,16,182
524,16,35,15,16,82
525,35,31,85,16,167
526,16,31,85,16,148
527,15,16,85,16,132
529,0,36,49,16,101
530,19,33,16,16,84
531,0,33,16,16,65
533,32,32,18,15,97
534,16,32,18,15,81
535,32,33,154,17,236
536,17,33,154,17,221
537,18,15,154,17,204
538,35,15,119,17,186
540,15,34,85,17,151
541,16,18,85,17,136
542,18,33,52,17,120
544,17,32,20,17,86
545,16,16,20,17,69
546,36,17,14,17,84
547,20,17,14,17,68
549,82,17,116,17,232
551,51,17,116,17,201
552,34,17,116,17,184
554,17,30,86,17,150
556,15,36,50,17,118
557,184,16,34,18,252
559,148,16,34,18,216
560,134,16,34,18,202
561,117,16,34,18,185
562,98,16,34,18,166
563,81,16,34,18,149
566,32,16,34,18,100
567,17,16,34,18,85
568,16,34,18,17,85
570,16,35,17,17,85
571,52,17,17,17,103
572,34,17,17,17,85
573,17,17,17,17,68
575,133,34,47,18,232
576,116,34,47,18,215
577,99,34,47,18,198
578,81,34,47,18,180
579,149,18,31,21,219
580,132,18,31,21,202
581,117,18,31,21,187
583,81,18,31,21,151
584,83,19,12,21,135
586,49,19,12,21,101
588,18,19,12,21,70
589,31,32,22,13,98
592,11,35,34,16,96
593,22,13,34,16,85
594,32,15,16,19,82
595,19,15,16,19,69
597,16,19,16,17,68
598,35,17,16,17,85
599,16,17,16,17,66
600,84,35,79,20,218
601,67,35,79,20,201
602,51,35,79,20,185
603,34,35,79,20,168
604,19,35,79,20,153
606,84,35,15,19,153
607,64,35,15,19,133
608,49,35,15,19,118
609,33,35,15,19,102
613,67,34,16,15,132
615,33,34,16,15,98
616,18,34,16,15,83
617,15,19,16,15,65
618,19,31,15,19,84
621,34,31,18,18,101
624,101,18,16,15,150
625,85,18,16,15,134
626,67,18,16,15,116
627,49,18,16,15,98
628,32,18,16,15,81
629,17,18,16,15,66
630,18,31,83,19,151
631,16,15,83,19,133
633,83,19,17,15,134
634,64,19,17,15,115
637,15,19,17,15,66
638,19,32,19,15,85
640,167,16,50,15,248
641,152,16,50,15,233
643,118,16,50,15,199
644,99,16,50,15,180
645,84,16,50,15,165
648,36,16,50,15,117
650,16,31,19,15,81
651,0,31,19,15,65
654,15,33,19,15,82
655,0,33,19,15,67
656,15,34,20,29,98
657,34,20,48,15,117
659,20,48,15,20,103
660,14,34,15,20,83
661,84,16,19,15,134
662,69,16,19,15,119
663,151,15,85,15,266
664,136,15,85,15,251
666,101,15,85,15,216
667,85,15,85,15,200
668,66,15,85,15,181
669,51,15,85,15,166
670,36,15,85,15,151
671,16,15,85,15,131
672,31,16,53,15,115
673,16,16,53,15,100
674,16,34,19,15,84
675,19,15,19,15,68
676,15,34,17,16,82
677,67,33,20,32,152
678,48,33,20,32,133
679,66,20,16,16,118
680,49,20,16,16,101
681,33,20,16,16,85
684,16,32,31,16,95
685,16,16,31,16,79
686,16,31,16,20,83
687,15,16,16,20,67
688,16,36,15,18,85
694,83,31,19,17,150
695,66,31,19,17,133
696,50,31,19,17,117
697,35,31,19,17,102
698,35,16,19,17,87
700,16,36,15,19,86
701,0,36,15,19,70
703,0,34,15,15,64
704,69,15,18,15,117
705,50,15,18,15,98
706,35,15,18,15,83
707,20,15,18,15,68
711,13,20,16,19,68
712,20,35,50,15,120
713,35,30,20,15,100
714,19,30,20,15,84
715,0,30,20,15,65
716,14,35,35,16,100
717,20,15,35,16,86
718,15,35,31,16,97
720,101,15,20,14,150
721,82,15,20,14,131
722,66,15,20,14,115
723,51,15,20,14,100
725,15,15,20,14,64
726,35,14,35,19,103
728,33,16,19,30,98
729,19,16,19,30,84
730,0,16,19,30,65
731,19,50,15,16,100
732,50,31,118,15,214
733,34,31,118,15,198
736,33,15,86,15,149
737,165,36,17,15,233
738,148,36,17,15,216
740,112,36,17,15,180
743,66,36,17,15,134
744,47,36,17,15,115
745,32,36,17,15,100
747,20,16,17,15,68
748,16,32,82,16,146
749,17,15,82,16,130
750,15,32,50,16,113
751,0,32,50,16,98
752,0,16,50,16,82
753,16,20,82,17,135
754,20,30,52,17,119
755,14,16,52,17,99
756,16,36,33,15,100
758,15,33,36,31,115
759,16,17,36,31,100
760,17,36,47,18,118
762,34,18,16,18,86
763,13,18,16,18,65
764,151,34,32,18,235
765,133,34,32,18,217
767,99,34,32,18,183
771,35,34,32,18,119
772,17,34,32,18,101
773,0,34,32,18,84
774,35,16,83,18,152
775,16,16,83,18,133
776,16,32,51,18,117
777,18,14,51,18,101
778,14,34,35,17,100
779,18,16,35,17,86
780,16,35,17,17,85
781,17,18,17,17,69
782,35,17,34,13,99
783,34,34,13,17,98
785,0,34,13,17,64
786,17,30,34,19,100
787,83,16,115,16,230
788,70,16,115,16,217
790,35,16,115,16,182
791,19,16,115,16,166
792,16,31,84,16,147
793,50,15,50,16,131
794,35,15,50,16,116
795,19,15,50,16,100
797,50,16,19,16,101
798,34,16,19,16,85
799,35,35,15,18,103
801,0,35,15,18,68
802,16,33,33,15,97
804,35,16,34,16,101
805,17,16,34,16,83
806,16,34,83,16,149
809,16,19,48,16,99
810,34,14,19,16,83
811,29,35,15,19,98
812,115,35,16,16,182
813,101,35,16,16,168
815,66,35,16,16,133
816,51,35,16,16,118
817,83,16,16,18,133
818,67,16,16,18,117
819,83,18,50,18,169
820,67,18,50,18,153
822,32,18,50,18,118
823,34,32,18,18,102
824,86,34,182,15,317
825,83,19,182,15,299
826,67,19,182,15,283
828,33,19,182,15,249
829,34,31,151,15,231
831,15,16,151,15,197
832,16,34,117,15,182
833,68,34,49,15,166
834,52,34,49,15,150
835,34,34,49,15,132
836,19,34,49,15,117
837,15,19,49,15,98
838,19,34,15,15,83
839,15,19,15,15,64
842,15,36,47,16,114
844,19,31,16,16,82
847,16,16,18,17,67
848,16,35,33,18,102
849,140,29,33,20,222
850,122,29,33,20,204
851,105,29,33,20,187
852,87,29,33,20,169
853,72,29,33,20,154
855,37,29,33,20,119
856,21,29,33,20,103
857,10,19,33,20,82
858,36,16,20,29,101
859,33,20,46,19,118
860,16,20,46,19,101
862,13,33,19,16,81
863,16,17,19,16,68
864,0,17,19,16,52
866,31,18,16,15,80
867,15,18,16,15,64
868,18,31,19,15,83
869,16,15,19,15,65
871,19,15,33,17,84
872,15,33,17,19,84
875,36,35,79,19,169
876,19,35,79,19,152
877,0,35,79,19,133
879,48,16,117,15,196
881,19,16,117,15,167
882,16,34,83,15,148
883,34,34,148,18,234
886,31,18,118,18,185
889,19,15,152,18,204
890,15,36,116,18,185
893,31,35,50,18,134
894,33,18,50,18,119
895,35,31,19,18,103
897,16,15,19,18,68
901,13,18,17,15,63
902,35,15,184,19,253
903,86,14,116,19,235
904,69,14,116,19,218
906,36,14,116,19,185
907,20,14,116,19,169
908,14,32,84,19,149
911,19,15,186,15,235
912,15,34,152,15,216
913,18,16,152,15,201
914,83,34,51,15,183
915,67,34,51,15,167
917,82,15,119,16,232
918,66,15,119,16,216
919,50,15,119,16,200
920,34,15,119,16,184
922,15,35,84,16,150
924,15,32,52,16,115
925,0,32,52,16,100
926,16,33,84,18,151
928,85,32,16,16,149
929,70,32,16,16,134
930,51,32,16,16,115
931,35,32,16,16,99
935,0,32,20,15,67
936,16,35,15,18,84
937,0,35,15,18,68
938,15,33,14,20,82
939,15,18,14,20,67
942,20,33,31,19,103
943,0,33,31,19,83
946,15,35,34,16,100
948,31,19,16,16,82
949,15,19,16,16,66
950,0,19,16,16,51
951,83,16,34,15,148
953,51,16,34,15,116
954,35,16,34,15,100
956,81,34,35,17,167
957,65,34,35,17,151
958,50,34,35,17,136
960,16,34,35,17,102
962,0,15,35,17,67
963,16,19,83,15,133
964,36,15,51,15,117
965,17,15,51,15,98
967,16,18,17,15,66
969,17,15,84,16,132
970,15,36,48,16,115
975,84,15,16,12,127
976,69,15,16,12,112
977,53,15,16,12,96
978,34,15,16,12,77
979,353,49,82,19,503
982,303,49,82,19,453
983,291,49,82,19,441
986,237,49,82,19,387
987,219,49,82,19,369
988,202,49,82,19,352
989,187,49,82,19,337
991,152,49,82,19,302
993,118,49,82,19,268
995,85,49,82,19,235
997,64,35,82,19,200
999,32,35,82,19,168
1000,14,35,82,19,150
1001,15,20,82,19,136
1002,36,16,50,19,121
1003,16,16,50,19,101
1004,31,19,16,19,85
1005,15,19,16,19,69
1006,19,35,16,16,86
1007,0,35,16,16,67
1008,35,16,32,19,102
1009,32,32,19,15,98
1011,15,17,19,15,66
1012,17,34,15,18,84
1013,85,16,15,16,132
1014,66,16,15,16,113
1017,18,16,15,16,65
1018,150,32,35,16,233
1019,134,32,35,16,217
1020,119,32,35,16,202
1021,103,32,35,16,186
1025,36,32,35,16,119
1026,33,16,35,16,100
1030,19,32,16,16,83
1031,16,16,16,16,64
1033,0,32,19,16,67
1034,16,35,32,19,102
1035,19,16,32,19,86
1036,16,32,35,15,98
1038,35,16,15,16,82
1039,35,31,19,16,101
1040,31,16,19,16,82
1042,84,32,183,17,316
1044,49,32,183,17,281
1046,15,32,183,17,247
1047,16,16,183,17,232
1048,84,35,148,19,286
1051,33,35,148,19,235
1052,31,20,148,19,218
1054,53,30,85,19,187
1055,33,30,85,19,167
1056,18,30,85,19,152
1057,17,13,85,19,134
1058,13,34,51,19,117
1059,34,33,18,19,104
1060,17,33,18,19,87
1061,16,17,18,19,70
1062,35,19,15,15,84
1063,18,19,15,15,67
1065,0,30,18,19,67
1066,33,19,16,14,82
1067,18,19,16,14,67
1069,16,14,17,17,64
1070,14,34,18,17,83
1071,17,17,18,17,69
1072,17,35,17,13,82
1073,65,34,16,17,132
1074,47,34,16,17,114
1075,30,34,16,17,97
1076,13,34,16,17,80
1077,17,17,16,17,67
1081,17,18,233,17,285
1082,18,34,199,17,268
1083,82,17,134,17,250
1084,66,17,134,17,234
1086,32,17,134,17,200
1087,48,19,98,17,182
1088,34,19,98,17,168
1089,36,33,65,17,151
1090,19,33,65,17,134
1095,33,35,16,16,100
1096,16,35,16,16,83
1097,17,18,16,16,67
1098,134,16,34,17,201
1100,100,16,34,17,167
1101,84,16,34,17,151
1102,68,16,34,17,135
1103,50,16,34,17,117
1105,19,16,34,17,86
1106,0,16,34,17,67
1109,17,16,17,17,67
1111,0,34,34,13,81
1112,17,34,13,17,81
1113,17,17,13,17,64
1114,17,30,17,16,80
1117,33,35,51,18,137
1118,16,35,51,18,120
1119,86,18,13,20,137
1120,68,18,13,20,119
1121,51,18,13,20,102
1122,35,18,13,20,86
1124,18,33,31,19,101
1125,33,31,19,15,98
1126,20,31,19,15,85
1129,19,15,16,19,69
1131,65,35,34,16,150
1132,49,35,34,16,134
1133,30,35,34,16,115
1134,13,35,34,16,98
1135,16,19,34,16,85
1136,19,34,85,13,151
1137,34,34,51,13,132
1138,84,33,18,17,152
1140,49,33,18,17,117
1141,82,17,17,15,131
1143,85,15,16,19,135
1144,65,15,16,19,115
1147,17,15,16,19,67
1148,15,35,15,19,84
1150,19,34,17,15,85
1151,34,32,15,17,98
1155,15,17,18,16,66
1156,137,16,32,16,201
1159,86,16,32,16,150
1160,70,16,32,16,134
1161,51,16,32,16,115
1162,34,16,32,16,98
1163,19,16,32,16,83
1166,17,38,14,13,82
1167,16,22,14,13,65
1168,36,13,19,14,82
1169,46,14,34,18,112
1170,32,14,34,18,98
1172,82,36,147,16,281
1173,68,36,147,16,267
1175,34,36,147,16,233
1176,16,36,147,16,215
1177,36,32,115,16,199
1178,20,32,115,16,183
1180,85,34,15,16,150
1182,50,34,15,16,115
1183,32,34,15,16,97
1186,0,16,15,16,47
1188,0,16,85,15,116
1189,17,19,49,15,100
1192,33,15,35,16,99
1193,100,31,34,16,181
1194,85,31,34,16,166
1196,50,31,34,16,131
1197,35,31,34,16,116
1198,19,31,34,16,100
1199,16,15,34,16,81
1200,100,16,16,16,148
1202,70,16,16,16,118
1204,35,16,16,16,83
1206,32,16,19,14,81
1207,16,16,19,14,65
1210,81,34,82,19,216
1212,50,34,82,19,185
1213,31,34,82,19,166
1214,15,34,82,19,150
1216,15,32,50,19,116
1218,36,15,85,16,152
1219,35,34,51,16,136
1220,15,34,51,16,116
1221,15,19,51,16,101
1222,36,15,19,16,86
1224,15,35,101,14,165
1225,0,35,101,14,150
1226,16,31,70,14,131
1227,31,35,35,14,115
1228,16,35,35,14,100
1229,18,17,35,14,84
1230,17,35,14,15,81
1233,29,23,12,16,80
1234,38,45,33,19,135
1236,12,33,33,19,97
1237,16,17,33,19,85
1238,0,17,33,19,69
1239,19,14,19,16,68
1241,0,35,17,17,69
1243,34,31,20,16,101
1245,16,15,20,16,67
1246,15,36,15,15,81
1247,20,16,15,15,66
1249,0,30,20,15,65
1250,15,35,16,19,85
1251,0,35,16,19,70
1254,19,32,16,18,85
1255,17,15,16,18,66
1256,15,34,18,16,83
1258,18,34,15,16,83
1260,16,31,22,28,97
1261,31,22,79,15,147
1263,22,47,32,15,116
1264,47,32,15,20,114
1266,101,15,19,16,151
1267,82,15,19,16,132
1269,50,15,19,16,100
1270,35,15,19,16,85
1273,35,35,15,16,101
1274,66,16,16,19,117
1275,50,16,16,19,101
1276,34,16,16,19,85
1277,15,16,16,19,66
1278,16,35,16,16,83
1279,0,35,16,16,67
1280,85,35,81,19,220
1282,50,35,81,19,185
1283,34,35,81,19,169
1284,18,35,81,19,153
1286,19,32,49,19,119
1289,166,35,16,16,233
1293,98,35,16,16,165
1294,83,35,16,16,150
1295,67,35,16,16,134
1296,66,19,16,16,117
1297,50,19,16,16,101
1298,32,19,16,16,83
1299,16,19,16,16,67
1301,16,16,32,19,83
1303,32,35,31,18,116
1305,19,16,31,18,84
1307,31,34,19,15,99
1308,16,34,19,15,84
1310,16,34,283,19,352
1313,16,17,250,19,302
1314,68,16,183,19,286
1315,51,16,183,19,269
1316,33,16,183,19,251
1317,17,16,183,19,235
1321,15,19,114,19,167
1322,19,31,83,19,152
1323,46,20,48,19,133
1324,67,15,36,14,132
1325,51,15,36,14,116
1327,16,15,36,14,81
1328,15,36,14,20,85
1329,36,34,16,13,99
1331,0,34,16,13,63
1332,0,20,16,13,49
1333,16,13,20,15,64
1334,13,35,16,18,82
1335,35,34,82,19,170
1336,115,35,16,15,181
1337,100,35,16,15,166
1338,84,35,16,15,150
1339,66,35,16,15,132
1340,85,31,37,13,166
1343,35,31,37,13,116
1344,19,31,37,13,100
1345,31,37,115,16,199
1346,15,37,115,16,183
1348,85,32,18,16,151
1349,65,32,18,16,131
1350,52,32,18,16,118
1351,32,32,18,16,98
1352,33,15,18,16,82
1353,32,34,15,21,102
1356,16,36,12,17,81
1357,15,21,12,17,65
1358,70,15,84,15,184
1359,49,15,84,15,163
1360,37,15,84,15,151
1361,20,15,84,15,134
1363,31,37,82,16,166
1364,15,37,82,16,150
1365,37,31,419,14,501
1366,18,31,419,14,482
1369,16,19,384,14,433
1370,19,32,352,14,417
1371,49,15,320,14,398
1372,33,15,320,14,382
1373,17,15,320,14,366
1375,17,18,285,14,334
1376,18,34,251,14,317
1379,35,31,185,14,265
1380,19,31,185,14,249
1381,12,19,185,14,230
1382,35,19,150,14,218
1384,19,31,119,14,183
1385,15,16,119,14,164
1386,217,34,16,18,285
1387,201,34,16,18,269
1388,184,34,16,18,252
1389,166,34,16,18,234
1390,150,34,16,18,218
1391,133,34,16,18,201
1392,116,34,16,18,184
1394,82,34,16,18,150
1395,68,34,16,18,136
1396,49,34,16,18,117
1397,69,34,13,19,135
1398,51,34,13,19,117
1400,18,34,13,19,84
1402,31,19,16,16,82
1404,35,16,19,15,85
1405,16,16,19,15,66
1406,16,34,16,22,88
1407,34,38,45,17,134
1409,0,38,45,17,100
1413,16,17,16,15,64
1414,17,31,20,16,84
1416,15,36,16,16,83
1417,20,16,16,16,68
1419,0,32,19,16,67
1420,16,35,16,19,86
1422,0,16,16,19,51
1423,16,19,82,15,132
1425,16,15,51,15,97
1426,214,34,185,15,448
1427,199,34,185,15,433
1430,148,34,185,15,382
1431,133,34,185,15,367
1434,81,34,185,15,315
1435,64,34,185,15,298
1436,48,34,185,15,282
1437,32,34,185,15,266
1438,16,34,185,15,250
1439,19,15,185,15,234
1440,32,17,151,15,215
1441,17,17,151,15,200
1442,33,16,119,15,183
1443,116,19,16,15,166
1446,68,19,16,15,118
1447,48,19,16,15,98
1448,32,19,16,15,82
1449,16,19,16,15,66
1451,16,15,36,16,83
1453,36,31,83,19,169
1456,0,15,83,19,117
1457,33,32,18,19,102
1458,16,32,18,19,85
1459,100,34,16,17,167
1460,84,34,16,17,151
1461,68,34,16,17,135
1462,50,34,16,17,117
1463,31,34,16,17,98
1465,67,34,16,16,133
1466,48,34,16,16,114
1467,33,34,16,16,99
1469,34,32,35,16,117
1471,32,35,16,18,101
1472,33,18,16,18,85
1476,32,17,51,17,117
1477,48,16,35,19,118
1479,17,16,35,19,87
1480,16,35,34,16,101
1481,18,17,34,16,85
1482,17,34,16,17,84
1483,0,34,16,17,67
1484,0,15,16,17,48
1486,0,17,17,16,50
1487,17,16,17,15,65
1488,16,32,36,16,100
1491,0,36,16,15,67
1492,20,31,133,20,204
1494,34,15,99,20,168
1495,19,15,99,20,153
1496,15,36,63,20,134
1498,20,31,32,20,103
1500,16,32,20,13,81
1501,17,15,20,13,65
1502,15,33,17,19,84
1504,0,13,17,19,49
1505,17,19,16,17,69
1508,17,32,16,16,81
1509,16,16,16,16,64
1510,16,32,17,19,84
1511,16,16,17,19,68
1512,16,36,16,16,84
1513,17,19,16,16,68
1514,19,32,16,19,86
1515,16,16,16,19,67
1516,81,36,48,20,185
1518,49,36,48,20,153
1519,30,36,48,20,134
1520,33,19,48,20,120
1521,104,33,31,16,184
1522,87,33,31,16,167
1525,36,33,31,16,116
1526,20,33,31,16,100
1527,0,33,31,16,80
1528,36,15,32,17,100
1529,131,33,17,16,197
1531,100,33,17,16,166
1532,202,18,14,16,250
1533,186,18,14,16,234
1535,153,18,14,16,201
1536,134,18,14,16,182
1538,100,18,14,16,148
1540,68,18,14,16,116
1541,52,18,14,16,100
1542,35,18,14,16,83
1543,37,30,34,16,117
1544,18,30,34,16,98
1545,0,30,34,16,80
1546,16,34,16,16,82
1547,66,36,16,16,134
1548,50,36,16,16,118
1549,32,36,16,16,100
1550,16,36,16,16,84
1552,16,32,16,19,83
1553,32,35,32,18,117
1554,16,35,32,18,101
1556,0,19,32,18,69
1557,0,32,18,16,66
1558,16,34,16,16,82
1559,50,16,42,24,132
1560,32,16,42,24,114
1561,16,16,42,24,98
1562,16,42,41,18,117
1564,34,16,17,18,85
1565,8,16,17,18,59
1567,17,18,17,15,67
1569,32,34,17,15,98
1570,33,16,17,15,81
1573,32,35,34,16,117
1574,34,16,34,16,100
1575,69,35,12,19,135
1576,50,35,12,19,116
1577,34,35,12,19,100
1578,19,35,12,19,85
1580,19,31,16,19,85
1581,12,19,16,19,66
1583,35,33,82,15,165
1586,18,34,80,17,149
1587,114,17,83,19,233
1588,99,17,83,19,218
1589,80,17,83,19,199
1590,64,17,83,19,183
1591,49,17,83,19,168
1592,32,17,83,19,151
1593,17,17,83,19,136
1594,17,21,62,19,119
1595,0,21,62,19,102
1596,81,32,84,14,211
1598,49,32,84,14,179
1599,82,16,52,14,164
1600,67,16,52,14,149
1602,31,16,52,14,113
1604,16,37,48,15,116
1607,166,32,17,15,230
1608,151,32,17,15,215
1609,137,32,17,15,201
1610,118,32,17,15,182
1611,103,32,17,15,167
1614,51,32,17,15,115
1616,32,16,17,15,80
1619,83,16,183,17,299
1621,51,16,183,17,267
1623,66,19,129,17,231
1624,51,19,129,17,216
1625,101,32,151,16,300
1626,85,32,151,16,284
1627,66,32,151,16,265
1629,33,32,151,16,232
1630,17,32,151,16,216
1632,116,34,16,16,182
1633,101,34,16,16,167
1634,82,34,16,16,148
1635,67,34,16,16,133
1636,51,34,16,16,117
1641,16,16,350,17,399
1642,16,36,314,17,383
1643,36,32,282,17,367
1644,19,32,282,17,350
1645,15,17,282,17,331
1646,17,35,247,17,316
1647,15,20,247,17,299
1648,20,30,217,17,284
1651,52,17,148,17,234
1652,35,17,148,17,217
1653,18,17,148,17,200
1654,0,17,148,17,182
1655,15,16,117,17,165
1657,33,36,48,17,134
1658,65,16,16,17,114
1659,52,16,16,17,101
1660,36,16,16,17,85
1661,16,16,16,17,65
1662,16,33,18,17,84
1664,35,17,16,16,84
1665,18,17,16,16,67
1667,16,16,16,20,68
1668,16,36,17,15,84
1670,20,32,17,16,85
1671,17,15,17,16,65
1672,15,33,32,17,97
1674,16,32,17,16,81
1675,16,16,17,16,65
1676,85,31,17,16,149
1677,69,31,17,16,133
1679,36,31,17,16,100
1680,20,31,17,16,84
1681,16,15,17,16,64
1682,32,16,18,16,82
1683,33,34,16,18,101
1684,34,16,16,18,84
1685,18,16,16,18,68
1686,16,34,17,19,86
1689,36,17,15,17,85
1691,17,46,34,15,112
1693,65,35,16,16,132
1694,48,35,16,16,115
1695,34,35,16,16,101
1696,15,35,16,16,82
1697,85,15,32,18,150
1698,70,15,32,18,135
1700,81,34,34,16,165
1701,65,34,34,16,149
1702,47,34,34,16,131
1703,32,34,34,16,116
1705,18,16,34,16,84
1707,34,34,15,19,102
1708,18,34,15,19,86
1709,34,34,16,16,100
1710,18,34,16,16,84
1711,50,16,19,16,101
1712,35,16,19,16,86
1713,16,16,19,16,67
1714,35,16,16,16,83
1715,19,16,16,16,67
1716,0,16,16,16,48
1718,81,37,33,15,166
1721,102,31,16,17,166
1722,86,31,16,17,150
1724,49,31,16,17,113
1727,15,16,16,17,64
1728,16,33,85,15,149
1729,0,33,85,15,133
1731,18,17,50,15,100
1732,17,34,16,15,82
1733,15,19,16,15,65
1734,67,18,33,16,134
1735,48,18,33,16,115
1736,32,18,33,16,99
1737,17,18,33,16,84
1738,18,33,82,19,152
1739,18,15,82,19,134
1740,49,32,35,16,132
1741,34,32,35,16,117
1742,18,32,35,16,101
1743,16,16,35,16,83
1744,32,19,16,16,83
1746,35,16,15,20,86
1748,16,35,13,20,84
1749,15,20,13,20,68
1751,0,33,16,17,66
1752,20,33,34,14,101
1753,16,17,34,14,81
1754,216,34,117,15,382
1756,182,34,117,15,348
1757,165,34,117,15,331
1758,151,34,117,15,317
1759,131,34,117,15,297
1760,116,34,117,15,282
1761,101,34,117,15,267
1764,48,34,117,15,214
1765,33,34,117,15,199
1766,17,34,117,15,183
1767,34,31,86,15,166
1768,15,31,86,15,147
1770,15,36,50,15,116
1771,20,16,50,15,101
1772,16,34,16,15,81
1774,17,31,16,19,83
1776,82,33,19,17,151
1777,67,33,19,17,136
1778,51,33,19,17,120
1779,84,17,83,17,201
1780,67,17,83,17,184
1781,52,17,83,17,169
1782,35,17,83,17,152
1783,19,17,83,17,136
1785,30,33,85,17,165
1788,15,37,48,17,117
1789,20,17,48,17,102
1790,17,30,86,16,149
1791,30,35,51,16,132
1794,17,34,17,16,84
1795,34,33,17,15,99
1796,19,33,17,15,84
1797,17,16,17,15,65
1798,33,15,19,16,83
1799,32,35,16,17,100
1800,34,16,16,17,83
1803,0,33,16,15,64
1804,17,31,20,15,83
1805,31,35,16,19,101
1807,0,35,16,19,70
1808,50,31,19,16,116
1810,19,31,19,16,85
1811,17,14,19,16,66
1812,14,35,99,15,163
1813,86,15,33,15,149
1814,67,15,33,15,130
1817,19,15,33,15,82
1819,17,16,15,16,64
1821,15,16,85,16,132
1822,16,35,50,16,117
1823,20,15,50,16,101
1825,20,14,16,16,66
1826,14,32,19,16,81
1827,16,16,19,16,67
1828,16,35,35,15,101
1829,0,35,35,15,85
1833,31,20,15,15,81
1834,16,20,15,15,66
1835,35,31,35,19,120
1837,15,16,35,19,85
1839,20,15,19,30,84
1840,184,29,17,20,250
1842,150,29,17,20,216
1845,103,29,17,20,169
1846,88,29,17,20,154
1847,70,29,17,20,136
1848,50,29,17,20,116
1849,37,29,17,20,103
1850,18,29,17,20,84
1851,96,21,66,15,198
1852,83,21,66,15,185
1853,67,21,66,15,169
1854,88,31,18,15,152
1857,87,15,51,15,168
1858,66,15,51,15,147
1860,37,15,51,15,118
1861,18,15,51,15,99
1862,31,15,20,15,81
1863,16,15,20,15,66
1864,15,35,16,19,85
1866,50,31,32,19,132
1867,35,31,32,19,117
1868,19,31,32,19,101
1869,0,31,32,19,82
1870,31,16,19,17,83
1873,19,17,16,15,67
1874,33,15,34,19,101
1876,15,34,19,16,84
1877,0,34,19,16,69
1878,15,35,16,19,85
1879,19,16,16,19,70
1880,16,35,16,15,82
1881,98,20,32,15,165
1882,82,20,32,15,149
1883,63,20,32,15,130
1885,32,20,32,15,99
1886,14,20,32,15,81
1887,20,47,16,19,102
1888,329,21,80,20,450
1891,282,21,80,20,403
1893,247,21,80,20,368
1894,231,21,80,20,352
1897,180,21,80,20,301
1898,163,21,80,20,284
1899,148,21,80,20,269
1900,133,21,80,20,254
1901,113,21,80,20,234
1902,97,21,80,20,218
1903,80,21,80,20,201
1904,64,21,80,20,185
1905,48,21,80,20,169
1906,50,30,50,20,150
1907,37,30,50,20,137
1911,20,15,15,20,70
1912,15,35,16,15,81
1913,15,20,16,15,66
1914,36,15,15,17,83
1915,31,32,20,17,100
1916,15,32,20,17,84
1919,20,17,16,15,68
1922,15,32,151,16,214
1923,16,16,151,16,199
1924,16,36,115,16,183
1925,36,31,84,16,167
1926,19,31,84,16,150
1927,82,16,153,29,280
1928,66,16,153,29,264
1929,51,16,153,29,249
1930,32,16,153,29,230
1932,33,16,120,29,198
1935,17,19,84,29,149
1936,83,20,29,21,153
1939,52,50,13,17,132
1940,86,30,16,20,152
1942,50,30,16,20,116
1943,35,30,16,20,101
1944,21,30,16,20,87
1946,84,34,33,19,170
1947,67,34,33,19,153
1948,51,34,33,19,137
1951,34,33,19,16,102
1954,16,35,33,17,101
1955,19,16,33,17,85
1956,16,33,84,16,149
1957,33,32,52,16,133
1958,34,15,52,16,117
1959,17,15,52,16,100
1960,0,15,52,16,83
1961,35,33,31,17,116
1963,17,16,31,17,81
1964,33,14,17,16,80
1966,31,16,20,16,83
1967,17,16,20,16,69
1968,16,36,16,17,85
1969,0,36,16,17,69
1973,17,20,12,16,65
1976,16,35,150,15,216
1978,50,33,82,15,180
1979,35,33,82,15,165
1980,37,16,82,15,150
1982,31,16,51,15,113
1983,115,16,52,16,199
1984,100,16,52,16,184
1985,84,16,52,16,168
1987,51,16,52,16,135
1989,170,33,15,15,233
1991,136,33,15,15,199
1992,120,33,15,15,183
1993,104,33,15,15,167
1994,84,33,15,15,147
1995,68,33,15,15,131
2000,33,15,37,19,104
2001,15,15,37,19,86
2002,15,37,19,25,96
2003,17,20,19,25,81
2005,63,21,14,18,116
2006,44,21,14,18,97
2007,33,21,14,18,86
2008,19,21,14,18,72
2013,18,17,14,18,67
2014,17,32,16,17,82
2015,32,33,17,15,97
2016,18,33,17,15,83
2018,34,15,20,15,84
2019,17,15,20,15,67
2020,15,35,16,16,82
2021,20,15,16,16,67
2022,15,32,19,15,81
2023,16,16,19,15,66
2025,0,34,35,16,85
2026,33,17,32,16,98
2027,18,17,32,16,83
2028,0,17,32,16,65
2029,81,16,53,16,166
2030,65,16,53,16,150
2031,49,16,53,16,134
2032,33,16,53,16,118
2033,17,16,53,16,102
2034,0,16,53,16,85
2035,18,15,20,16,69
2037,20,16,83,17,136
2039,33,34,33,17,117
2041,17,17,33,17,84
2042,33,17,17,16,83
2043,16,17,17,16,66
2044,17,33,17,18,85
2045,17,16,17,18,68
2046,16,35,15,16,82
2047,0,35,15,16,66
2048,18,31,35,14,98
2049,15,16,35,14,80
2050,16,35,14,17,82
2052,86,33,32,16,167
2054,53,33,32,16,134
2055,36,33,32,16,117
2056,37,16,32,16,101
2057,17,16,32,16,81
2058,16,32,16,17,81
2059,16,16,16,17,65
2060,32,17,36,16,101
2061,16,17,36,16,85
2062,17,36,16,16,85
2063,36,32,32,16,116
2065,64,32,87,16,199
2066,48,32,87,16,183
2068,15,32,87,16,150
2069,16,16,87,16,135
2070,16,34,53,16,119
2072,17,36,17,16,86
2074,37,16,14,19,86
2077,14,19,82,19,134
2079,33,32,118,18,201
2080,17,32,118,18,185
2081,17,15,118,18,168
2082,15,36,82,18,151
2083,86,15,35,17,153
2085,50,15,35,17,117
2086,36,15,35,17,103
2087,20,15,35,17,87
2088,15,35,33,15,98
2089,17,18,33,15,83
2091,0,33,31,17,81
2092,31,16,35,18,100
2093,15,16,35,18,84
2095,17,18,18,13,66
2098,13,35,15,21,84
2099,0,35,15,21,71
2100,17,36,15,14,82
2101,15,21,15,14,65
2102,0,21,15,14,50
2103,0,29,33,20,82
2104,32,15,83,19,149
2106,15,36,83,17,151
2108,32,15,52,17,116
2109,16,15,52,17,100
2110,15,35,17,17,84
2111,0,35,17,17,69
2112,19,34,32,16,101
2113,17,17,32,16,82
2114,0,17,32,16,65
2115,0,32,16,16,64
2116,15,32,19,16,82
2119,35,35,83,16,169
2120,32,19,83,16,150
2121,16,19,83,16,134
2122,35,16,51,16,118
2124,16,32,35,17,100
2125,15,17,35,17,84
2126,101,18,21,28,168
2127,84,18,21,28,151
2128,65,18,21,28,132
2129,49,18,21,28,116
2130,32,18,21,28,99
2131,17,18,21,28,84
2132,18,21,12,16,67
2133,21,44,36,16,117
2134,44,36,16,16,112
2136,16,36,16,16,84
2137,20,16,16,16,68
2138,16,32,31,20,99
2139,16,16,31,20,83
2140,0,16,31,20,67
2141,16,15,20,16,67
2142,84,32,85,16,217
2144,49,32,85,16,182
2145,33,32,85,16,166
2146,17,32,85,16,150
2147,16,16,85,16,133
2148,16,36,49,16,117
2150,33,20,16,16,85
2151,13,20,16,16,65
2153,16,16,84,16,132
2155,0,32,52,16,100
2157,16,20,16,16,68
2158,20,32,34,16,102
2159,16,16,34,16,82
2160,33,17,16,16,82
2162,17,32,22,27,98
2165,33,33,19,15,100
2166,11,33,19,15,78
2169,19,15,16,19,69
2171,83,18,48,19,168
2172,67,18,48,19,152
2173,114,19,51,16,200
2174,99,19,51,16,185
2175,82,19,51,16,168
2178,117,34,16,16,183
2179,102,34,16,16,168
2180,86,34,16,16,152
2181,67,34,16,16,133
2182,84,32,83,16,215
2183,69,32,83,16,200
2185,34,32,83,16,165
2186,19,32,83,16,150
2187,16,16,83,16,131
2188,16,32,83,23,154
2189,0,32,83,23,138
2190,16,35,48,23,122
2191,16,19,48,23,106
2192,90,28,84,16,218
2195,39,28,84,16,167
2196,32,19,84,16,151
2198,19,33,51,16,119
2199,0,33,51,16,100
2201,0,35,16,16,67
2203,16,16,17,16,65
2205,0,33,16,16,65
2206,16,32,20,15,83
2207,0,32,20,15,67
2211,83,16,17,17,133
2212,65,16,17,17,115
2213,49,16,17,17,99
2214,33,16,17,17,83
2215,16,16,17,17,66
2216,33,17,17,16,83
2217,17,17,17,16,67
2218,34,16,18,15,83
2219,17,16,18,15,66
2221,18,15,17,17,67
2222,32,17,36,16,101
2223,34,36,16,17,103
2224,17,36,16,17,86
2225,0,36,16,17,69
2228,17,32,16,15,80
2229,11,21,16,15,63
2230,37,15,36,17,105
2233,36,32,50,17,135
2234,135,15,17,20,187
2236,99,15,17,20,151
2237,84,15,17,20,136
2238,66,15,17,20,118
2240,34,15,17,20,86
2241,118,16,31,17,182
2243,86,16,31,17,150
2245,49,16,31,17,113
2246,52,31,17,20,120
2247,36,31,17,20,104
2248,16,31,17,20,84
2249,31,37,16,15,99
2250,16,37,16,15,84
2251,37,31,17,17,102
2252,20,31,17,17,85
2253,16,15,17,17,65
2255,34,33,52,13,132
2256,135,16,50,16,217
2257,118,16,50,16,200
2259,85,16,50,16,167
2261,53,16,50,16,135
2265,0,32,18,16,66
2266,33,16,17,15,81
2268,16,32,19,17,84
2270,15,36,50,15,116
2273,50,15,152,14,231
2274,34,15,152,14,215
2275,19,15,152,14,200
2276,49,32,86,14,181
2277,34,32,86,14,166
2278,16,32,86,14,148
2279,32,34,118,16,200
2280,16,34,118,16,184
2281,16,18,118,16,168
2282,18,33,85,16,152
2283,15,18,85,16,134
2284,37,14,52,16,119
2285,33,35,17,16,101
2286,14,35,17,16,82
2287,16,19,17,16,68
2289,17,16,33,19,85
2290,16,33,84,16,149
2291,0,33,84,16,133
2292,16,19,65,16,116
2293,35,33,16,16,100
2294,16,33,16,16,81
2296,17,32,32,17,98
2298,33,15,17,17,82
2299,17,15,17,17,66
2300,32,17,84,17,150
2302,17,34,50,17,118
2303,18,16,50,17,101
2305,17,17,16,17,67
2306,33,17,32,18,100
2307,16,17,32,18,83
2308,17,32,18,17,84
2309,17,15,18,17,67
2311,18,17,16,15,66
2314,15,36,15,16,82
2315,51,16,19,16,102
2316,31,16,19,16,82
2317,15,16,19,16,66
2318,16,35,16,16,83
2319,35,32,17,18,102
2320,16,32,17,18,83
2321,83,16,34,19,152
2322,67,16,34,19,136
2323,51,16,34,19,120
2324,34,16,34,19,103
2325,16,16,34,19,85
2326,36,33,46,18,133
2327,20,33,46,18,117
2330,64,17,34,16,131
2331,50,17,34,16,117
2333,18,17,34,16,85
2335,15,19,16,17,67
2336,19,33,83,16,151
2337,16,17,83,16,132
2338,35,16,49,16,116
2340,16,33,32,16,97
2341,81,17,184,16,298
2342,64,17,184,16,281
2343,48,17,184,16,265
2344,32,17,184,16,249
2345,16,17,184,16,233
2347,16,18,150,16,200
2348,18,33,117,16,184
2349,16,17,117,16,166
2350,17,34,83,16,150
2353,15,16,52,16,99
2356,85,18,197,16,316
2357,69,18,197,16,300
2358,52,18,197,16,283
2360,19,18,197,16,250
2362,15,33,149,16,213
2364,85,32,83,16,216
2365,68,32,83,16,199
2366,53,32,83,16,184
2367,37,32,83,16,168
2368,18,32,83,16,149
2369,32,32,51,16,131
2371,16,16,51,16,99
2372,16,33,34,16,99
2373,0,33,34,16,83
2374,16,34,16,16,82
2375,18,16,16,16,66
2377,32,35,16,15,98
2378,16,35,16,15,82
2379,0,35,16,15,66
2381,16,15,117,17,165
2382,34,16,82,17,149
2383,19,16,82,17,134
2384,16,35,47,17,115
2385,16,19,47,17,99
2388,16,33,18,14,81
2389,16,17,18,14,65
2390,17,32,18,18,85
2391,0,32,18,18,68
2393,36,32,17,17,102
2394,35,15,17,17,84
2395,32,34,17,17,100
2397,34,34,134,17,219
2398,17,34,134,17,202
2399,34,34,100,17,185
2400,17,34,100,17,168
2401,34,32,68,17,151
2402,17,32,68,17,134
2403,16,16,68,17,117
2404,16,34,34,17,101
2405,18,16,34,17,85
2407,17,17,17,17,68
2408,34,17,48,18,117
2409,17,17,48,18,100
2410,34,13,18,18,83
2412,49,33,50,15,147
2414,18,33,50,15,116
2415,0,33,50,15,98
2416,18,33,32,17,100
2417,0,33,32,17,82
2418,16,32,17,16,81
2419,0,32,17,16,65
2420,15,33,16,20,84
2422,16,36,85,31,168
2425,15,17,53,31,116
2426,17,33,20,31,101
2427,33,20,12,19,84
2428,36,48,15,16,115
2429,20,48,15,16,99
2430,12,36,15,16,79
2431,19,17,15,16,67
2432,32,16,17,17,82
2434,16,34,18,16,84
2435,34,34,34,16,118
2439,18,16,32,16,82
2440,16,32,35,15,98
2441,32,35,83,15,165
2442,85,33,16,15,149
2444,53,33,16,15,117
2445,34,33,16,15,98
2446,19,33,16,15,83
2450,15,36,48,15,114
2451,0,36,48,15,99
2452,35,19,13,15,82
2453,80,17,35,17,149
2454,81,35,17,16,149
2456,49,35,17,16,117
2457,34,35,17,16,102
2458,17,35,17,16,85
2460,50,33,16,17,116
2461,33,33,16,17,99
2462,16,33,16,17,82
2463,16,17,16,17,66
2465,0,33,33,16,82
2469,0,33,51,18,102
2470,17,35,16,18,86
2473,16,18,16,16,66
2474,18,32,16,16,82
2477,52,15,17,16,100
2478,36,15,17,16,84
2479,20,15,17,16,68
2480,15,33,18,16,82
2481,17,16,18,16,67
2482,34,16,17,17,84
2483,100,35,32,18,185
2484,82,35,32,18,167
2485,66,35,32,18,151
2486,84,32,116,15,247
2487,67,32,116,15,230
2488,51,32,116,15,214
2489,85,16,82,15,198
2491,50,16,82,15,163
2492,116,31,17,17,181
2493,100,31,17,17,165
2495,66,31,17,17,131
2496,50,31,17,17,115
2497,34,31,17,17,99
2502,17,36,17,16,86
2503,87,13,17,19,136
2505,131,34,33,16,214
2508,80,34,33,16,163
2510,50,34,33,16,133
2511,31,34,33,16,114
2512,13,34,33,16,96
2514,17,33,16,20,86
2515,17,16,16,20,69
2516,16,36,13,20,85
2518,20,33,14,19,86
2519,33,33,14,19,99
2520,20,33,14,19,86
2523,14,19,14,20,67
2524,100,20,16,17,153
2525,81,20,16,17,134
2526,87,33,16,15,151
2527,67,33,16,15,131
2531,33,31,18,15,97
2532,17,31,18,15,81
2534,15,33,85,17,150
2536,15,35,83,18,151
2537,19,16,83,18,136
2538,33,17,49,18,117
2540,17,33,34,17,101
2541,16,17,34,17,84
2542,84,31,52,16,183
2543,67,31,52,16,166
2544,51,31,52,16,150
2547,51,17,80,16,164
2549,20,17,80,16,133
2550,17,31,49,16,113
2552,16,33,16,16,81
2553,0,33,16,16,65
2554,48,34,17,17,116
2555,32,34,17,17,100
2556,16,34,17,17,84
2557,34,34,16,15,99
2559,17,17,16,15,65
2560,17,31,17,20,85
2561,0,31,17,20,68
2562,15,37,16,16,84
2563,17,20,16,16,69
2564,20,32,32,17,101
2566,16,32,152,17,217
2567,32,36,116,17,201
2572,16,36,49,17,118
2573,17,19,49,17,102
2574,19,33,33,17,102
2575,66,33,17,17,133
2577,33,33,17,17,100
2578,17,33,17,17,84
2579,0,33,17,17,67
2581,17,17,33,17,84
2583,33,33,82,16,164
2584,83,33,15,16,147
2586,50,33,15,16,114
2587,34,33,15,16,98
2588,17,33,15,16,81
2590,16,31,35,16,98
2591,15,16,35,16,82
2592,32,19,16,16,83
2593,16,19,16,16,67
2594,68,19,17,15,119
2595,49,19,17,15,100
2596,33,19,17,15,84
2597,17,19,17,15,68
2600,15,34,16,15,80
2602,166,16,16,19,217
2603,150,16,16,19,201
2605,119,16,16,19,170
2606,99,16,16,19,150
2607,83,16,16,19,134
2608,67,16,16,19,118
2609,51,16,16,19,102
2611,17,16,16,19,68
2612,16,35,15,16,82
2614,19,31,16,17,83
2615,82,16,55,28,181
2617,51,16,55,28,150
2618,35,16,55,28,134
2620,82,34,17,19,152
2621,66,34,17,19,136
2624,11,34,17,19,81
2625,17,17,17,19,70
2626,17,36,13,19,85
2627,17,19,13,19,68
2629,13,19,15,17,64
2630,19,32,33,15,99
2631,15,17,33,15,80
2633,17,16,15,21,69
2634,31,21,15,17,84
2635,15,21,15,17,68
2636,0,21,15,17,53
2637,32,33,17,15,97
2638,17,33,17,15,82
2639,0,33,17,15,65
2642,15,33,85,16,149
2644,84,33,135,14,266
2645,68,33,135,14,250
2646,49,33,135,14,231
2648,82,36,68,14,200
2649,64,36,68,14,182
2650,47,36,68,14,165
2652,15,36,68,14,133
2653,36,31,37,14,118
2654,18,31,37,14,100
2655,16,15,37,14,82
2656,15,37,49,16,117
2657,17,20,49,16,102
2658,20,31,18,16,85
2660,0,17,18,16,51
2661,18,16,17,16,67
2662,16,33,16,19,84
2663,33,35,17,15,100
2664,16,35,17,15,83
2666,36,15,33,16,100
2667,17,15,33,16,81
2669,17,16,16,17,66
2670,16,33,17,19,85
2673,0,36,16,17,69
2674,19,33,15,16,83
2675,0,33,15,16,64
2676,17,31,35,16,99
2677,31,35,16,16,98
2680,86,31,33,19,169
2681,67,31,33,19,150
2682,82,33,19,17,151
2683,66,33,19,17,135
2685,31,33,19,17,100
2686,15,33,19,17,84
2687,17,16,19,17,69
2688,35,17,16,17,85
2691,33,33,16,16,98
2692,17,33,16,16,82
2693,0,33,16,16,65
2694,16,32,17,16,81
2696,0,16,17,16,49
2697,17,16,219,16,268
2698,34,16,185,16,251
2699,34,32,153,16,235
2700,32,16,153,16,217
2701,16,16,153,16,201
2702,16,34,119,16,185
2703,0,34,119,16,169
2704,13,35,84,16,148
2705,101,34,50,17,202
2706,85,34,50,17,186
2709,34,34,50,17,135
2710,35,16,50,17,118
2712,16,33,34,17,100
2713,0,33,34,17,84
2714,16,34,17,14,81
2715,17,17,17,14,65
2717,48,18,49,18,133
2718,31,18,49,18,116
2719,17,18,49,18,102
2720,100,17,18,18,153
2722,64,17,18,18,117
2724,33,17,18,18,86
2725,32,36,47,17,132
2727,18,18,47,17,100
2728,82,36,47,18,183
2730,48,36,47,18,149
2735,17,13,35,16,81
2737,17,18,16,16,67
2738,18,32,20,15,85
2739,16,16,20,15,67
2740,16,35,15,18,84
2742,83,34,49,15,181
2743,102,31,83,18,234
2744,87,31,83,18,219
2745,85,15,83,18,201
2747,50,15,83,18,166
2748,35,15,83,18,151
2750,15,33,50,18,116
2752,15,34,16,18,83
2753,0,34,16,18,68
2754,19,34,16,16,85
2755,16,18,16,16,66
2757,16,16,18,15,65
2758,34,15,84,15,148
2759,18,15,84,15,132
2760,15,34,50,15,114
2761,16,18,50,15,99
2763,35,30,19,16,100
2764,19,30,19,16,84
2766,15,35,17,14,81
2767,85,15,18,17,135
2771,86,15,83,20,204
2774,34,15,83,20,152
2775,17,15,83,20,135
2776,118,21,13,30,182
2777,103,21,13,30,167
2778,85,21,13,30,149
2779,68,21,13,30,132
2780,50,21,13,30,114
2781,35,21,13,30,99
2782,20,21,13,30,84
2783,34,30,18,16,98
2784,13,30,18,16,77
2785,30,34,16,16,96
2786,48,32,83,20,183
2787,34,32,83,20,169
2788,16,32,83,20,151
2789,0,32,83,20,135
2793,17,16,15,20,68
2794,16,35,17,16,84
2795,15,20,17,16,68
2797,17,16,81,17,131
2798,33,16,48,17,114
2799,17,16,48,17,98
2800,16,31,17,17,81
2802,33,17,16,17,83
2803,17,17,16,17,67
2804,17,33,120,13,183
2805,0,33,120,13,166
2806,36,16,85,13,150
2809,36,31,18,13,98
2810,48,31,83,20,182
2811,31,31,83,20,165
2812,17,31,83,20,151
2814,13,39,80,16,148
2815,17,22,80,16,135
2816,36,15,51,16,118
2817,162,32,19,16,229
2818,148,32,19,16,215
2821,98,32,19,16,165
2822,82,32,19,16,149
2823,66,32,19,16,133
2825,32,32,19,16,99
2827,84,16,16,17,133
2828,69,16,16,17,118
2831,17,16,16,17,66
2832,102,13,83,20,218
2833,86,13,83,20,202
2834,70,13,83,20,186
2836,37,13,83,20,153
2837,53,17,46,20,136
2838,33,17,46,20,116
2839,20,17,46,20,103
2841,13,20,13,20,66
2842,20,33,13,20,86
2843,0,33,13,20,66
2844,70,16,36,31,153
2845,50,16,36,31,133
2846,37,16,36,31,120
2847,69,31,17,13,130
2848,52,31,17,13,113
2849,118,16,16,16,166
2850,99,16,16,16,147
2851,82,16,16,16,130
2852,67,16,16,16,115
2853,51,16,16,16,99
2855,21,16,16,16,69
2856,32,16,33,16,97
2857,16,16,33,16,81
2859,17,16,16,17,66
2860,16,33,19,16,84
2862,36,16,14,17,83
2863,19,16,14,17,66
2865,0,31,36,16,83
2866,33,20,16,17,86
2867,16,20,16,17,69
2869,16,17,16,15,64
2870,0,17,16,15,48
2871,16,15,16,20,67
2873,86,16,16,16,134
2874,70,16,16,16,118
2876,99,22,44,16,181
2877,83,22,44,16,165
2878,65,22,44,16,147
2879,49,22,44,16,131
2880,82,33,51,16,182
2882,49,33,51,16,149
2883,27,33,51,16,127
2886,36,16,31,17,100
2887,20,16,31,17,84
2888,16,31,17,19,83
2890,16,36,16,16,84
2892,150,33,120,16,319
2896,83,33,120,16,252
2900,148,36,17,16,217
2901,133,36,17,16,202
2903,100,36,17,16,169
2904,82,36,17,16,151
2906,84,33,17,17,151
2907,69,33,17,17,136
2909,36,33,17,17,103
2910,16,33,17,17,83
2911,0,33,17,17,67
2912,16,34,14,19,83
2913,17,17,14,19,67
2914,82,35,15,16,148
2915,65,35,15,16,131
2917,32,35,15,16,98
2918,35,19,15,16,85
2920,19,31,16,16,82
2922,84,34,17,15,150
2923,68,34,17,15,134
2924,86,32,16,19,153
2925,70,32,16,19,137
2927,34,32,16,19,101
2928,19,32,16,19,86
2929,17,15,16,19,67
2930,31,19,13,20,83
2931,35,33,17,15,100
2932,19,33,17,15,84
2933,33,32,83,17,165
2934,20,32,83,17,152
2935,32,34,49,17,132
2936,82,33,17,17,149
2938,49,33,17,17,116
2941,0,33,17,17,67
2942,17,34,17,14,82
2943,34,31,18,17,100
2944,17,31,18,17,83
2946,85,18,14,16,133
2947,71,18,14,16,119
2948,85,32,166,16,299
2949,68,32,166,16,282
2952,46,32,134,16,228
2955,17,15,134,16,182
2957,18,15,101,16,150
2958,36,50,79,19,184
2959,37,34,79,19,169
2960,32,18,79,19,148
2961,34,17,62,19,132
2962,18,17,62,19,116
2963,17,46,16,19,98
2964,62,19,18,15,114
2965,49,19,18,15,101
2966,33,19,18,15,85
2968,19,33,16,16,84
2969,0,33,16,16,65
2972,16,36,13,17,82
2974,19,30,20,17,86
2975,13,17,20,17,67
2976,17,37,17,15,86
2977,20,17,17,15,69
2978,0,17,17,15,49
2980,15,32,33,21,101
2981,16,16,33,21,86
2982,32,17,21,29,99
2983,33,21,12,17,83
2984,84,33,17,17,151
2985,67,33,17,17,134
2987,34,33,17,17,101
2989,17,16,17,17,67
2990,84,33,33,16,166
2991,68,33,33,16,150
2994,83,33,136,16,268
2995,66,33,136,16,251
2996,50,33,136,16,235
2997,33,33,136,16,218
2998,16,33,136,16,201
3000,17,33,103,16,169
3001,33,36,67,16,152
3003,170,32,16,16,234
3006,117,32,16,16,181
3007,103,32,16,16,167
3009,67,32,16,16,131
3010,51,32,16,16,115
3011,37,32,16,16,101
3012,36,16,16,16,84
3014,0,16,16,16,48
3015,32,35,31,20,118
3016,16,35,31,20,102
3019,31,35,84,13,163
3020,39,15,84,13,151
3022,15,32,52,13,112
3023,18,14,52,13,97
3024,0,14,52,13,79
3026,36,13,20,14,83
3027,18,13,20,14,65
3028,33,14,36,14,97
3029,34,36,14,18,102
3031,36,32,19,17,104
3032,17,32,19,17,85
3033,14,18,19,17,68
3035,19,17,14,16,66
3036,149,34,16,16,215
3037,132,34,16,16,198
3038,118,34,16,16,184
3040,86,34,16,16,152
3041,66,34,16,16,132
3043,34,34,16,16,100
3044,17,34,16,16,83
3045,34,32,35,16,117
3047,16,16,35,16,83
3048,33,18,16,17,84
3050,18,33,17,15,83
3051,33,32,22,26,113
3052,82,33,15,18,148
3053,65,33,15,18,131
3054,48,33,15,18,114
3056,11,33,15,18,77
3058,87,32,17,15,151
3061,36,32,17,15,100
3062,17,32,17,15,81
3063,13,19,17,15,64
3064,36,15,17,18,86
3065,84,15,34,19,152
3066,67,15,34,19,135
3068,35,15,34,19,103
3071,16,18,19,15,68
3072,18,34,15,19,86
3073,49,19,50,16,134
3074,30,19,50,16,115
3075,15,19,50,16,100
3076,19,31,19,16,85
3078,15,35,84,16,150
3079,19,16,84,16,135
3082,68,16,17,15,116
3083,53,16,17,15,101
3084,33,16,17,15,81
3085,17,16,17,15,65
3086,16,32,35,16,99
3088,15,35,82,16,148
3089,35,32,50,16,133
3090,20,32,50,16,118
3093,33,33,167,17,250
3094,14,33,167,17,231
3095,17,16,167,17,217
3097,36,32,99,17,184
3098,19,32,99,17,167
3099,17,15,99,17,148
3100,15,32,67,17,131
3101,32,35,32,17,116
3103,35,32,17,16,100
3104,19,32,17,16,84
3105,32,33,17,16,98
3106,15,33,17,16,81
3107,50,16,19,16,101
3108,33,16,19,16,84
3109,17,16,19,16,68
3110,16,35,15,17,83
3111,83,21,13,20,137
3112,64,21,13,20,118
3113,82,20,13,16,131
3114,67,20,13,16,116
3116,34,20,13,16,83
3117,13,20,13,16,62
3118,33,16,20,16,85
3119,13,16,20,16,65
3121,20,16,32,13,81
3122,16,32,13,21,82
3123,16,16,13,21,66
3125,13,21,34,17,85
3126,21,34,17,16,88
3127,101,32,18,14,165
3128,84,32,18,14,148
3129,67,32,18,14,131
3130,50,32,18,14,114
3132,17,32,18,14,81
3133,16,16,18,14,64
3134,16,32,18,15,81
3136,14,33,36,16,99
3138,15,36,16,16,83
3139,84,19,13,21,137
3140,63,19,13,21,116
3142,32,19,13,21,85
3146,104,14,16,20,154
3147,83,14,16,20,133
3149,51,14,16,20,101
3150,36,14,16,20,86
3151,19,14,16,20,69
3152,14,36,15,19,84
3153,16,20,15,19,70
3155,15,19,17,35,86
3157,79,23,13,16,131
3158,62,23,13,16,114
3159,46,23,13,16,98
3161,39,29,17,16,101
3164,33,16,16,19,84
3165,17,16,16,19,68
3167,67,33,16,16,132
3168,51,33,16,16,116
3169,32,33,16,16,97
3170,18,33,16,16,83
3172,47,34,33,19,133
3175,34,33,19,17,103
3176,14,33,19,17,83
3177,69,32,33,17,151
3178,52,32,33,17,134
3180,17,32,33,17,99
3182,32,17,17,17,83
3183,16,17,17,17,67
3184,17,34,120,31,202
3185,0,34,120,31,185
3187,82,19,19,31,151
3188,86,19,14,17,136
3189,67,19,14,17,117
3192,19,19,14,17,69
3193,19,48,16,15,98
3196,0,17,16,15,48
3199,36,32,17,15,100
3201,64,34,18,16,132
3202,48,34,18,16,116
3203,32,34,18,16,100
3204,15,34,18,16,83
3206,17,34,118,16,185
3207,34,31,87,16,168
3208,16,31,87,16,150
3211,0,33,54,16,103
3212,13,35,19,16,83
3214,16,35,15,17,83
3216,31,17,17,16,81
3217,15,17,17,16,65
3218,0,17,17,16,50
3219,33,20,15,15,83
3220,16,20,15,15,66
3221,20,47,0,16,83
3222,15,32,0,16,63
3224,85,33,16,15,149
3225,68,33,16,15,132
3226,52,33,16,15,116
3227,52,17,16,15,100
3228,32,17,16,15,80
3229,16,17,16,15,64
3231,16,15,18,16,65
3232,15,34,17,19,85
3233,0,34,17,19,70
3234,202,17,148,20,387
3235,186,17,148,20,371
3236,169,17,148,20,354
3238,136,17,148,20,321
3239,118,17,148,20,303
3241,86,17,148,20,271
3242,71,17,148,20,256
3243,51,17,148,20,236
3244,37,17,148,20,222
3245,21,17,148,20,206
3247,16,15,117,20,168
3249,35,31,51,20,137
3250,19,31,51,20,121
3252,16,34,17,20,87
3256,20,16,32,17,85
3258,13,36,15,16,80
3259,218,16,51,18,303
3262,167,16,51,18,252
3263,151,16,51,18,236
3265,117,16,51,18,202
3267,83,16,51,18,168
3269,48,16,51,18,133
3270,32,16,51,18,117
3271,16,16,51,18,101
3272,16,34,17,18,85
3273,0,34,17,18,69
3274,34,18,16,16,84
3275,17,18,16,16,67
3277,32,33,115,18,198
3278,33,16,115,18,182
3279,33,31,84,18,166
3280,16,31,84,18,149
3281,16,15,84,18,133
3282,36,48,15,18,117
3283,34,35,15,18,102
3284,13,35,15,18,81
3286,31,18,17,17,83
3287,33,34,16,15,98
3288,18,34,16,15,83
3289,0,34,16,15,65
3290,17,31,19,16,83
3291,16,15,19,16,66
3293,19,16,117,16,168
3294,16,34,83,16,149
3295,66,32,19,16,133
3296,48,32,19,16,115
3297,32,32,19,16,99
3298,15,32,19,16,82
3299,16,16,19,16,67
3300,85,33,16,16,150
3301,69,33,16,16,134
3304,31,18,16,16,81
3306,18,32,86,15,151
3307,16,16,86,15,133
3309,0,35,51,15,101
3310,67,15,17,17,116
3311,51,15,17,17,100
3312,33,15,17,17,82
3314,32,17,80,20,149
3315,17,17,80,20,134
3316,34,17,46,20,117
3317,17,17,46,20,100
3318,33,16,14,20,83
3319,66,32,85,16,199
3321,34,32,85,16,167
3322,20,32,85,16,153
3324,32,19,49,16,116
3326,35,18,15,16,84
3327,16,18,15,16,65
3328,18,31,19,32,100
3330,83,32,33,17,165
3331,67,32,33,17,149
3332,48,32,33,17,130
3333,33,32,33,17,115
3334,16,32,33,17,98
3335,82,18,17,17,134
3336,67,18,17,17,119
3342,17,33,48,17,115
3343,15,18,48,17,98
3344,18,32,16,17,83
3345,15,17,16,17,65
3346,17,33,17,15,82
3348,0,17,17,15,49
3349,0,32,18,16,66
3350,15,34,31,20,100
3352,16,31,0,20,67
3353,84,17,16,19,136
3354,67,17,16,19,119
3355,86,19,16,15,136
3356,66,19,16,15,116
3357,49,19,16,15,99
3358,33,19,16,15,83
3360,19,31,19,17,86
3362,34,17,31,17,99
3364,81,35,16,16,148
3366,49,35,16,16,116
3367,33,35,16,16,100
3368,16,35,16,16,83
3369,0,35,16,16,67
3370,16,32,16,18,82
3371,32,34,18,17,101
3372,16,34,18,17,85
3373,16,18,18,17,69
3374,18,35,33,16,102
3376,17,33,120,30,200
3377,33,32,88,30,183
3378,20,32,88,30,170
3379,0,32,88,30,150
3381,16,16,56,30,118
3383,17,19,20,30,86
3384,49,37,16,16,118
3385,30,37,16,16,99
3386,10,37,16,16,79
3387,37,32,16,15,100
3388,17,32,16,15,80
3393,19,18,115,16,168
3396,35,17,49,16,117
3397,16,17,49,16,98
3398,17,32,17,16,82
3399,15,17,17,16,65
3400,0,17,17,16,50
3401,33,33,17,19,102
3402,16,33,17,19,85
3403,0,33,17,19,69
3404,84,33,51,17,185
3406,51,33,51,17,152
3407,32,33,51,17,133
3408,16,33,51,17,117
3409,0,33,51,17,101
3410,179,36,19,17,251
3411,163,36,19,17,235
3413,130,36,19,17,202
3415,95,36,19,17,167
3417,62,36,19,17,134
3419,50,15,19,17,101
3420,34,15,19,17,85
3421,21,15,19,17,72
3422,15,36,17,17,85
3423,19,17,17,17,70
3424,34,17,49,17,117
3425,17,17,49,17,100
3427,0,29,20,17,66
3428,13,37,16,17,83
3430,17,33,14,20,84
3431,16,17,14,20,67
3432,51,30,17,19,117
3434,20,30,17,19,86
3435,14,16,17,19,66
3436,16,36,17,16,85
3438,19,33,16,15,83
3439,33,31,17,19,100
3441,16,15,17,19,67
3442,15,36,17,15,83
3443,17,19,17,15,68
3444,19,32,34,17,102
3445,17,15,34,17,83
3447,17,17,17,14,65
3448,34,14,17,16,81
3450,47,36,15,17,115
3451,33,36,15,17,101
3452,16,36,15,17,84
3453,21,15,15,17,68
3454,15,32,34,17,98
3455,15,17,34,17,83
3456,17,34,33,16,100
3458,17,33,33,17,100
3459,33,33,17,16,99
3460,32,17,17,16,82
3461,16,17,17,16,66
3462,34,16,35,15,100
3463,17,16,35,15,83
3464,51,32,17,15,115
3465,35,32,17,15,99
3466,18,32,17,15,82
3467,15,17,17,15,64
3468,0,17,17,15,49
3469,0,32,220,15,267
3470,15,37,183,15,250
3473,17,14,152,15,198
3474,98,16,52,15,181
3475,84,16,52,15,167
3477,49,16,52,15,132
3478,33,16,52,15,116
3479,17,16,52,15,100
3480,199,20,14,15,248
3484,131,20,14,15,180
3485,116,20,14,15,165
3489,49,20,14,15,98
3490,32,20,14,15,81
3491,49,15,20,17,101
3492,34,15,20,17,86
3493,14,15,20,17,66
3494,15,37,16,17,85
3495,20,17,16,17,70
3496,17,33,14,19,83
3498,17,33,17,16,83
3500,19,33,16,16,84
3502,32,16,17,15,80
3505,32,37,16,16,101
3506,15,37,16,16,84
3508,17,32,16,16,81
3509,0,32,16,16,64
3510,16,32,35,15,98
3511,82,17,20,15,134
3513,50,17,20,15,102
3515,15,17,20,15,67
3520,16,33,17,16,82
3524,16,35,16,16,83
3527,16,16,16,19,67
3529,16,19,16,16,67
3530,35,16,84,16,151
3532,16,35,49,16,116
3533,0,35,49,16,100
3534,83,33,117,16,249
3537,32,33,117,16,198
3538,16,33,117,16,182
3541,17,19,81,16,133
3542,0,19,81,16,116
3543,0,32,49,16,97
3545,117,15,18,15,165
3546,100,15,18,15,148
3547,84,15,18,15,132
3550,101,18,16,16,151
3551,82,18,16,16,132
3553,50,18,16,16,100
3554,32,18,16,16,82
3555,17,18,16,16,67
3556,18,32,16,19,85
3557,16,16,16,19,67
3558,16,35,16,15,82
3559,118,16,18,16,168
3560,102,16,18,16,152
3561,83,16,18,16,133
3563,52,16,18,16,102
3564,32,16,18,16,82
3565,16,16,18,16,66
3566,0,16,18,16,50
3567,0,34,16,16,66
3568,32,16,17,17,82
3569,32,34,18,14,98
3570,82,36,17,16,151
3571,66,36,17,16,135
3572,49,36,17,16,118
3573,32,36,17,16,101
3574,14,36,17,16,83
3575,16,20,17,16,69
3576,37,16,17,16,86
3577,164,35,83,17,299
3578,147,35,83,17,282
3579,131,35,83,17,266
3582,83,35,83,17,218
3583,87,15,83,17,202
3584,70,15,83,17,185
3586,36,15,83,17,151
3587,84,17,34,17,152
3588,64,17,34,17,132
3589,49,17,34,17,117
3590,116,34,14,18,182
3594,50,34,14,18,116
3595,33,34,14,18,99
3596,16,34,14,18,82
3597,34,32,17,16,99
3598,17,32,17,16,82
3599,32,33,17,16,98
3600,18,33,17,16,84
3601,0,33,17,16,66
3602,16,33,36,17,102
3603,17,16,36,17,86
3607,34,32,16,16,98
3608,17,32,16,16,81
3609,32,32,17,16,97
3610,82,34,115,20,251
3612,49,34,115,20,218
3613,33,34,115,20,202
3615,34,36,79,20,169
3619,13,20,46,20,99
3620,20,33,13,20,86
3621,66,34,13,19,132
3622,53,34,13,19,119
3624,20,34,13,19,86
3625,0,34,13,19,66
3627,13,19,15,19,66
3629,34,33,48,17,132
3630,33,19,48,17,117
3632,67,17,34,19,137
3633,48,17,34,19,118
3635,16,17,34,19,86
3636,34,17,19,13,83
3637,116,17,84,18,235
3638,99,17,84,18,218
3640,63,17,84,18,182
3641,50,17,84,18,169
3643,16,17,84,18,135
3644,0,17,84,18,119
3645,17,19,116,18,170
3647,14,16,86,18,134
3649,18,18,50,18,104
3650,18,32,116,19,185
3651,0,32,116,19,167
3652,15,36,80,19,150
3655,14,18,48,19,99
3657,16,19,13,19,67
3658,82,35,117,16,250
3660,50,35,117,16,218
3661,31,35,117,16,199
3663,19,16,117,16,168
3664,16,34,83,16,149
3665,34,32,51,16,133
3666,36,15,51,16,118
3667,17,15,51,16,99
3668,15,32,35,17,99
3669,0,32,35,17,84
3670,84,34,15,17,150
3671,69,34,15,17,135
3672,50,34,15,17,116
3676,16,32,16,17,81
3678,0,17,16,17,50
3679,16,17,49,17,99
3680,83,34,51,16,184
3681,66,34,51,16,167
3682,49,34,51,16,150
3683,33,34,51,16,134
3684,17,34,51,16,118
3686,16,32,85,15,148
3688,15,35,50,15,115
3689,35,37,13,15,100
3690,16,37,13,15,81
3691,0,37,13,15,65
3692,20,28,20,15,83
3693,13,15,20,15,63
3696,15,33,16,17,81
3701,0,34,17,16,67
3702,34,16,34,16,100
3703,17,16,34,16,83
3704,16,34,16,16,82
3705,34,32,16,18,100
3707,16,16,16,18,66
3708,83,33,17,16,149
3713,33,33,34,16,116
3714,33,16,34,16,99
3715,118,16,17,16,167
3716,101,16,17,16,150
3717,85,16,17,16,134
3718,67,16,17,16,116
3722,33,16,16,19,84
3723,33,35,14,18,100
3724,16,35,14,18,83
3726,167,19,50,16,252
3727,148,19,50,16,233
3729,116,19,50,16,201
3731,83,19,50,16,168
3733,50,19,50,16,135
3735,14,19,50,16,99
3737,17,15,18,16,66
3739,18,16,48,17,99
3740,31,16,17,17,81
3742,33,17,18,16,84
3743,83,19,16,17,135
3744,66,19,16,17,118
3745,84,17,34,17,152
3746,150,32,16,20,218
3749,100,32,16,20,168
3752,50,32,16,20,118
3756,16,36,83,14,149
3758,37,15,51,14,117
3759,17,15,51,14,97
3760,32,17,115,18,182
3761,34,31,84,18,167
3762,17,31,84,18,150
3763,0,31,84,18,133
3764,14,34,50,18,116
3765,0,34,50,18,102
3766,16,33,17,18,84
3767,16,17,17,18,68
3768,17,35,15,18,85
3769,17,18,15,18,68
3773,0,34,17,16,67
3774,20,33,14,20,87
3778,20,31,18,16,85
3780,35,16,17,16,84
3782,16,33,16,18,83
3783,84,16,17,16,133
3784,67,16,17,16,116
3786,35,16,17,16,84
3788,83,33,16,18,150
3789,67,33,16,18,134
3790,50,33,16,18,117
3792,49,34,33,17,133
3793,33,34,33,17,117
3794,16,34,33,17,100
3795,0,34,33,17,84
3796,18,33,17,20,88
3798,33,20,17,31,101
3799,17,20,17,31,85
3800,37,47,83,15,182
3801,17,47,83,15,162
3802,11,36,83,15,145
3803,0,36,83,15,134
3804,0,16,83,15,114
3805,32,35,150,16,233
3806,17,35,150,16,218
3807,16,19,150,16,201
3808,19,31,119,16,185
3809,16,15,119,16,166
3810,117,33,81,18,249
3812,84,33,81,18,216
3813,68,33,81,18,200
3814,51,33,81,18,183
3815,35,33,81,18,167
3816,20,33,81,18,152
3817,17,16,81,18,132
3821,15,16,83,19,133
3822,16,34,49,19,118
3823,16,18,49,19,102
3825,18,15,16,19,68
3827,16,19,31,18,84
3828,36,14,34,17,101
3830,32,16,33,17,98
3832,16,33,17,15,81
3833,0,33,17,15,65
3834,16,32,17,20,85
3836,0,15,17,20,52
3837,0,37,18,31,86
3838,20,18,130,17,185
3839,18,49,81,17,165
3841,19,18,81,17,135
3843,16,17,48,17,98
3844,33,17,15,17,82
3846,32,17,82,18,149
3847,15,17,82,18,132
3849,0,35,47,18,100
3853,33,33,19,14,99
3854,33,18,19,14,84
3855,33,33,36,14,116
3856,87,33,16,18,154
3857,83,19,16,18,136
3859,50,19,16,18,103
3860,32,19,16,18,85
3861,150,16,19,31,216
3865,83,16,19,31,149
3867,53,16,19,31,119
3868,36,16,19,31,102
3869,20,16,19,31,86
3870,16,19,78,17,130
3871,19,45,33,17,114
3873,20,14,33,17,84
3875,33,35,17,16,101
3876,12,35,17,16,80
3877,17,18,17,16,68
3879,17,16,16,16,65
3880,0,16,16,16,48
3881,16,16,35,17,84
3882,16,35,17,17,85
3884,16,34,18,13,81
3885,17,17,18,13,65
3887,0,31,85,16,132
3888,82,32,49,17,180
3889,69,32,49,17,167
3890,49,32,49,17,147
3891,33,32,49,17,131
3892,17,32,49,17,115
3894,16,33,33,17,99
3895,0,33,33,17,83
3897,16,17,17,17,67
3898,85,32,20,14,151
3899,68,32,20,14,134
3900,83,34,84,18,219
3901,66,34,84,18,202
3902,49,34,84,18,185
3903,32,34,84,18,168
3904,83,36,15,18,152
3905,67,36,15,18,136
3907,33,36,15,18,102
3911,33,34,16,16,99
3912,18,34,16,16,84
3913,0,34,16,16,66
3914,135,17,167,16,335
3915,115,17,167,16,315
3916,99,17,167,16,299
3918,66,17,167,16,266
3919,49,17,167,16,249
3921,17,17,167,16,217
3924,32,17,102,16,167
3925,33,33,69,16,151
3927,17,16,69,16,118
3928,36,16,33,16,101
3929,20,16,33,16,85
3930,16,33,16,15,80
3931,16,17,16,15,64
3932,17,31,17,18,83
3933,0,31,17,18,66
3934,15,35,81,18,149
3935,35,31,50,18,134
3936,18,31,50,18,117
3937,0,31,50,18,99
3939,37,31,83,19,170
3940,20,31,83,19,153
3941,13,18,83,19,133
3942,18,36,47,19,120
3943,166,35,14,20,235
3945,130,35,14,20,199
3946,116,35,14,20,185
3947,99,35,14,20,168
3949,64,35,14,20,133
3950,50,35,14,20,119
3951,34,35,14,20,103
3952,16,35,14,20,85
3953,83,18,15,18,134
3955,48,18,15,18,99
3956,34,18,15,18,85
3957,32,33,33,19,117
3959,33,33,85,16,167
3961,0,33,85,16,134
3962,33,13,53,16,115
3963,19,13,53,16,101
3964,13,36,33,21,103
3965,0,36,33,21,90
3966,17,33,34,15,99
3967,17,16,34,15,82
3969,21,44,19,17,101
3972,0,16,19,17,52
3974,131,17,34,16,198
3976,96,17,34,16,163
3977,80,17,34,16,147
3978,65,17,34,16,132
3979,48,17,34,16,115
3980,33,17,34,16,100
3981,17,17,34,16,84
3982,35,16,52,15,118
3984,32,16,20,15,83
3986,16,35,17,17,85
3987,20,15,17,17,69
3990,17,32,16,19,84
3991,0,32,16,19,67
3994,19,33,17,16,85
3995,17,16,17,16,66
3997,0,33,15,17,65
3999,15,17,19,14,65
4000,17,33,16,17,83
4001,19,14,16,17,66
4002,117,32,17,16,182
4003,103,32,17,16,168
4004,87,32,17,16,152
4005,70,32,17,16,135
4006,53,32,17,16,118
4008,20,32,17,16,85
4009,17,15,17,16,65
4010,15,33,16,16,80
4011,17,16,16,16,65
4013,32,34,16,17,99
4015,0,34,16,17,67
4020,85,33,16,18,152
4021,65,33,16,18,132
4022,52,33,16,18,119
4024,17,33,16,18,84
4026,17,34,16,16,83
4027,16,18,16,16,66
4029,32,35,147,17,231
4031,0,35,147,17,199
4032,32,20,113,17,182
4033,14,20,113,17,164
4035,83,16,84,16,199
4036,83,31,85,16,215
4038,51,31,85,16,183
4040,16,31,85,16,148
4041,14,17,85,16,132
4042,33,20,49,16,118
4043,85,16,17,16,134
4045,49,16,17,16,98
4046,65,16,35,16,132
4047,49,16,35,16,116
4048,33,16,35,16,100
4049,17,16,35,16,84
4050,16,35,16,16,83
4051,83,17,16,19,135
4052,67,17,16,19,119
4053,48,17,16,19,100
4054,32,17,16,19,84
4055,33,35,17,15,100
4056,84,33,17,16,150
4058,51,33,17,16,117
4060,15,33,17,16,81
4061,102,33,32,17,184
4062,85,33,32,17,167
4063,69,33,32,17,151
4064,52,33,32,17,134
4065,36,33,32,17,118
4066,20,33,32,17,102
4068,16,32,34,16,98
4071,17,17,49,17,100
4072,0,17,49,17,83
4076,17,32,17,16,82
4077,32,33,34,17,116
4079,17,16,34,17,84
4081,153,16,83,15,267
4083,119,16,83,15,233
4085,85,16,83,15,199
4086,69,16,83,15,183
4087,50,16,83,15,164
4089,17,16,83,15,131
4093,12,21,48,16,97
4095,48,16,116,20,200
4096,33,16,116,20,185
4097,18,16,116,20,170
4099,15,20,81,20,136
4100,36,16,49,20,121
4101,16,16,49,20,101
4103,33,36,14,16,99
4104,32,20,14,16,82
4105,36,30,35,17,118
4106,20,30,35,17,102
4107,0,30,35,17,82
4108,68,17,15,16,116
4109,52,17,15,16,100
4110,33,17,15,16,81
4111,17,17,15,16,65
4112,17,31,17,16,81
4113,15,16,17,16,64
4115,17,16,35,16,84
4116,36,15,16,17,84
4117,169,35,16,13,233
4118,149,35,16,13,213
4120,118,35,16,13,182
4122,82,35,16,13,146
4123,66,35,16,13,130
4124,50,35,16,13,114
4126,51,29,18,16,114
4127,35,29,18,16,98
4128,18,29,18,16,81
4129,0,29,18,16,63
4130,13,34,118,16,181
4131,18,16,118,16,168
4132,32,17,85,16,150
4133,16,17,85,16,134
4134,86,32,84,16,218
4135,69,32,84,16,201
4136,52,32,84,16,184
4137,82,17,49,16,164
4138,66,17,49,16,148
4141,18,17,49,16,100
4143,0,32,84,16,132
4145,33,34,49,16,132
4147,19,15,49,16,99
4148,15,33,16,16,80
4149,33,32,118,16,199
4150,32,16,118,16,182
4151,16,16,118,16,166
4154,32,17,51,16,116
4155,16,17,51,16,100
4157,284,17,183,19,503
4159,249,17,183,19,468
4160,233,17,183,19,452
4162,201,17,183,19,420
4163,183,17,183,19,402
4164,182,34,149,19,384
4165,167,34,149,19,369
4166,150,34,149,19,352
4167,133,34,149,19,335
4168,116,34,149,19,318
4169,100,34,149,19,302
4170,102,15,149,19,285
4171,86,15,149,19,269
4174,36,15,149,19,219
4175,19,15,149,19,202
4177,83,16,50,19,168
4179,48,16,50,19,133
4180,32,16,50,19,117
4181,33,33,17,19,102
4183,17,16,17,19,69
4184,33,19,14,17,83
4185,17,19,14,17,67
4187,14,17,152,16,199
4190,85,30,20,16,151
4191,70,30,20,16,136
4192,83,36,48,20,187
4194,46,36,48,20,150
4195,100,34,50,13,197
4196,83,34,50,13,180
4197,70,34,50,13,167
4199,34,34,50,13,131
4200,19,34,50,13,116
4203,13,16,21,13,63
4204,37,13,37,16,103
4205,21,13,37,16,87
4206,33,17,16,17,83
4208,17,33,32,15,97
4209,33,32,15,16,96
4210,17,32,15,16,80
4211,16,16,15,16,63
4213,31,36,34,17,118
4214,16,36,34,17,103
4215,20,16,34,17,87
4217,0,34,17,16,67
4218,17,33,16,17,83
4219,33,33,115,17,198
4221,16,17,115,17,165
4222,34,16,82,17,149
4223,17,16,82,17,132
4225,35,31,33,16,115
4226,16,31,33,16,96
4227,16,15,33,16,80
4228,15,33,34,18,100
4229,16,17,34,18,85
4230,17,34,18,16,85
4231,16,18,18,16,68
4232,36,16,16,17,85
4236,17,35,32,16,100
4237,16,19,32,16,83
4239,32,32,32,17,113
4240,12,32,32,17,93
4243,16,16,17,17,66
4244,16,34,84,16,150
4245,17,17,84,16,134
4246,37,16,48,16,117
4247,36,32,32,17,117
4249,16,16,32,17,81
4250,16,32,17,17,82
4251,66,20,16,16,118
4252,50,20,16,16,102
4253,34,20,16,16,86
4254,17,20,16,16,69
4255,20,49,16,16,101
4256,16,33,16,16,81
4257,16,17,16,16,65
4259,16,16,16,17,65
4260,16,33,17,17,83
4262,17,34,18,16,85
4265,34,35,13,17,99
4267,35,30,18,17,100
4268,31,17,18,17,83
4269,13,17,18,17,65
4270,17,35,81,16,149
4271,0,35,81,16,132
4272,17,18,79,17,131
4274,44,35,17,17,113
4276,14,35,17,17,83
4278,33,17,36,16,102
4280,17,36,34,17,104
4281,0,36,34,17,87
4283,16,18,17,13,64
4284,35,13,17,18,83
4286,48,32,34,17,131
4287,35,32,34,17,118
4288,18,32,34,17,101
4289,0,32,34,17,83
4290,33,17,17,16,83
4293,0,33,16,21,70
4295,0,37,12,21,70
4296,21,33,48,18,120
4297,12,21,48,18,99
4298,21,30,18,18,87
4300,34,18,17,31,100
4301,18,18,17,31,84
4303,0,17,83,17,117
4308,37,13,20,14,84
4309,17,13,20,14,64
4311,85,17,84,16,202
4312,65,17,84,16,182
4315,17,17,84,16,134
4316,34,17,147,19,217
4317,17,17,147,19,200
4318,17,33,114,19,183
4320,16,33,81,19,149
4321,33,31,50,19,133
4323,18,13,50,19,100
4324,13,35,15,19,82
4326,31,19,17,15,82
4327,15,19,17,15,66
4328,19,32,33,19,103
4329,0,32,33,19,84
4331,0,33,33,18,84
4332,16,33,18,17,84
4336,86,33,48,17,184
4337,82,20,48,17,167
4338,66,20,48,17,151
4339,50,20,48,17,135
4340,34,20,48,17,119
4342,20,32,16,17,85
4343,15,17,16,17,65
4345,0,33,17,16,66
4347,0,33,82,17,132
4348,16,33,49,17,115
4349,33,33,82,18,166
4350,18,33,82,18,151
4351,17,16,82,18,133
4354,34,17,15,18,84
4357,15,18,34,15,82
4358,18,34,15,16,83
4360,17,31,17,18,83
4361,31,35,18,15,99
4362,84,32,20,17,153
4363,68,32,20,17,137
4364,51,32,20,17,120
4365,33,32,20,17,102
4366,15,32,20,17,84
4367,17,15,20,17,69
4368,149,33,19,17,218
4370,114,33,19,17,183
4371,97,33,19,17,166
4374,48,33,19,17,117
4376,13,33,19,17,82
4379,36,33,17,17,103
4380,33,17,17,17,84
4381,33,34,80,17,164
4382,17,34,80,17,148
4383,34,34,46,17,131
4385,13,21,46,17,97
4386,39,45,17,17,118
4387,63,34,17,16,130
4389,34,34,17,16,101
4390,17,34,17,16,84
4391,17,17,17,16,67
4392,34,16,34,16,100
4394,34,16,16,17,83
4397,16,17,17,16,66
4398,116,34,83,20,253
4400,82,34,83,20,219
4401,66,34,83,20,203
4404,16,34,83,20,153
4405,18,16,83,20,137
4406,16,34,49,20,119
4407,17,17,49,20,103
4408,35,17,14,20,86
4411,0,34,130,17,181
4412,20,32,98,17,167
4413,15,17,98,17,147
4414,33,16,83,16,148
4415,16,16,83,16,131
4417,16,16,51,16,99
4419,21,46,24,17,108
4420,13,33,24,17,87
4421,17,16,24,17,74
4422,0,16,24,17,57
4424,17,27,33,16,93
4425,0,27,33,16,76
4427,33,33,17,16,99
4428,17,33,17,16,83
4429,16,17,17,16,66
4430,119,32,19,13,183
4431,102,32,19,13,166
4432,85,32,19,13,149
4434,52,32,19,13,116
4435,35,32,19,13,99
4437,82,16,18,17,133
4438,66,16,18,17,117
4439,50,16,18,17,101
4442,0,16,18,17,51
4443,0,35,14,17,66
4444,0,17,14,17,48
4445,82,16,16,20,134
4446,68,16,16,20,120
4448,46,36,14,19,115
4449,34,36,14,19,103
4450,16,36,14,19,85
4451,16,20,14,19,69
4452,20,33,15,16,84
4453,33,31,16,18,98
4454,34,16,16,18,84
4455,15,16,16,18,65
4457,16,18,18,16,68
4458,36,16,15,22,89
4460,16,37,11,19,83
4461,15,22,11,19,67
4465,33,34,17,17,101
4467,17,17,17,17,68
4468,17,34,32,16,99
4469,17,17,32,16,82
4470,17,32,16,18,83
4471,16,16,16,18,66
4472,16,34,32,19,101
4473,16,18,32,19,85
4474,34,16,19,16,85
4475,16,16,19,16,67
4477,35,33,15,17,100
4480,31,17,19,16,83
4481,15,17,19,16,67
4482,0,17,19,16,52
4483,35,34,50,17,136
4484,33,17,50,17,117
4485,17,17,50,17,101
4486,165,16,20,14,215
4487,148,16,20,14,198
4488,131,16,20,14,181
4489,116,16,20,14,166
4490,98,16,20,14,148
4491,81,16,20,14,131
4492,68,16,20,14,118
4493,50,16,20,14,100
4495,116,17,33,17,183
4497,83,17,33,17,150
4498,63,17,33,17,130
4499,49,17,33,17,116
4500,29,17,33,17,96
4501,16,17,33,17,83
4502,484,33,116,16,649
4503,467,33,116,16,632
4504,447,33,116,16,612
4505,434,33,116,16,599
4506,417,33,116,16,582
4507,399,33,116,16,564
4508,382,33,116,16,547
4509,365,33,116,16,530
4510,351,33,116,16,516
4512,314,33,116,16,479
4513,300,33,116,16,465
4517,233,33,116,16,398
4518,217,33,116,16,382
4520,184,33,116,16,349
4521,165,33,116,16,330
4522,148,33,116,16,313
4523,132,33,116,16,297
4524,114,33,116,16,279
4525,97,33,116,16,262
4526,82,33,116,16,247
4527,64,33,116,16,229
4528,49,33,116,16,214
4530,15,33,116,16,180
4533,16,20,80,16,132
4536,16,18,29,16,79
4538,13,32,18,17,80
4540,16,35,17,17,85
4542,34,17,17,14,82
4543,34,31,17,20,102
4545,17,14,17,20,68
4546,14,37,16,16,83
4547,37,32,17,16,102
4548,36,16,17,16,85
4549,16,16,17,16,65
4550,0,16,17,16,49
4551,69,32,16,16,133
4552,52,32,16,16,116
4553,36,32,16,16,100
4554,18,32,16,16,82
4555,0,32,16,16,64
4556,19,32,35,16,102
4557,16,16,35,16,83
4559,0,35,16,16,67
4560,18,32,34,17,101
4561,32,34,17,17,100
4562,16,34,17,17,84
4565,83,16,84,17,200
4566,66,16,84,17,183
4567,49,16,84,17,166
4568,33,16,84,17,150
4569,32,20,81,17,150
4571,0,20,81,17,118
4572,13,34,34,17,98
4573,15,19,34,17,85
4574,85,32,21,14,152
4575,66,32,21,14,133
4576,49,32,21,14,116
4577,32,32,21,14,99
4578,33,14,21,14,82
4581,102,32,51,16,201
4582,81,32,51,16,180
4583,67,32,51,16,166
4584,115,32,34,17,198
4585,97,32,34,17,180
4587,133,33,22,28,216
4588,117,33,22,28,200
4589,101,33,22,28,184
4590,82,33,22,28,165
4591,66,33,22,28,149
4593,34,33,22,28,117
4594,16,33,22,28,99
4595,33,22,12,16,83
4596,38,46,49,15,148
4597,22,46,49,15,132
4599,16,18,49,15,98
4601,32,32,20,16,100
4603,17,15,20,16,68
4605,36,33,17,16,102
4606,66,16,16,17,115
4607,50,16,16,17,99
4608,119,33,16,18,186
4609,100,33,16,18,167
4610,83,33,16,18,150
4611,67,33,16,18,134
4612,51,33,16,18,118
4613,34,33,16,18,101
4614,16,33,16,18,83
4615,17,16,16,18,67
4616,32,18,16,16,82
4621,34,33,16,17,100
4623,16,17,16,17,66
4624,83,37,80,17,217
4625,66,37,80,17,200
4628,53,30,50,17,150
4629,37,30,50,17,134
4630,19,30,50,17,116
4631,12,18,50,17,97
4632,18,33,17,17,85
4633,33,34,16,20,103
4634,17,34,16,20,87
4635,17,17,16,20,70
4636,17,36,31,16,100
4638,20,17,14,16,67
4641,16,14,20,17,67
4642,0,14,20,17,51
4644,34,16,150,16,216
4645,49,17,117,16,199
4646,32,17,117,16,182
4647,16,17,117,16,166
4648,17,35,82,16,150
4649,18,17,82,16,133
4650,82,33,184,16,315
4652,49,33,184,16,282
4653,33,33,184,16,266
4654,16,33,184,16,249
4656,16,34,150,16,216
4657,0,34,150,16,200
4658,16,33,117,16,182
4659,0,33,117,16,166
4660,32,17,84,16,149
4662,17,35,49,16,117
4663,84,16,16,18,134
4664,68,16,16,18,118
4666,99,15,83,17,214
4667,83,15,83,17,198
4668,67,15,83,17,182
4669,100,34,15,17,166
4670,84,34,15,17,150
4671,66,34,15,17,132
4673,34,34,15,17,100
4674,18,34,15,17,84
4675,34,32,33,18,117
4676,15,32,33,18,98
4677,15,17,33,18,83
4678,17,33,18,16,84
4679,0,33,18,16,67
4680,14,34,32,22,102
4682,32,16,22,31,101
4683,16,16,22,31,85
4684,38,46,19,14,117
4686,15,31,19,14,79
4687,16,15,19,14,64
4688,84,34,17,13,148
4689,69,34,17,13,133
4690,50,34,17,13,114
4691,36,34,17,13,100
4692,18,34,17,13,82
4694,35,13,16,18,82
4695,46,18,17,17,98
4696,29,18,17,17,81
4697,16,18,17,17,68
4698,35,17,17,16,85
4701,33,35,15,15,98
4702,16,35,15,15,81
4703,17,18,15,15,65
4704,18,30,37,17,102
4705,165,32,19,15,231
4708,116,32,19,15,182
4710,81,32,19,15,147
4711,64,32,19,15,130
4714,17,32,19,15,83
4716,17,34,19,14,84
4718,15,33,35,16,99
4719,33,35,16,17,101
4721,0,35,16,17,68
4723,0,33,32,19,84
4724,33,16,36,15,100
4725,16,16,36,15,83
4726,16,36,30,19,101
4727,19,17,30,19,85
4728,0,17,30,19,66
4729,15,15,19,17,66
4731,19,17,17,15,68
4732,0,17,17,15,49
4733,0,32,18,16,66
4735,0,34,18,17,69
4737,35,33,15,18,101
4741,15,18,33,16,82
4742,0,18,33,16,67
4743,33,32,16,19,100
4745,16,16,16,19,67
4750,20,33,32,18,103
4753,32,34,16,17,99
4754,16,34,16,17,83
4759,0,35,33,13,81
4760,17,33,13,18,81
4761,16,17,13,18,64
4762,17,31,33,17,98
4763,13,18,33,17,81
4766,17,33,16,18,84
4768,16,34,16,17,83
4770,87,18,80,17,202
4771,69,18,80,17,184
4772,53,18,80,17,168
4773,36,18,80,17,151
4774,17,18,80,17,132
4775,18,47,33,17,115
4776,16,31,33,17,97
4777,16,15,33,17,81
4778,0,15,33,17,65
4779,17,16,17,16,66
4780,16,33,35,17,101
4783,18,17,33,17,85
4784,17,33,17,16,83
4785,0,33,17,16,66
4787,33,33,35,14,115
4788,16,33,35,14,98
4789,17,16,35,14,82
4791,16,19,81,16,132
4792,33,17,83,16,149
4793,48,16,83,17,164
4794,34,16,83,17,150
4795,17,16,83,17,133
4796,33,16,50,17,116
4797,17,16,50,17,100
4799,0,33,17,17,67
4804,19,33,18,13,83
4805,13,20,18,13,64
4806,20,31,35,18,104
4808,48,34,16,16,114
4810,18,34,16,16,84
4811,18,16,16,16,66
4814,16,33,82,17,148
4815,0,33,82,17,132
4816,34,19,45,17,115
4818,19,29,16,17,81
4820,16,33,18,16,83
4821,33,34,20,30,117
4823,0,34,20,30,84
4825,83,16,18,17,134
4826,63,16,18,17,114
4827,50,16,18,17,101
4828,33,16,18,17,84
4829,16,16,18,17,67
4831,18,17,16,16,67
4833,86,13,37,12,148
4834,70,13,37,12,132
4835,54,13,37,12,116
4836,38,13,37,12,100
4837,21,13,37,12,83
4838,13,37,46,16,112
4840,21,29,17,16,83
4841,46,16,34,19,115
4842,34,16,34,19,103
4845,34,35,48,19,136
4847,83,19,20,28,150
4849,87,45,34,16,182
4850,71,45,34,16,166
4853,20,45,34,16,115
4855,67,33,17,17,134
4856,51,33,17,17,118
4857,34,33,17,17,101
4859,16,17,17,17,67
4861,34,32,18,18,102
4862,34,15,18,18,85
4864,15,36,16,15,82
4867,16,15,19,14,64
4868,15,33,86,17,151
4870,14,35,51,17,117
4871,0,35,51,17,103
4872,17,33,85,14,149
4873,17,16,85,14,132
4874,34,17,80,17,148
4877,0,33,47,17,97
4881,16,17,84,17,134
4882,17,37,47,17,118
4883,0,37,47,17,101
4884,37,12,18,17,84
4885,17,12,18,17,64
4887,18,17,18,17,70
4888,17,35,33,14,99
4889,18,17,33,14,82
4890,50,32,84,17,183
4892,18,32,84,17,151
4893,0,32,84,17,133
4894,18,34,50,17,119
4895,18,16,50,17,101
4896,33,16,17,17,83
4898,16,34,84,15,149
4899,34,32,85,17,168
4900,17,32,85,17,151
4902,52,31,18,17,118
4903,36,31,18,17,102
4904,20,31,18,17,86
4906,15,35,147,17,214
4907,0,35,147,17,199
4909,0,33,114,17,164
4911,0,33,81,17,131
4912,34,17,47,17,115
4913,115,20,13,20,168
4914,98,20,13,20,151
4915,81,20,13,20,134
4917,49,20,13,20,102
4918,34,20,13,20,87
4919,17,20,13,20,70
4920,20,33,16,17,86
4921,13,20,16,17,66
4922,20,33,13,21,87
4923,0,33,13,21,67
4924,51,31,50,16,148
4925,34,31,50,16,131
4927,0,31,50,16,97
4930,16,33,83,17,149
4931,17,16,83,17,133
4932,34,15,50,17,116
4933,18,15,50,17,100
4934,15,33,17,17,82
4935,16,17,17,17,67
4937,0,34,17,17,68
4939,85,16,17,16,134
4940,84,33,17,16,150
4942,50,33,17,16,116
4943,33,33,17,16,99
4945,17,16,17,16,66
4946,16,33,33,16,98
4949,17,16,16,17,66
4951,16,17,17,17,67
4952,17,34,32,20,103
4954,34,15,20,16,85
4955,17,15,20,16,68
4956,35,16,34,12,97
4957,20,16,34,12,82
4958,16,18,16,12,62
4960,16,31,17,16,80
4962,103,19,79,20,221
4964,67,19,79,20,185
4965,51,19,79,20,169
4966,34,19,79,20,152
4967,17,19,79,20,135
4968,19,30,49,20,118
4969,99,32,149,16,296
4970,86,32,149,16,283
4972,49,32,149,16,246
4973,34,32,149,16,231
4974,20,32,149,16,217
4976,35,17,115,16,183
4977,17,17,115,16,165
4978,34,16,82,16,148
4980,16,35,98,17,166
4981,15,20,98,17,150
4982,20,31,67,17,135
4985,32,35,17,16,100
4987,0,35,17,16,68
4988,0,16,17,16,49
4989,33,33,133,16,215
4992,17,36,97,16,166
4996,16,35,80,17,148
4997,17,18,80,17,132
4998,18,17,63,17,115
4999,0,17,63,17,97
5000,29,16,18,17,80
5001,16,16,18,17,67
5002,0,16,18,17,51
5004,17,35,17,16,85
5006,16,33,34,16,99
5007,33,34,16,17,100
5010,20,33,148,20,221
5011,16,17,148,20,201
5013,98,34,68,16,216
5014,81,34,68,16,199
5018,17,34,68,16,135
5019,16,18,68,16,118
5020,86,33,34,16,169
5021,68,33,34,16,151
5022,52,33,34,16,135
5024,16,33,34,16,99
5025,16,17,34,16,83
5026,0,17,34,16,67
5027,0,34,16,17,67
5029,16,17,17,16,66
5032,16,33,81,20,150
5034,149,34,17,17,217
5035,133,34,17,17,201
5036,116,34,17,17,184
5038,84,34,17,17,152
5039,66,34,17,17,134
5040,52,34,17,17,120
5041,32,34,17,17,100
5042,15,34,17,17,83
5043,17,17,17,17,68
5044,17,34,14,19,84
5045,17,17,14,19,67
5048,50,36,14,16,116
5049,31,36,14,16,97
5050,17,36,14,16,83
5053,14,16,117,18,165
5054,33,17,83,18,151
5055,17,17,83,18,135
5056,17,35,48,18,118
5060,16,34,18,16,84
5061,16,18,18,16,68
5062,18,34,17,17,86
5064,16,34,15,17,82
5065,17,17,15,17,66
5066,17,32,16,17,82
5067,15,17,16,17,65
5068,33,17,17,17,84
5070,34,17,16,18,85
5073,148,19,17,14,198
5076,97,19,17,14,147
5077,83,19,17,14,133
5078,82,31,19,19,151
5079,68,31,19,19,137
5082,19,31,19,19,88
5083,17,14,19,19,69
5084,85,29,53,16,183
5085,71,29,53,16,169
5086,52,29,53,16,150
5087,33,29,53,16,131
5088,19,29,53,16,117
5095,17,17,14,20,68
5096,17,34,13,17,81
5098,20,30,34,18,102
5099,47,17,18,17,99
5102,35,17,17,18,87
5103,99,35,85,16,235
5104,81,35,85,16,217
5105,64,35,85,16,200
5108,16,35,85,16,152
5109,18,17,85,16,136
5110,17,22,63,16,118
5112,46,33,34,16,129
5114,35,16,34,16,101
5115,17,16,34,16,83
5116,83,34,14,17,148
5119,33,34,14,17,98
5120,34,17,14,17,82
5121,17,17,14,17,65
5122,31,17,202,14,264
5123,80,20,133,14,247
5124,66,20,133,14,233
5125,69,29,104,14,216
5126,51,29,104,14,198
5127,34,29,104,14,181
5128,20,29,104,14,167
5129,16,13,104,14,147
5131,20,17,67,14,118
5132,17,33,34,14,98
5137,14,19,33,17,83
5138,0,19,33,17,69
5139,0,33,17,16,66
5140,33,16,17,17,83
5141,17,16,17,17,67
5144,17,30,20,20,87
5145,17,13,20,20,70
5146,13,40,13,16,82
5148,20,29,33,17,99
5149,0,29,33,17,79
5150,16,33,17,16,82
5151,16,17,17,16,66
5152,17,33,201,16,267
5153,33,35,166,16,250
5154,84,35,98,16,233
5157,33,35,98,16,182
5158,33,18,98,16,165
5159,35,30,84,18,167
5160,18,30,84,18,150
5161,13,17,84,18,132
5162,17,33,51,18,119
5163,17,16,51,18,102
5164,182,36,31,20,269
5165,166,36,31,20,253
5167,131,36,31,20,218
5168,115,36,31,20,202
5169,97,36,31,20,184
5172,50,36,31,20,137
5176,16,31,36,16,99
5177,31,36,16,16,99
5178,35,16,16,16,83
5179,36,32,34,15,117
5181,32,34,15,18,99
5182,16,34,15,18,83
5183,133,32,218,17,400
5184,116,32,218,17,383
5185,99,32,218,17,366
5187,66,32,218,17,333
5188,50,32,218,17,317
5190,17,32,218,17,284
5191,0,32,218,17,267
5192,33,20,181,17,251
5193,17,20,181,17,235
5196,67,18,80,17,182
5197,53,18,80,17,168
5198,36,18,80,17,151
5199,18,18,80,17,133
5201,16,13,51,17,97
5202,0,13,51,17,81
5203,36,32,117,16,201
5205,15,17,117,16,165
5206,36,16,82,16,150
5207,215,20,33,12,280
5208,196,20,33,12,261
5209,180,20,33,12,245
5210,164,20,33,12,229
5211,148,20,33,12,213
5212,131,20,33,12,196
5215,82,20,33,12,147
5218,32,20,33,12,97
5219,12,20,33,12,77
5220,20,33,12,22,87
5221,0,33,12,22,67
5222,50,32,17,17,116
5223,34,32,17,17,100
5224,22,32,17,17,88
5225,13,19,17,17,66
5227,0,34,16,17,67
5230,34,14,19,16,83
5232,14,35,17,17,83
5233,19,16,17,17,69
5237,0,34,32,17,83
5239,32,34,51,16,133
5240,33,17,51,16,117
5241,34,35,16,16,101
5242,17,35,16,16,84
5244,34,16,16,16,82
5245,16,16,16,16,64
5246,16,32,34,16,98
5247,32,34,16,17,99
5248,33,17,16,17,83
5249,34,33,18,16,101
5251,33,34,14,18,99
5252,35,16,14,18,83
5253,18,16,14,18,66
5254,16,32,20,31,99
5256,18,20,31,17,86
5257,20,48,14,21,103
5258,14,34,14,21,83
5259,17,17,14,21,69
5260,52,35,13,18,118
5261,35,35,13,18,101
5262,21,35,13,18,87
5263,0,35,13,18,66
5266,32,18,17,17,84
5267,14,18,17,17,66
5268,18,34,17,16,85
5269,34,33,33,16,116
5271,17,16,33,16,82
5272,35,46,150,16,247
5273,19,46,150,16,231
5274,14,32,150,16,212
5275,81,18,83,16,198
5279,14,18,83,16,131
5280,34,20,47,16,117
5281,83,16,17,19,135
5285,32,36,14,19,101
5286,16,36,14,19,85
5287,0,36,14,19,69
5288,19,33,18,14,84
5289,0,33,18,14,65
5291,18,14,17,16,65
5292,14,33,33,16,96
5293,0,33,33,16,82
5295,18,15,16,23,72
5297,39,29,35,16,119
5298,23,29,35,16,103
5299,12,17,35,16,80
5302,151,32,34,17,234
5303,134,32,34,17,217
5304,118,32,34,17,201
5305,100,32,34,17,183
5306,87,32,34,17,170
5307,70,32,34,17,153
5308,50,32,34,17,133
5314,33,13,84,17,147
5315,17,13,84,17,131
5316,65,16,16,17,114
5317,52,16,16,17,101
5318,34,16,16,17,83
5319,17,16,16,17,66
5321,33,33,19,14,99
5322,34,16,19,14,83
5323,17,16,19,14,66
5324,16,33,18,16,83
5325,33,34,34,16,117
5327,0,34,34,16,84
5329,17,17,16,19,69
5331,0,35,16,17,68
5332,19,33,17,15,84
5333,0,33,17,15,65
5334,17,32,33,16,98
5338,32,16,18,17,83
5339,16,16,18,17,67
5340,34,17,32,17,100
5342,17,32,17,17,83
5343,32,34,33,17,116
5345,34,33,34,16,117
5346,17,33,34,16,100
5347,135,30,219,16,400
5349,102,30,219,16,367
5350,85,30,219,16,350
5351,68,30,219,16,333
5353,35,30,219,16,300
5354,17,30,219,16,282
5355,16,14,219,16,265
5356,0,14,219,16,249
5357,19,16,184,16,235
5358,16,34,150,16,216
5359,17,17,150,16,200
5360,33,16,118,16,183
5361,16,16,118,16,166
5362,33,17,84,16,150
5363,34,33,51,16,134
5365,117,17,17,16,167
5367,84,17,17,16,134
5368,84,33,84,18,219
5369,68,33,84,18,203
5370,101,16,50,18,185
5371,85,16,50,18,169
5373,51,16,50,18,135
5374,85,33,15,17,150
5375,69,33,15,17,134
5376,84,32,83,16,215
5378,50,32,83,16,181
5380,18,32,83,16,149
5381,82,16,17,16,131
5383,50,16,17,16,99
5384,34,16,17,16,83
5385,16,16,17,16,65
5387,0,33,18,16,67
5388,16,34,16,17,83
5390,82,34,18,17,151
5391,66,34,18,17,135
5394,16,34,18,17,85
5395,34,35,33,16,118
5397,35,33,16,18,102
5399,14,19,16,18,67
5401,16,18,14,19,67
5403,14,19,34,16,83
5406,17,30,151,16,214
5407,84,47,83,16,230
5408,115,32,51,16,214
5409,101,32,51,16,200
5412,47,32,51,16,146
5413,34,32,51,16,133
5414,17,32,51,16,116
5415,16,16,51,16,99
5416,0,16,51,16,83
5417,18,16,17,16,67
5418,16,33,17,19,85
5421,36,31,17,17,101
5422,33,17,17,17,84
5423,14,17,17,17,65
5424,17,34,17,16,84
5427,17,16,15,20,68
5428,16,35,16,17,84
5429,0,35,16,17,68
5432,33,17,17,20,87
5433,50,20,46,17,133
5434,34,20,46,17,117
5435,17,20,46,17,100
5437,63,34,17,16,130
5438,44,34,17,16,111
5439,35,34,17,16,102
5440,68,16,16,16,116
5441,51,16,16,16,99
5443,17,16,16,16,65
5444,83,34,48,15,180
5446,51,34,48,15,148
5447,35,34,48,15,132
5448,18,34,48,15,115
5449,34,32,116,16,198
5450,18,32,116,16,182
5451,32,31,85,16,164
5452,33,15,85,16,149
5453,16,15,85,16,132
5454,15,36,85,17,153
5455,85,16,20,17,138
5456,81,37,13,15,146
5457,65,37,13,15,130
5458,48,37,13,15,113
5459,114,21,47,19,201
5460,98,21,47,19,185
5461,82,21,47,19,169
5462,62,21,47,19,149
5463,45,21,47,19,132
5464,32,21,47,19,119
5465,17,21,47,19,104
5466,21,31,16,19,87
5468,15,35,83,17,150
5469,16,19,83,17,135
5470,19,34,49,17,119
5471,0,34,49,17,100
5472,21,33,33,17,104
5475,16,17,83,16,132
5476,17,31,84,17,149
5477,17,14,84,17,132
5478,49,33,16,17,115
5479,35,33,16,17,101
5480,36,16,16,17,85
5482,32,17,35,17,101
5483,16,17,35,17,85
5484,35,17,165,17,234
5485,18,17,165,17,217
5487,32,32,101,17,182
5489,16,16,101,17,150
5490,16,32,69,17,134
5491,17,15,69,17,118
5492,15,37,32,17,101
5493,37,32,17,18,104
5494,20,32,17,18,87
5495,0,32,17,18,67
5497,17,18,14,16,65
5498,118,34,20,28,200
5500,86,34,20,28,168
5502,52,34,20,28,134
5503,36,34,20,28,118
5504,17,34,20,28,99
5505,34,20,10,18,82
5506,20,20,10,18,68
5507,20,44,34,17,115
5508,44,34,17,17,112
5511,17,17,17,17,68
5512,51,32,17,19,119
5513,34,32,17,19,102
5514,17,32,17,19,85
5518,35,13,86,16,150
5519,79,19,33,17,148
5520,63,19,33,17,132
5522,120,34,47,16,217
5523,99,34,47,16,196
5524,87,34,47,16,184
5526,51,34,47,16,148
5531,0,31,32,18,81
5533,32,35,16,17,100
5534,16,35,16,17,84
5535,0,35,16,17,68
5536,17,33,17,18,85
5537,33,35,47,16,131
5538,34,18,47,16,115
5539,98,34,20,14,166
5540,81,34,20,14,149
5541,63,34,20,14,131
5543,32,34,20,14,100
5544,16,34,20,14,84
5547,20,14,33,20,87
5548,0,14,33,20,67
5551,36,33,0,14,83
5553,0,33,0,14,47
5555,14,20,82,17,133
5556,20,17,65,17,119
5557,33,33,16,17,99
5558,96,16,102,19,233
5559,80,16,102,19,217
5560,63,16,102,19,200
5561,63,35,67,19,184
5562,47,35,67,19,168
5563,30,35,67,19,151
5564,16,35,67,19,137
5567,32,35,84,16,167
5568,36,15,84,16,151
5570,165,16,84,18,283
5572,131,16,84,18,249
5573,118,16,84,18,236
5575,82,16,84,18,200
5576,66,16,84,18,184
5579,16,16,84,18,134
5580,16,35,49,18,118
5581,68,34,32,17,151
5582,50,34,32,17,133
5583,84,15,17,17,133
5584,67,15,17,17,116
5592,32,20,50,16,118
5594,20,30,36,18,104
5595,13,17,36,18,84
5596,17,36,18,17,88
5598,16,18,49,18,101
5599,35,32,18,31,116
5600,49,18,81,17,165
5601,32,18,81,17,148
5602,19,18,81,17,135
5603,18,48,33,17,116
5604,16,32,33,17,98
5605,32,33,17,16,98
5609,17,16,15,20,68
5610,16,35,17,16,84
5611,15,20,17,16,68
5613,17,16,34,16,83
5614,34,49,32,18,133
5615,18,49,32,18,117
5616,16,33,32,18,99
5617,16,17,32,18,83
5618,34,15,18,14,81
5619,32,32,86,16,166
5620,15,32,86,16,149
5621,18,14,86,16,134
5622,47,36,17,16,116
5623,33,36,17,16,102
5625,53,16,17,15,101
5626,36,16,17,15,84
5627,17,16,17,15,65
5628,33,15,85,16,149
5629,32,32,53,16,133
5630,15,32,53,16,116
5631,16,16,53,16,101
5632,16,37,16,16,85
5633,16,21,16,16,69
5634,37,16,14,20,87
5635,32,34,32,16,114
5637,66,34,34,16,150
5638,52,34,34,16,136
5639,32,34,34,16,116
5640,16,34,34,16,100
5641,34,34,16,18,102
5642,35,17,16,18,86
5643,17,17,16,18,68
5644,0,17,16,18,51
5645,34,31,16,17,98
5646,18,31,16,17,82
5647,31,33,21,28,113
5648,15,33,21,28,97
5650,17,21,12,16,66
5651,21,46,16,20,103
5652,46,36,13,16,111
5653,34,36,13,16,99
5654,34,20,13,16,83
5655,82,17,35,16,150
5656,66,17,35,16,134
5659,135,33,17,15,200
5661,101,33,17,15,166
5663,66,33,17,15,131
5664,50,33,17,15,115
5666,17,33,17,15,82
5667,16,17,17,15,65
5668,17,32,34,16,99
5669,32,34,16,20,102
5671,34,36,81,17,168
5673,0,36,81,17,134
5674,0,20,81,17,118
5675,0,18,63,17,98
5677,31,34,235,15,315
5678,16,34,235,15,300
5679,34,33,202,15,284
5680,34,16,202,15,267
5682,16,33,169,15,233
5684,17,34,135,15,201
5686,132,20,133,15,300
5687,115,20,133,15,283
5689,78,20,133,15,246
5690,65,20,133,15,233
5691,233,31,83,19,366
5692,219,31,83,19,352
5693,201,31,83,19,334
5695,167,31,83,19,300
5697,135,31,83,19,268
5698,120,31,83,19,253
5700,83,31,83,19,216
5701,70,31,83,19,203
5702,84,33,50,19,186
5703,65,33,50,19,167
5706,17,33,50,19,119
5707,16,17,50,19,102
5708,67,19,14,19,119
5710,33,19,14,19,85
5711,17,19,14,19,69
5712,19,33,33,18,103
5715,0,33,35,16,84
5716,34,17,16,16,83
5717,35,32,15,21,103
5718,17,32,15,21,85
5721,36,31,33,17,117
5723,31,33,31,19,114
5724,19,33,31,19,102
5726,35,14,36,18,103
5727,17,14,36,18,85
5728,33,17,18,13,81
5730,0,17,18,13,48
5731,0,31,16,21,68
5733,0,37,16,15,68
5734,119,34,115,19,287
5736,82,34,115,19,250
5737,67,34,115,19,235
5739,165,35,49,14,263
5741,133,35,49,14,231
5742,116,35,49,14,214
5743,99,35,49,14,197
5744,82,35,49,14,180
5745,69,35,49,14,167
5747,33,35,49,14,131
5748,15,35,49,14,113
5749,16,19,49,14,98
5750,19,32,17,14,82
5751,16,16,17,14,63
5752,16,31,36,16,99
5753,17,14,36,16,83
5754,31,19,81,22,153
5755,85,16,38,31,170
5758,33,16,38,31,118
5759,48,22,11,20,101
5760,32,22,11,20,85
5761,16,22,11,20,69
5762,152,33,16,17,218
5763,130,33,16,17,196
5765,99,33,16,17,165
5766,85,33,16,17,151
5767,68,33,16,17,134
5769,35,33,16,17,101
5770,19,33,16,17,85
5771,33,33,16,19,101
5772,32,17,16,19,84
5773,16,17,16,19,68
5774,33,19,17,13,82
5775,52,13,218,16,299
5776,36,13,218,16,283
5777,17,13,218,16,264
5778,266,14,17,17,314
5779,253,14,17,17,301
5781,217,14,17,17,265
5782,201,14,17,17,249
5783,185,14,17,17,233
5784,169,14,17,17,217
5785,152,14,17,17,200
5786,136,14,17,17,184
5788,101,14,17,17,149
5789,85,14,17,17,133
5790,69,14,17,17,117
5791,51,14,17,17,99
5793,19,14,17,17,67
5794,14,34,16,19,83
5795,34,35,167,17,253
5796,119,33,67,17,236
5797,102,33,67,17,219
5798,86,33,67,17,203
5799,67,33,67,17,184
5803,14,19,67,17,117
5804,19,32,35,17,103
5805,32,35,17,13,97
5806,16,35,17,13,81
5807,35,30,17,20,102
5809,17,13,17,20,67
5813,80,16,19,18,133
5814,63,16,19,18,116
5815,47,16,19,18,100
5816,84,18,13,17,132
5817,66,18,13,17,114
5819,37,18,13,17,85
5820,18,18,13,17,66
5821,18,48,33,18,117
5825,15,18,34,17,84
5826,0,18,34,17,69
5827,18,16,17,17,68
5828,16,34,14,17,81
5832,17,33,18,17,85
5833,0,33,18,17,68
5834,34,17,14,17,82
5835,18,17,14,17,66
5836,17,31,17,17,82
5838,17,34,19,17,87
5840,17,36,14,17,84
5841,19,17,14,17,67
5842,17,31,18,16,82
5844,17,34,34,16,101
5847,0,34,16,17,67
5848,34,17,84,16,151
5849,82,18,84,16,200
5850,66,18,84,16,184
5852,32,18,84,16,150
5853,67,31,20,16,134
5854,51,31,20,16,118
5855,33,31,20,16,100
5856,16,31,20,16,83
5857,51,16,17,17,101
5859,20,16,17,17,70
5860,16,34,81,20,151
5862,17,33,48,20,118
5863,0,33,48,20,101
5864,16,35,13,20,84
5865,17,18,13,20,68
5866,18,33,14,16,81
5867,13,20,14,16,63
5868,34,16,18,17,85
5869,48,17,17,14,96
5870,34,17,17,14,82
5871,18,17,17,14,66
5872,17,31,84,17,149
5873,0,31,84,17,132
5874,14,33,51,17,115
5875,17,16,51,17,101
5876,32,18,17,17,84
5877,34,34,18,18,104
5880,53,34,12,18,117
5881,36,34,12,18,100
5882,18,34,12,18,82
5884,21,30,17,16,84
5885,12,18,17,16,63
5887,0,33,18,16,67
5888,34,16,118,17,185
5890,16,32,86,17,151
5892,16,36,50,17,119
5895,17,16,34,15,82
5896,16,34,15,16,81
5897,199,33,17,18,267
5898,182,33,17,18,250
5899,165,33,17,18,233
5900,150,33,17,18,218
5901,134,33,17,18,202
5902,116,33,17,18,184
5903,132,35,17,16,200
5904,116,35,17,16,184
5906,101,18,17,16,152
5908,67,18,17,16,118
5909,50,18,17,16,101
5910,33,18,17,16,84
5911,17,18,17,16,68
5915,31,34,18,17,100
5916,66,17,34,14,131
5917,52,17,34,14,117
5918,32,17,34,14,97
5919,18,17,34,14,83
5920,17,34,14,16,81
5921,34,30,17,20,101
5922,20,30,17,20,87
5923,80,18,119,17,234
5924,203,17,13,20,253
5925,187,17,13,20,237
5927,150,17,13,20,200
5928,137,17,13,20,187
5930,103,17,13,20,153
5931,87,17,13,20,137
5932,67,17,13,20,117
5934,34,17,13,20,84
5935,18,17,13,20,68
5937,13,20,13,21,67
5939,0,34,14,17,65
5941,0,31,18,15,64
5942,35,15,18,16,84
5943,18,15,18,16,67
5944,33,16,14,20,83
5945,85,17,81,16,199
5946,67,17,81,16,181
5947,68,31,50,16,165
5948,54,31,50,16,151
5949,34,31,50,16,131
5950,17,31,50,16,114
5951,16,15,50,16,97
5953,34,32,86,17,169
5954,17,32,86,17,152
5955,16,16,86,17,135
5956,16,36,50,17,119
5958,35,20,17,17,89
5960,20,34,32,18,104
5962,17,32,18,17,84
5963,0,32,18,17,67
5965,0,35,16,16,67
5966,0,17,16,16,49
5967,32,33,49,16,130
5970,17,32,17,16,82
5971,0,32,17,16,65
5972,85,33,81,18,217
5973,86,16,81,18,201
5974,85,34,47,18,184
5975,69,34,47,18,168
5977,33,34,47,18,132
5978,30,20,47,18,115
5979,65,34,183,20,302
5980,51,34,183,20,288
5981,31,34,183,20,268
5982,17,34,183,20,254
5983,16,18,183,20,237
5984,18,31,152,20,221
5988,18,33,83,20,154
5990,15,32,51,20,118
5991,16,16,51,20,103
5992,16,35,36,32,119
5995,16,20,81,16,133
5998,19,18,31,16,84
