序号,发送->接收,接收->转发,转发->接收,接收->处理,总计
2,15,17,16,22,70
3,0,17,16,22,55
4,0,38,12,19,69
5,22,31,18,13,84
7,19,31,20,14,84
8,18,13,20,14,65
9,13,34,15,20,82
11,14,35,15,17,81
12,0,35,15,17,67
13,20,32,18,17,87
14,0,32,18,17,67
16,18,17,14,16,65
17,17,30,18,18,83
20,18,18,18,13,67
21,18,31,18,16,83
22,18,13,18,16,65
23,13,34,17,18,82
24,0,34,17,18,69
25,16,35,15,17,83
26,17,18,15,17,67
27,18,32,15,18,83
30,15,18,17,17,67
31,0,18,17,17,52
33,17,34,18,14,83
35,17,32,17,17,83
36,0,32,17,17,66
39,17,32,17,18,84
40,0,32,17,18,67
41,14,35,17,17,83
42,0,35,17,17,69
43,18,34,15,18,85
44,0,34,15,18,67
45,17,33,18,16,84
46,15,18,18,16,67
47,18,34,14,18,84
48,18,16,14,18,66
49,16,32,18,14,80
50,0,32,18,14,64
52,18,14,17,17,66
53,14,34,18,15,81
55,17,33,24,6,80
56,18,15,24,6,63
57,15,30,30,31,106
58,24,6,30,31,91
59,6,30,14,17,67
61,14,30,21,16,81
64,21,16,15,15,67
66,15,15,19,14,63
67,15,33,20,16,84
68,19,14,20,16,69
70,20,16,14,19,69
71,16,33,15,20,84
73,19,35,16,16,86
74,15,20,16,16,67
75,20,32,17,16,85
76,0,32,17,16,65
77,16,33,16,15,80
78,0,33,16,15,64
80,16,15,18,15,64
81,15,33,20,14,82
83,15,34,17,17,83
86,17,17,17,17,68
87,17,34,14,17,82
89,17,31,18,18,84
90,0,31,18,18,67
91,17,36,14,17,84
92,0,36,14,17,67
94,14,17,18,15,64
95,17,33,18,16,84
97,15,34,18,17,84
100,0,35,15,16,66
101,17,31,17,17,82
102,15,16,17,17,65
103,16,34,18,17,85
106,0,35,15,16,66
107,17,31,17,20,85
108,0,31,17,20,68
109,16,37,12,20,85
110,17,20,12,20,69
111,20,32,17,14,83
112,0,32,17,14,63
115,14,34,17,17,82
117,17,34,17,18,86
118,17,17,17,18,69
119,17,35,13,17,82
120,0,35,13,17,65
121,18,30,17,18,83
123,17,35,17,16,85
127,16,34,17,17,84
128,18,16,17,17,68
129,16,34,16,14,80
130,17,17,16,14,64
131,17,30,21,14,82
132,0,30,21,14,65
133,14,35,16,20,85
135,14,36,14,19,83
136,16,20,14,19,69
137,20,33,17,16,86
138,0,33,17,16,66
140,17,16,15,18,66
141,16,33,14,17,80
142,15,18,14,17,64
143,18,31,18,20,87
144,14,17,18,20,69
146,18,20,14,18,70
151,19,33,16,15,83
152,0,33,16,15,64
153,18,31,19,16,84
154,16,15,19,16,66
156,19,16,16,18,69
157,16,34,14,17,81
158,16,18,14,17,65
159,18,31,17,18,84
161,17,35,17,17,86
162,17,18,17,17,69
163,18,34,17,17,86
164,0,34,17,17,68
165,17,34,13,18,82
166,17,17,13,18,65
167,17,31,21,11,80
169,18,32,18,18,86
170,21,11,18,18,68
171,11,36,15,18,80
172,18,18,15,18,69
173,18,33,15,18,84
175,18,33,15,19,85
176,15,18,15,19,67
177,18,34,16,14,82
181,14,33,19,18,84
182,19,14,19,18,70
183,14,37,15,17,83
185,18,32,17,17,84
186,15,17,17,17,66
189,17,31,19,17,84
190,17,14,19,17,67
191,14,36,17,14,81
192,0,36,17,14,67
193,17,31,17,18,83
194,0,31,17,18,66
196,17,18,18,15,68
198,18,15,18,16,67
199,15,34,18,17,84
201,16,35,15,16,82
203,17,31,15,17,80
204,15,16,15,17,63
205,16,32,18,17,83
206,0,32,18,17,67
207,17,35,18,13,83
208,18,17,18,13,66
209,17,31,19,16,83
210,18,13,19,16,66
211,13,35,17,17,82
212,19,16,17,17,69
214,17,17,18,14,66
216,18,14,21,17,70
220,0,32,16,15,63
221,18,31,16,20,85
223,15,36,14,19,84
224,0,36,14,19,69
225,20,33,18,13,84
226,0,33,18,13,64
228,18,13,19,15,65
229,13,34,16,19,82
231,15,35,14,18,82
232,16,19,14,18,67
234,0,32,16,16,64
235,18,32,20,13,83
237,16,33,18,17,84
239,13,35,19,13,80
241,17,32,19,17,85
242,0,32,19,17,68
243,13,36,14,17,80
245,17,31,16,18,82
246,14,17,16,18,65
247,17,34,15,18,84
249,18,33,18,16,85
251,18,34,15,17,84
254,15,17,18,14,64
255,17,32,17,19,85
256,0,32,17,19,68
257,14,36,14,17,81
258,0,36,14,17,67
260,0,31,19,17,67
263,17,33,14,18,82
264,14,19,14,18,65
265,19,32,18,16,85
267,18,34,18,14,84
269,16,32,18,15,81
270,18,14,18,15,65
271,14,33,18,16,81
272,0,33,18,16,67
274,0,34,18,17,69
277,17,32,19,14,82
278,18,14,19,14,65
280,0,33,18,18,69
281,14,36,14,17,81
282,0,36,14,17,67
283,18,31,18,14,81
284,14,17,18,14,63
285,17,32,18,17,84
289,17,34,19,16,86
290,18,16,19,16,69
293,16,30,20,16,82
294,0,30,20,16,66
295,17,36,14,17,84
296,20,16,14,17,67
297,16,31,18,17,82
298,0,31,18,17,66
299,17,35,17,14,83
301,17,31,18,17,83
302,17,14,18,17,66
303,14,35,15,17,81
306,0,32,18,16,66
309,16,36,14,18,84
310,17,19,14,18,68
311,19,32,15,17,83
312,0,32,15,17,64
313,18,32,17,16,83
314,15,17,17,16,65
315,17,33,19,17,86
318,19,17,16,16,68
319,17,32,20,13,82
320,16,16,20,13,65
321,16,33,18,18,85
322,0,33,18,18,69
324,18,18,14,20,70
325,18,34,14,17,83
326,14,20,14,17,65
327,20,31,17,18,86
328,0,31,17,18,66
329,17,35,13,18,83
331,18,31,17,17,83
333,18,34,14,17,83
334,17,17,14,17,65
335,17,31,17,17,82
337,17,34,18,20,89
339,17,38,13,17,85
343,17,32,18,15,82
344,15,17,18,15,65
345,17,33,17,18,85
346,0,33,17,18,68
347,15,35,15,20,85
348,0,35,15,20,70
350,15,20,18,12,65
351,20,30,17,17,84
354,0,34,16,18,68
355,17,34,18,16,85
358,0,34,18,15,67
360,0,33,18,13,64
362,0,31,18,17,66
365,17,34,16,15,82
366,0,34,16,15,65
367,19,31,19,12,81
369,15,31,22,16,84
372,0,38,16,16,70
373,16,32,17,16,81
374,0,32,17,16,65
375,16,33,18,16,83
376,0,33,18,16,67
377,16,34,18,14,82
378,0,34,18,14,66
381,14,35,15,17,81
382,0,35,15,17,67
385,17,33,18,16,84
386,0,33,18,16,67
390,17,19,18,17,71
393,17,28,20,17,82
394,14,14,20,17,65
397,17,36,14,16,83
398,15,21,14,16,66
401,16,33,19,13,81
402,0,33,19,13,65
403,15,32,19,18,84
404,19,13,19,18,69
405,13,37,15,18,83
406,19,18,15,18,70
407,18,33,13,19,83
409,18,32,15,18,83
410,0,32,15,18,65
412,15,18,14,18,65
413,18,32,20,17,87
415,18,37,13,18,86
416,20,17,13,18,68
417,17,31,19,16,83
418,0,31,19,16,66
419,18,35,15,17,85
420,19,16,15,17,67
421,16,32,15,18,81
422,0,32,15,18,65
424,0,33,15,18,66
425,18,33,14,20,85
427,18,34,14,17,83
429,20,31,19,15,85
430,14,17,19,15,65
431,17,34,18,17,86
433,15,35,14,17,81
434,0,35,14,17,66
435,17,31,0,17,65
437,17,35,18,16,86
438,0,35,18,16,69
439,18,34,18,14,84
442,18,14,19,13,64
444,19,13,18,18,68
445,13,36,17,18,84
446,18,18,17,18,71
447,18,35,13,18,84
448,17,18,13,18,66
450,0,31,18,14,63
451,18,32,18,18,86
453,14,36,13,17,80
456,0,30,19,13,62
457,17,32,18,19,86
460,18,19,14,17,68
461,19,31,18,17,85
462,14,17,18,17,66
463,17,35,18,17,87
464,18,17,18,17,70
467,17,33,15,17,82
468,0,33,15,17,65
469,19,32,15,18,84
470,0,32,15,18,65
471,17,33,17,17,84
472,15,18,17,17,67
473,18,34,17,17,86
474,17,17,17,17,68
475,17,34,15,17,83
476,0,34,15,17,66
477,17,32,17,17,83
478,15,17,17,17,66
479,17,34,18,17,86
480,0,34,18,17,69
482,0,35,13,18,66
483,17,31,17,17,82
484,13,18,17,17,65
485,18,34,17,15,84
486,17,17,17,15,66
488,17,15,15,17,64
490,0,32,18,19,69
492,18,19,0,14,51
493,19,33,14,17,83
494,0,33,14,17,64
495,19,31,17,18,85
497,17,35,15,16,83
499,18,31,18,16,83
500,15,16,18,16,65
502,0,34,17,18,69
503,16,35,17,15,83
504,17,18,17,15,67
506,0,32,17,18,67
508,17,18,17,16,68
509,18,33,18,13,82
511,16,31,18,17,82
514,18,17,18,15,68
515,17,33,19,12,81
516,18,15,19,12,64
517,15,31,18,18,82
518,19,12,18,18,67
519,12,36,15,18,81
523,18,33,18,17,86
524,18,15,18,17,68
525,15,35,14,17,81
526,0,35,14,17,66
527,17,31,19,15,82
528,14,17,19,15,65
529,17,34,18,18,87
531,15,36,14,17,82
532,18,18,14,17,67
533,18,31,18,16,83
534,0,31,18,16,65
536,18,16,15,16,65
538,15,16,18,18,67
539,16,36,16,17,85
541,18,33,16,17,84
542,0,33,16,17,66
544,16,17,16,19,68
545,17,35,15,15,82
546,0,35,15,15,65
548,0,30,17,20,67
552,16,15,15,18,64
553,15,33,18,17,83
554,0,33,18,17,68
555,18,35,14,17,84
556,18,17,14,17,66
558,0,31,19,14,64
559,17,33,18,17,85
560,19,14,18,17,68
563,17,32,17,18,84
565,15,35,15,17,82
566,17,18,15,17,67
567,18,32,18,16,84
568,15,17,18,16,66
569,17,34,18,14,83
570,0,34,18,14,66
571,16,32,18,18,84
574,18,18,14,18,68
575,18,32,15,19,84
576,0,32,15,19,66
577,18,34,14,18,84
578,15,19,14,18,66
579,19,32,18,16,85
581,18,34,17,17,86
582,18,16,17,17,68
583,16,34,15,16,81
584,17,17,15,16,65
587,16,36,15,18,85
588,19,17,15,18,69
589,17,33,16,17,83
590,15,18,16,17,66
591,18,33,18,14,83
594,18,14,18,17,67
595,14,35,15,17,81
596,0,35,15,17,67
597,17,32,18,16,83
598,0,32,18,16,66
599,0,17,18,16,51
600,0,34,18,14,66
601,16,32,18,18,84
603,14,36,15,17,82
604,0,36,15,17,68
605,18,32,15,17,82
606,0,32,15,17,64
607,17,32,18,17,84
608,15,17,18,17,67
609,17,35,17,17,86
610,18,17,17,17,69
612,17,17,14,17,65
613,17,31,20,14,82
614,0,31,20,14,65
615,17,34,18,18,87
616,0,34,18,18,70
619,18,31,17,18,84
620,0,31,17,18,66
622,17,18,14,17,66
624,14,17,18,18,67
626,18,18,14,17,67
627,18,31,17,17,83
628,14,17,17,17,65
630,17,17,18,14,66
631,17,32,19,14,82
632,18,14,19,14,65
633,14,33,17,18,82
636,17,18,19,15,69
638,0,34,15,17,66
639,15,32,17,17,81
640,15,17,17,17,66
641,17,34,18,17,86
642,17,17,18,17,69
643,17,35,15,17,84
645,17,32,17,17,83
646,15,17,17,17,66
647,17,34,14,17,82
649,17,31,18,17,83
650,0,31,18,17,66
653,17,32,18,16,83
655,14,34,18,14,80
656,18,16,18,14,66
658,0,32,18,18,68
660,0,36,15,17,68
661,18,32,18,17,85
662,15,17,18,17,67
666,0,32,18,17,67
667,17,35,15,17,84
668,18,17,15,17,67
669,17,32,17,16,82
672,17,16,18,17,68
674,0,35,17,14,66
676,17,14,17,18,66
677,14,35,15,19,83
678,17,18,15,19,69
679,18,34,15,18,85
680,15,19,15,18,67
684,15,17,18,16,66
686,18,16,16,17,67
687,16,33,18,14,81
688,16,17,18,14,65
690,0,32,18,17,67
691,14,35,18,13,80
692,0,35,18,13,66
693,17,31,17,17,82
694,18,13,17,17,65
695,13,34,19,17,83
698,19,17,14,17,67
699,17,31,18,17,83
700,0,31,18,17,66
701,17,35,16,15,83
702,18,17,16,15,66
703,17,31,18,17,83
705,15,35,18,15,83
707,17,33,18,14,82
708,0,33,18,14,65
709,15,32,18,16,81
710,18,14,18,16,66
714,0,35,15,17,67
717,17,34,17,16,84
718,17,17,17,16,67
719,17,33,18,14,82
720,17,16,18,14,65
721,16,32,19,17,84
722,18,14,19,17,68
723,14,36,14,18,82
724,0,36,14,18,68
725,17,32,17,19,85
726,0,32,17,19,68
728,0,36,14,18,68
729,19,32,14,19,84
730,14,18,14,19,65
731,18,33,15,16,82
732,14,19,15,16,64
734,0,31,17,17,65
735,16,34,19,14,83
737,17,33,18,18,86
738,19,14,18,18,69
739,14,36,15,17,82
741,18,32,17,17,84
742,0,32,17,17,66
743,17,34,15,16,82
744,17,17,15,16,65
745,17,31,18,15,81
746,15,16,18,15,64
747,16,33,18,18,85
748,0,33,18,18,69
749,15,36,14,18,83
751,18,32,18,17,85
753,18,35,14,18,85
754,18,17,14,18,67
755,17,32,17,15,81
757,18,32,23,29,102
758,17,15,23,29,84
759,15,23,11,18,67
760,23,46,17,14,100
761,11,35,17,14,77
762,18,17,17,14,66
764,17,14,17,18,66
766,0,35,17,17,69
768,17,17,15,16,65
769,17,31,18,18,84
770,15,16,18,18,67
771,16,36,14,17,83
772,18,18,14,17,67
774,14,17,18,17,66
776,18,17,17,15,67
777,17,32,17,17,83
778,17,15,17,17,66
779,15,34,18,17,84
780,17,17,18,17,69
783,17,30,18,16,81
784,15,15,18,16,64
785,15,34,17,17,83
786,18,16,17,17,68
787,16,34,20,14,84
788,17,17,20,14,68
789,17,34,20,16,87
790,20,14,20,16,70
791,14,36,14,15,79
793,16,29,18,17,80
794,14,15,18,17,64
795,15,35,15,18,83
796,18,17,15,18,68
797,17,33,15,18,83
798,15,18,15,18,66
800,15,18,18,16,67
801,18,34,17,18,87
803,16,35,14,17,82
804,17,18,14,17,66
805,18,31,18,18,85
806,14,17,18,18,67
808,18,18,14,18,68
809,18,32,17,16,83
810,14,18,17,16,65
812,17,16,15,16,64
814,15,16,18,16,65
816,18,16,19,23,76
817,16,42,8,20,86
818,19,23,8,20,70
819,23,28,14,19,84
820,0,28,14,19,61
822,0,33,15,17,65
823,19,32,15,17,83
825,17,32,18,15,82
826,15,17,18,15,65
827,17,33,17,18,85
828,0,33,17,18,68
830,17,18,17,17,69
831,18,34,15,17,84
832,17,17,15,17,66
833,17,32,18,15,82
836,0,33,17,17,67
837,15,34,18,16,83
839,17,34,14,19,84
840,18,16,14,19,67
843,19,33,18,14,84
844,16,17,18,14,65
845,17,32,18,18,85
847,14,36,15,16,81
848,0,36,15,16,67
850,15,16,18,14,63
851,16,32,18,17,83
852,18,14,18,17,67
854,18,17,18,17,70
855,17,35,16,17,85
858,0,33,15,17,65
859,17,32,18,14,81
860,15,17,18,14,64
861,17,32,19,16,84
862,18,14,19,16,67
863,14,35,18,14,81
864,19,16,18,14,67
866,0,32,18,17,67
867,14,35,16,18,83
868,0,35,16,18,69
870,16,18,15,17,66
871,18,32,15,20,85
872,0,32,15,20,67
873,17,35,15,17,84
875,20,32,18,17,87
876,15,17,18,17,67
877,17,35,14,17,83
879,17,31,16,18,82
881,17,34,15,18,84
883,18,33,18,15,84
885,18,33,18,17,86
887,15,35,15,17,82
888,0,35,15,17,67
889,17,32,18,14,81
891,17,32,18,18,85
893,14,36,15,17,82
894,18,18,15,17,68
897,17,35,15,17,84
898,17,18,15,17,67
902,0,33,16,17,66
903,18,33,19,17,87
904,0,33,19,17,69
905,17,36,14,17,84
906,19,17,14,17,67
908,14,17,18,14,63
913,17,32,18,16,83
914,18,14,18,16,66
915,14,34,19,15,82
916,0,34,19,15,68
917,16,34,18,17,85
921,17,31,18,17,83
922,14,17,18,17,66
923,17,35,17,14,83
925,17,31,18,14,80
926,0,31,18,14,63
927,14,32,19,18,83
928,0,32,19,18,69
929,14,37,15,18,84
930,19,18,15,18,70
931,18,33,17,17,85
932,15,18,17,17,67
935,17,31,18,17,83
936,17,14,18,17,66
939,17,34,15,17,83
940,0,34,15,17,66
942,15,17,18,16,66
944,18,16,15,17,66
945,16,32,18,17,83
946,15,17,18,17,67
948,18,17,15,17,67
949,17,32,17,17,83
950,15,17,17,17,66
951,17,34,15,18,84
954,15,18,18,14,65
955,18,32,18,18,86
956,0,32,18,18,68
957,14,36,17,15,82
958,18,18,17,15,68
960,0,32,17,18,67
962,0,35,14,17,66
963,18,31,18,17,84
964,14,17,18,17,66
965,17,35,14,18,84
966,0,35,14,18,67
967,17,32,17,18,84
968,14,18,17,18,67
969,18,35,15,17,85
970,17,18,15,17,67
971,18,32,18,17,85
973,17,35,15,17,84
974,18,17,15,17,67
978,0,32,18,16,66
980,18,16,18,14,66
983,14,32,21,17,84
984,18,14,21,17,70
986,21,17,16,14,68
989,14,34,16,18,82
990,0,34,16,18,68
991,15,34,18,14,81
992,16,18,18,14,66
993,18,32,18,18,86
994,0,32,18,18,68
995,14,36,15,17,82
996,18,18,15,17,68
999,17,35,15,15,82
1001,16,30,19,15,80
1002,15,15,19,15,64
1003,15,34,18,17,84
1005,15,35,15,18,83
1006,18,17,15,18,68
1007,17,33,18,15,83
1008,15,18,18,15,66
1010,18,15,17,17,67
1012,0,34,18,15,67
1013,17,33,16,17,83
1014,18,15,16,17,66
1015,15,33,18,14,80
1016,0,33,18,14,65
1017,17,32,18,16,83
1018,18,14,18,16,66
1019,14,34,18,16,82
1020,0,34,18,16,68
1022,0,34,16,17,67
1023,16,33,18,14,81
1024,16,17,18,14,65
1025,17,32,18,17,84
1026,0,32,18,17,67
1027,14,35,17,17,83
1028,18,17,17,17,69
1029,17,34,17,17,85
1030,17,17,17,17,68
1031,17,34,15,18,84
1032,17,17,15,18,67
1033,17,33,16,18,84
1034,0,33,16,18,67
1035,18,34,16,15,83
1036,16,18,16,15,65
1037,18,31,16,18,83
1038,0,31,16,18,65
1039,15,34,19,14,82
1040,16,18,19,14,67
1041,18,33,15,19,85
1042,19,14,15,19,67
1043,14,34,15,19,82
1046,15,19,16,18,68
1048,0,34,15,18,67
1049,18,33,15,18,84
1051,18,33,16,17,84
1052,0,33,16,17,66
1053,18,33,17,15,83
1054,0,33,17,15,65
1055,17,32,19,17,85
1056,17,15,19,17,68
1057,15,36,14,18,83
1061,18,32,18,17,85
1062,18,14,18,17,67
1064,18,17,15,17,67
1066,15,17,18,15,65
1068,18,15,17,17,67
1069,15,34,18,14,81
1070,17,17,18,14,66
1071,17,32,16,18,83
1072,0,32,16,18,66
1074,16,18,16,17,67
1075,18,33,17,16,84
1076,16,17,17,16,66
1078,17,16,18,16,67
1079,16,34,17,17,84
1080,18,16,17,17,68
1082,17,17,17,17,68
1083,17,34,18,14,83
1084,17,17,18,14,66
1085,17,32,18,17,84
1086,0,32,18,17,67
1087,14,35,15,18,82
1088,18,17,15,18,68
1090,0,33,16,17,66
1094,16,17,18,16,67
1095,17,34,15,18,84
1096,18,16,15,18,67
1098,0,33,16,16,65
1101,16,35,18,14,83
1102,18,17,18,14,67
1103,17,32,18,15,82
1104,0,32,18,15,65
1105,14,33,18,17,82
1106,0,33,18,17,68
1107,15,35,16,16,82
1108,18,17,16,16,67
1109,17,32,16,18,83
1110,0,32,16,18,66
1113,18,35,15,17,85
1114,0,35,15,17,67
1115,17,32,18,14,81
1116,15,17,18,14,64
1117,17,32,19,17,85
1119,14,36,17,14,81
1120,19,17,17,14,67
1121,17,31,16,18,82
1122,0,31,16,18,65
1123,14,34,18,14,80
1124,16,18,18,14,66
1125,18,32,18,17,85
1126,18,14,18,17,67
1128,18,17,17,17,69
1129,17,34,15,18,84
1130,17,17,15,18,67
1133,18,33,18,15,84
1134,0,33,18,15,66
1135,15,33,18,17,83
1137,15,35,15,18,83
1139,17,33,16,16,82
1140,15,18,16,16,65
1142,16,16,18,17,67
1143,16,35,14,17,82
1144,18,17,14,17,66
1145,17,31,16,17,81
1146,14,17,16,17,64
1147,17,33,18,17,85
1154,19,15,17,18,69
1157,18,32,16,17,83
1158,0,32,16,17,65
1159,15,33,18,17,83
1160,0,33,18,17,68
1161,17,35,14,16,82
1164,0,30,19,17,66
1168,15,17,18,17,67
1171,17,31,19,17,84
1173,17,36,16,17,86
1176,16,17,14,17,64
1177,17,31,18,16,82
1178,14,17,18,16,65
1179,17,34,18,16,85
1180,18,16,18,16,68
1182,18,16,19,13,66
1183,16,32,18,18,84
1185,13,36,15,17,81
1187,18,32,18,14,82
1189,17,32,16,18,83
1191,14,34,18,18,84
1192,16,18,18,18,70
1193,18,36,16,14,84
1195,18,30,19,17,84
1196,16,14,19,17,66
1197,14,36,15,17,82
1198,19,17,15,17,68
1199,17,32,18,14,81
1201,17,32,18,16,83
1202,18,14,18,16,66
1203,14,34,18,17,83
1204,18,16,18,17,69
1205,16,35,15,18,84
1206,18,17,15,18,68
1208,0,33,15,17,65
1209,18,32,17,18,85
1210,0,32,17,18,67
1211,17,35,15,18,85
1213,18,33,17,17,85
1216,17,17,14,17,65
1217,17,31,18,15,81
1218,14,17,18,15,64
1219,17,33,19,17,86
1220,0,33,19,17,69
1221,15,36,15,17,83
1223,17,32,15,18,82
1224,15,17,15,18,65
1225,17,33,18,17,85
1226,0,33,18,17,68
1228,18,17,14,18,67
1229,17,32,18,14,81
1230,14,18,18,14,64
1231,18,32,19,16,85
1232,18,14,19,16,67
1233,14,35,18,13,80
1235,16,31,18,18,83
1236,0,31,18,18,67
1239,18,32,17,17,84
1240,15,17,17,17,66
1242,17,17,17,15,66
1243,17,32,17,19,85
1244,17,15,17,19,68
1245,15,36,15,18,84
1246,17,19,15,18,69
1247,19,33,15,17,84
1249,18,32,18,14,82
1250,15,17,18,14,64
1251,17,32,17,18,84
1252,18,14,17,18,67
1253,14,35,18,14,81
1257,14,33,18,18,83
1258,19,14,18,18,69
1259,14,36,14,18,82
1260,0,36,14,18,68
1263,18,35,15,18,86
1264,0,35,15,18,68
1265,17,33,15,17,82
1266,15,18,15,17,65
1267,18,32,16,17,83
1268,15,17,16,17,65
1269,17,33,18,17,85
1270,16,17,18,17,68
1273,17,31,18,17,83
1274,15,16,18,17,66
1277,17,32,19,15,83
1278,18,14,19,15,66
1281,15,35,14,17,81
1283,18,31,18,14,81
1284,14,17,18,14,63
1285,17,32,18,17,84
1286,0,32,18,17,67
1287,14,35,18,17,84
1288,18,17,18,17,70
1289,17,35,14,18,84
1293,18,33,16,18,85
1297,18,32,19,17,86
1298,17,15,19,17,68
1299,0,15,19,17,51
1300,19,17,16,17,69
1301,17,33,14,20,84
1302,16,17,14,20,67
1303,17,34,15,18,84
1304,0,34,15,18,67
1306,15,18,14,17,64
1307,18,31,17,18,84
1309,17,35,15,17,84
1310,17,18,15,17,67
1311,18,32,17,17,84
1316,0,35,20,28,83
1317,20,20,11,17,68
1318,0,20,11,17,48
1319,11,33,17,17,78
1322,17,17,17,18,69
1323,17,35,14,17,83
1325,18,31,17,18,84
1327,17,35,15,17,84
1328,17,18,15,17,67
1330,15,17,16,20,68
1331,17,36,16,15,84
1332,16,20,16,15,67
1335,15,35,15,17,82
1336,0,35,15,17,67
1337,17,32,18,14,81
1338,15,17,18,14,64
1339,0,17,18,14,49
1340,18,14,18,17,67
1341,14,35,16,16,81
1343,17,32,18,17,84
1344,16,16,18,17,67
1346,18,17,18,13,66
1347,17,31,19,17,84
1348,18,13,19,17,67
1349,13,36,15,17,81
1350,19,17,15,17,68
1352,15,17,16,17,65
1354,0,33,19,14,66
1355,17,33,18,17,85
1356,19,14,18,17,68
1357,14,35,15,18,82
1359,17,33,18,17,85
1360,15,18,18,17,68
1361,18,35,14,17,84
1362,18,17,14,17,66
1364,0,31,19,14,64
1366,19,14,18,16,67
1367,14,34,18,17,83
1368,18,16,18,17,69
1369,16,35,14,18,83
1371,17,32,15,17,81
1373,18,32,17,18,85
1374,15,17,17,18,67
1375,17,35,15,17,84
1376,0,35,15,17,67
1378,15,17,17,17,66
1379,17,34,19,13,83
1380,17,17,19,13,66
1381,17,32,17,17,83
1382,19,13,17,17,66
1384,0,34,17,17,68
1385,17,34,18,15,84
1386,0,34,18,15,67
1388,0,33,16,18,67
1389,15,34,17,15,81
1391,18,32,18,16,84
1392,0,32,18,16,66
1393,15,34,18,14,81
1394,0,34,18,14,66
1395,16,32,17,18,83
1396,18,14,17,18,67
1397,14,35,17,17,83
1398,17,18,17,17,69
1399,18,34,16,17,85
1400,17,17,16,17,67
1402,16,17,15,18,66
1403,17,33,15,18,83
1405,18,33,18,17,86
1407,18,35,15,18,86
1408,0,35,15,18,68
1409,17,33,15,18,83
1410,0,33,15,18,66
1411,18,33,16,17,84
1412,15,18,16,17,66
1413,18,33,16,19,86
1414,16,17,16,19,68
1415,17,35,15,18,85
1416,0,35,15,18,68
1418,15,18,15,18,66
1419,18,33,14,17,82
1421,18,31,18,16,83
1422,14,17,18,16,65
1423,17,34,18,17,86
1424,0,34,18,17,69
1428,0,30,19,17,66
1429,14,36,15,17,82
1430,0,36,15,17,68
1431,17,32,17,17,83
1432,0,32,17,17,66
1433,17,34,18,14,83
1434,0,34,18,14,66
1436,18,14,18,15,65
1438,18,15,17,18,68
1440,0,35,19,14,68
1441,18,33,19,13,83
1442,0,33,19,13,65
1443,14,32,19,17,82
1444,19,13,19,17,68
1446,0,36,15,17,68
1447,17,32,18,14,81
1448,15,17,18,14,64
1449,17,32,18,17,84
1451,14,35,18,14,81
1453,17,32,19,18,86
1454,18,14,19,18,69
1455,14,37,15,17,83
1456,19,18,15,17,69
1457,18,32,16,17,83
1460,0,33,15,18,66
1461,17,33,17,18,85
1462,15,18,17,18,68
1464,17,18,17,11,63
1465,18,28,21,14,81
1469,14,35,17,18,84
1471,17,35,15,18,85
1475,18,31,20,15,84
1477,16,35,15,17,83
1478,20,15,15,17,67
1480,15,17,19,14,65
1481,17,33,19,17,86
1482,19,14,19,17,69
1483,14,36,15,18,83
1484,0,36,15,18,69
1487,18,33,15,19,85
1488,15,18,15,19,67
1489,18,34,14,18,84
1490,0,34,14,18,66
1491,19,32,18,17,86
1492,14,18,18,17,67
1493,18,35,16,15,84
1494,18,17,16,15,66
1495,17,31,19,14,81
1496,16,15,19,14,64
1497,15,33,19,14,81
1499,14,33,19,17,83
1500,19,14,19,17,69
1501,14,36,15,16,81
1502,19,17,15,16,67
1503,17,31,18,17,83
1505,16,35,15,17,83
1507,17,32,18,18,85
1508,15,17,18,18,68
1509,17,36,15,18,86
1512,15,18,15,18,66
1513,18,33,16,17,84
1514,15,18,16,17,66
1515,18,33,15,18,84
1516,16,17,15,18,66
1518,0,33,16,18,67
1520,16,18,14,20,68
1521,18,34,13,17,82
1523,20,30,19,14,83
1524,13,17,19,14,63
1525,17,33,18,18,86
1526,19,14,18,18,69
1528,0,36,15,16,67
1529,18,31,20,13,82
1531,16,33,18,18,85
1533,13,36,15,18,82
1534,18,18,15,18,69
1535,18,33,15,17,83
1536,15,18,15,17,65
1538,0,32,18,18,68
1540,0,36,15,17,68
1542,15,17,15,18,65
1543,17,33,16,18,84
1544,0,33,16,18,67
1545,18,34,16,18,86
1546,0,34,16,18,68
1548,16,18,15,17,66
1549,18,32,14,18,82
1550,0,32,14,18,64
1552,0,32,20,13,65
1553,18,33,19,17,87
1554,20,13,19,17,69
1556,19,17,15,17,68
1557,17,32,15,18,82
1558,0,32,15,18,65
1560,15,18,17,17,67
1561,18,34,18,17,87
1563,17,35,14,18,84
1564,0,35,14,18,67
1565,17,32,17,15,81
1566,0,32,17,15,64
1568,17,15,18,16,66
1569,15,34,18,14,81
1570,18,16,18,14,66
1571,16,32,18,17,83
1572,18,14,18,17,67
1573,14,35,17,17,83
1576,17,17,15,17,66
1579,17,35,12,21,85
1582,0,33,16,17,66
1583,21,33,15,17,86
1585,17,32,18,17,84
1586,15,17,18,17,67
1590,14,18,18,17,67
1591,18,35,14,18,85
1592,18,17,14,18,67
1593,17,32,18,14,81
1596,0,32,18,15,65
1597,14,33,18,18,83
1600,0,36,15,19,70
1601,18,34,15,15,82
1603,19,30,17,19,85
1604,15,15,17,19,66
1606,17,19,15,19,70
1607,19,34,15,14,82
1608,0,34,15,14,63
1609,19,29,20,18,86
1611,14,38,15,17,84
1613,18,32,17,18,85
1615,17,35,15,17,84
1616,0,35,15,17,67
1617,18,32,14,18,82
1618,0,32,14,18,64
1619,17,32,18,14,81
1621,18,32,18,18,86
1623,14,36,15,17,82
1624,0,36,15,17,68
1625,18,32,16,18,84
1626,15,17,16,18,66
1629,18,34,16,16,84
1630,15,19,16,16,66
1632,0,32,19,17,68
1633,16,36,13,17,82
1634,19,17,13,17,66
1635,17,30,18,18,83
1636,13,17,18,18,66
1637,17,36,13,15,81
1639,18,28,19,17,82
1640,0,28,19,17,64
1641,15,36,17,15,83
1642,19,17,17,15,68
1643,17,32,17,18,84
1644,17,15,17,18,67
1645,15,35,16,19,85
1647,18,35,18,15,86
1648,0,35,18,15,68
1649,19,33,17,16,85
1653,16,35,14,18,83
1654,15,20,14,18,67
1655,20,32,16,19,87
1657,18,35,15,17,85
1658,0,35,15,17,67
1659,19,32,18,13,82
1660,15,17,18,13,63
1661,17,31,18,18,84
1662,0,31,18,18,67
1664,18,18,14,18,68
1665,18,32,18,14,82
1667,18,32,19,14,83
1668,18,14,19,14,65
1669,14,33,19,14,80
1670,0,33,19,14,66
1672,0,33,17,17,67
1674,17,17,18,15,67
1675,17,33,19,17,86
1677,15,36,15,18,84
1678,19,17,15,18,69
1679,17,33,15,17,82
1681,18,32,19,14,83
1683,17,33,19,17,86
1684,19,14,19,17,69
1685,14,36,14,17,81
1686,0,36,14,17,67
1689,17,35,16,18,86
1690,0,35,16,18,69
1692,16,18,14,17,65
1695,17,36,14,18,85
1696,0,36,14,18,68
1697,18,32,14,18,82
1698,14,18,14,18,64
1700,0,32,14,20,66
1701,18,34,15,18,85
1702,14,20,15,18,67
1703,20,33,16,17,86
1704,15,18,16,17,66
1705,18,33,19,14,84
1707,17,33,18,18,86
1708,0,33,18,18,69
1709,14,36,15,17,82
1710,18,18,15,17,68
1711,18,32,17,16,83
1712,15,17,17,16,65
1713,17,33,18,15,83
1714,17,16,18,15,66
1715,16,33,17,15,81
1716,0,33,17,15,65
1717,15,32,18,18,83
1718,0,32,18,18,68
1719,15,36,11,22,84
1720,0,36,11,22,69
1721,18,33,18,13,82
1722,0,33,18,13,64
1724,18,13,19,14,64
1726,19,14,19,17,69
1727,14,36,15,18,83
1728,19,17,15,18,69
1731,18,32,18,18,86
1732,16,16,18,18,68
1734,0,36,15,17,68
1737,17,34,15,17,83
1738,16,18,15,17,66
1739,18,32,15,19,84
1740,0,32,15,19,66
1741,17,34,17,17,85
1742,15,19,17,17,68
1743,19,34,14,18,85
1745,17,32,18,17,84
1746,14,18,18,17,67
1747,18,35,15,17,85
1748,18,17,15,17,67
1749,0,17,15,17,49
1751,17,33,18,14,82
1753,17,32,19,15,83
1754,18,14,19,15,66
1755,14,34,17,18,83
1756,0,34,17,18,69
1757,15,35,14,17,81
1758,17,18,14,17,66
1759,18,31,19,14,82
1760,14,17,19,14,64
1763,14,33,19,17,83
1764,19,14,19,17,69
1765,14,36,15,17,82
1766,19,17,15,17,68
1767,17,32,18,15,82
1768,0,32,18,15,65
1769,17,33,18,18,86
1770,18,15,18,18,69
1772,18,18,14,17,67
1774,14,17,19,17,67
1775,17,36,15,15,83
1777,17,30,19,15,81
1778,15,15,19,15,64
1779,15,34,18,15,82
1781,15,33,17,17,82
1782,18,15,17,17,67
1783,15,34,19,14,82
1785,17,33,18,17,85
1786,0,33,18,17,68
1787,14,35,15,16,80
1789,17,31,18,16,82
1791,16,34,18,17,85
1793,16,35,15,17,83
1794,0,35,15,17,67
1795,17,32,17,18,84
1797,17,35,15,18,85
1798,17,18,15,18,68
1799,18,33,16,16,83
1800,15,18,16,16,65
1801,18,32,19,16,85
1802,0,32,19,16,67
1803,16,35,15,18,84
1806,15,18,17,17,67
1807,18,34,15,17,84
1808,17,17,15,17,66
1810,15,17,17,17,66
1811,17,34,18,13,82
1812,17,17,18,13,65
1813,17,31,19,17,84
1814,0,31,19,17,67
1817,17,33,14,18,82
1818,16,17,14,18,65
1819,17,32,20,16,85
1823,16,30,19,17,82
1825,0,14,19,17,50
1826,0,36,15,18,69
1828,15,18,15,17,65
1829,18,32,17,17,84
1830,15,17,17,17,66
1832,0,34,15,17,66
1833,17,32,18,15,82
1834,0,32,18,15,65
1835,17,33,18,15,83
1838,18,15,18,18,69
1839,15,36,16,17,84
1840,18,18,16,17,69
1842,16,17,15,20,68
1843,17,35,14,18,84
1844,15,20,14,18,67
1847,18,31,18,17,84
1848,0,31,18,17,66
1850,18,17,16,17,68
1851,17,33,18,15,83
1852,16,17,18,15,66
1854,18,15,21,14,68
1855,15,35,16,14,80
1856,21,14,16,14,65
1857,14,30,19,15,78
1858,0,30,19,15,64
1859,14,34,18,15,81
1860,19,15,18,15,67
1861,15,33,17,17,82
1862,0,33,17,17,67
1863,15,34,20,14,83
1864,17,17,20,14,68
1865,17,34,18,14,83
1866,0,34,18,14,66
1867,14,32,18,18,82
1868,18,14,18,18,68
1869,14,36,15,18,83
1870,18,18,15,18,69
1872,15,18,15,17,65
1873,18,32,18,14,82
1875,17,32,18,17,84
1876,18,14,18,17,67
1878,18,17,19,17,71
1879,17,36,14,18,85
1880,19,17,14,18,68
1881,17,32,15,17,81
1882,14,18,15,17,64
1883,18,32,15,19,84
1884,15,17,15,19,66
1885,17,34,15,18,84
1886,15,19,15,18,67
1887,19,33,15,17,84
1888,0,33,15,17,65
1889,18,32,18,17,85
1890,15,17,18,17,67
1891,17,35,15,19,86
1892,18,17,15,19,69
1893,17,34,15,19,85
1894,15,19,15,19,68
1895,19,34,14,18,85
1896,0,34,14,18,66
1897,19,32,15,18,84
1899,18,33,18,14,83
1900,15,18,18,14,65
1901,18,32,18,17,85
1902,0,32,18,17,67
1904,18,17,17,15,67
1905,17,32,18,17,84
1906,17,15,18,17,67
1907,15,35,15,18,83
1908,18,17,15,18,68
1909,17,33,16,18,84
1911,18,34,16,15,83
1912,16,18,16,15,65
1913,18,31,17,16,82
1914,0,31,17,16,64
1915,15,33,19,21,88
1917,16,40,12,15,83
1918,19,21,12,15,67
1919,21,27,19,14,81
1923,14,36,16,18,84
1924,19,17,16,18,70
1926,16,18,14,18,66
1927,18,32,15,19,84
1928,0,32,15,19,66
1930,15,19,15,19,68
1932,15,19,15,17,66
1933,19,32,15,17,83
1934,0,32,15,17,64
1936,0,32,18,15,65
1938,18,15,18,17,68
1940,0,35,15,18,68
1944,18,15,18,15,66
1945,15,33,18,14,80
1946,18,15,18,14,65
1948,18,14,20,17,69
1949,14,37,15,17,83
1951,17,32,14,19,82
1955,19,32,18,18,87
1957,14,36,16,17,83
1958,0,36,16,17,69
1959,18,33,15,18,84
1960,16,17,15,18,66
1961,17,33,15,18,83
1962,15,18,15,18,66
1964,15,18,17,15,65
1965,18,32,18,15,83
1967,15,33,19,17,84
1969,15,36,15,18,84
1970,19,17,15,18,69
1971,17,33,14,19,83
1972,0,33,14,19,66
1974,14,19,15,16,64
1975,19,31,19,16,85
1976,0,31,19,16,66
1978,0,35,15,17,67
1980,15,17,19,17,68
1981,17,36,17,14,84
1982,19,17,17,14,67
1985,14,35,15,18,82
1986,0,35,15,18,68
1987,18,33,15,19,85
1988,0,33,15,19,67
1989,18,34,15,17,84
1990,15,19,15,17,66
1991,19,32,18,15,84
1992,0,32,18,15,65
1993,17,33,16,18,84
1994,18,15,16,18,67
1997,18,33,16,18,85
1999,15,34,15,18,82
2000,16,18,15,18,67
2001,18,33,16,18,85
2002,15,18,16,18,67
2003,18,34,15,18,85
2004,16,18,15,18,67
2005,18,33,16,17,84
2006,15,18,16,17,66
2007,18,33,18,14,83
2008,0,33,18,14,65
2009,17,32,18,17,84
2010,18,14,18,17,67
2011,14,35,19,15,83
2013,17,34,16,17,84
2014,0,34,16,17,67
2015,15,33,15,17,80
2016,0,33,15,17,65
2018,15,17,18,14,64
2025,19,32,15,17,83
2026,14,18,15,17,64
2027,18,32,19,14,83
2028,0,32,19,14,65
2029,17,33,18,18,86
2030,19,14,18,18,69
2031,14,36,14,19,83
2033,18,33,14,18,83
2034,0,33,14,18,65
2035,19,32,19,13,83
2036,0,32,19,13,64
2037,18,32,19,18,87
2039,13,37,14,18,82
2040,0,37,14,18,69
2043,18,34,15,18,85
2045,19,33,15,19,86
2046,15,18,15,19,67
2047,18,34,14,18,84
2049,19,32,17,18,86
2050,14,18,17,18,67
2052,17,18,14,18,67
2053,18,32,15,17,82
2054,0,32,15,17,64
2055,18,32,18,16,84
2056,15,17,18,16,66
2058,18,16,18,15,67
2059,16,33,16,17,82
2060,0,33,16,17,66
2061,15,33,18,17,83
2062,0,33,18,17,68
2063,17,35,15,17,84
2064,18,17,15,17,67
2067,17,32,20,14,83
2068,0,32,20,14,66
2069,13,34,18,18,83
2070,20,14,18,18,70
2071,14,36,14,18,82
2072,18,18,14,18,68
2073,18,32,18,14,82
2074,0,32,18,14,64
2075,18,32,19,14,83
2078,19,14,18,18,69
2080,18,18,14,18,68
2081,18,32,18,14,82
2082,0,32,18,14,64
2083,18,32,18,17,85
2084,0,32,18,17,67
2085,14,35,15,18,82
2086,18,17,15,18,68
2087,17,33,18,17,85
2088,0,33,18,17,68
2090,0,35,15,17,67
2092,0,32,15,18,65
2093,17,33,17,18,85
2094,0,33,17,18,68
2095,18,35,15,16,84
2096,17,18,15,16,66
2097,18,31,22,11,82
2098,15,16,22,11,64
2100,22,11,19,14,66
2102,0,33,18,16,67
2103,14,34,17,17,82
2104,18,16,17,17,68
2105,16,34,15,18,83
2106,17,17,15,18,67
2107,17,33,17,17,84
2108,15,18,17,17,67
2111,17,35,14,19,85
2112,18,17,14,19,68
2113,17,33,16,18,84
2114,14,19,16,18,67
2115,19,34,14,16,83
2116,0,34,14,16,64
2117,18,30,18,17,83
2119,16,35,16,16,83
2121,17,32,18,17,84
2122,16,16,18,17,67
2123,16,35,15,18,84
2124,18,17,15,18,68
2125,17,33,18,14,82
2127,18,32,16,17,83
2128,0,32,16,17,65
2130,16,17,19,14,66
2131,17,33,17,17,84
2132,0,33,17,17,67
2133,14,34,18,16,82
2134,17,17,18,16,68
2135,17,34,18,16,85
2137,16,34,15,17,82
2138,18,16,15,17,66
2139,16,32,16,19,83
2140,15,17,16,19,67
2141,17,35,15,17,84
2144,15,17,16,16,64
2145,17,32,19,17,85
2146,0,32,19,17,68
2148,19,17,15,18,69
2149,17,33,17,15,82
2151,18,32,18,15,83
2152,17,15,18,15,65
2154,0,33,18,15,66
2155,15,33,19,14,81
2156,18,15,19,14,66
2157,15,33,20,15,83
2160,0,35,16,17,68
2161,15,33,18,15,81
2162,16,17,18,15,66
2163,17,33,19,14,83
2164,0,33,19,14,66
2165,15,33,19,16,83
2166,0,33,19,16,68
2167,14,35,16,15,80
2169,16,31,18,18,83
2170,0,31,18,18,67
2171,15,36,15,17,83
2172,0,36,15,17,68
2173,18,32,19,14,83
2176,19,14,16,18,67
2177,14,34,18,14,80
2178,0,34,18,14,66
2179,18,32,19,14,83
2180,0,32,19,14,65
2181,14,33,18,17,82
2182,19,14,18,17,68
2183,14,35,18,17,84
2184,0,35,18,17,70
2185,17,35,15,17,84
2186,18,17,15,17,67
2187,17,32,15,18,82
2188,15,17,15,18,65
2190,15,18,18,18,69
2191,18,36,15,14,83
2192,0,36,15,14,65
2193,18,29,19,18,84
2194,0,29,19,18,66
2195,14,37,14,17,82
2197,18,31,17,18,84
2198,14,17,17,18,66
2199,17,35,14,19,85
2200,17,18,14,19,68
2202,0,33,15,17,65
2203,19,32,18,15,84
2204,15,17,18,15,65
2205,17,33,18,18,86
2206,0,33,18,18,69
2207,15,36,14,18,83
2208,18,18,14,18,68
2209,18,32,16,15,81
2211,18,31,19,17,85
2212,0,31,19,17,67
2213,15,36,16,17,84
2215,17,33,17,15,82
2216,0,33,17,15,65
2217,17,32,18,15,82
2220,0,33,17,16,66
2221,15,33,17,19,84
2222,0,33,17,19,69
2224,0,36,16,17,69
2225,19,33,15,19,86
2226,16,17,15,19,67
2227,17,34,15,17,83
2228,15,19,15,17,66
2230,0,32,16,18,66
2231,17,34,15,17,83
2232,16,18,15,17,66
2233,18,32,16,19,85
2234,0,32,16,19,67
2235,17,35,14,19,85
2237,19,33,15,15,82
2238,0,33,15,15,63
2239,19,30,18,17,84
2240,0,30,18,17,65
2242,0,35,18,15,68
2243,17,33,18,17,85
2248,0,32,21,18,71
2249,17,39,12,16,84
2250,21,18,12,16,67
2251,18,28,15,18,79
2252,0,28,15,18,61
2253,16,33,18,15,82
2254,15,18,18,15,66
2256,18,15,17,18,68
2257,15,35,16,16,82
2259,18,32,16,17,83
2260,16,16,16,17,65
2261,16,33,17,18,84
2262,0,33,17,18,68
2268,0,34,16,17,67
2269,18,33,15,18,84
2271,17,33,15,19,84
2272,0,33,15,19,67
2273,18,34,15,17,84
2274,0,34,15,17,66
2275,19,32,16,17,84
2276,15,17,16,17,65
2277,17,33,18,17,85
2278,16,17,18,17,68
2279,17,35,17,12,81
2280,18,17,17,12,64
2281,17,29,21,15,82
2284,21,15,16,19,71
2287,19,32,16,17,84
2288,15,17,16,17,65
2289,17,33,17,18,85
2290,0,33,17,18,68
2291,17,35,15,17,84
2292,17,18,15,17,67
2293,18,32,18,14,82
2294,0,32,18,14,64
2295,17,32,19,17,85
2296,18,14,19,17,68
2297,14,36,15,18,83
2298,0,36,15,18,69
2299,17,33,17,14,81
2300,15,18,17,14,64
2301,18,31,18,18,85
2302,17,14,18,18,67
2303,14,36,15,17,82
2308,15,18,17,19,69
2310,17,19,14,21,71
2311,19,35,12,18,84
2312,0,35,12,18,65
2313,21,30,16,18,85
2314,12,18,16,18,64
2315,18,34,14,18,84
2316,16,18,14,18,66
2317,18,32,18,15,83
2318,14,18,18,15,65
2319,18,33,0,18,69
2322,18,15,0,19,52
2323,15,34,17,17,83
2326,17,17,16,18,68
2327,17,34,16,17,84
2328,16,18,16,17,67
2329,18,33,16,18,85
2330,16,17,16,18,67
2331,17,34,14,18,83
2332,16,18,14,18,66
2333,18,32,15,18,83
2334,14,18,15,18,65
2335,18,33,18,17,86
2336,0,33,18,17,68
2339,17,32,19,12,80
2340,0,32,19,12,63
2341,17,31,18,19,85
2342,19,12,18,19,68
2343,12,37,15,17,81
2344,18,19,15,17,69
2346,15,17,16,17,65
2347,17,33,19,13,82
2348,16,17,19,13,65
2349,17,32,19,17,85
2352,0,36,16,17,69
2353,17,33,16,18,84
2354,0,33,16,18,67
2355,17,34,14,17,82
2356,0,34,14,17,65
2357,18,31,20,14,83
2358,0,31,20,14,65
2360,20,14,18,14,66
2363,14,36,14,17,81
2364,18,18,14,17,67
2365,18,31,19,15,83
2366,14,17,19,15,65
2367,17,34,16,18,85
2372,15,18,18,15,66
2373,18,33,23,26,100
2374,18,15,23,26,82
2375,15,23,13,13,64
2376,0,23,13,13,49
2377,13,32,18,17,80
2378,13,19,18,17,67
2379,0,19,18,17,54
2380,18,17,16,18,69
2381,17,34,15,16,82
2382,0,34,15,16,65
2384,0,31,14,22,67
2385,16,36,13,18,83
2387,22,31,18,15,86
2388,13,18,18,15,64
2390,18,15,19,13,65
2391,15,32,19,17,83
2392,19,13,19,17,68
2394,19,17,14,17,67
2395,17,31,18,15,81
2396,14,17,18,15,64
2397,17,33,18,17,85
2398,0,33,18,17,68
2399,15,35,16,15,81
2400,18,17,16,15,66
2401,17,31,18,17,83
2404,0,35,18,15,68
2405,17,33,19,14,83
2407,15,33,18,18,84
2408,0,33,18,18,69
2411,18,30,18,17,83
2412,0,30,18,17,65
2413,18,35,16,17,86
2414,0,35,16,17,68
2415,17,33,15,17,82
2417,17,32,19,14,82
2418,0,32,19,14,65
2419,17,33,19,17,86
2420,19,14,19,17,69
2421,14,36,15,17,82
2422,19,17,15,17,68
2423,17,32,16,17,82
2424,0,32,16,17,65
2425,17,33,18,17,85
2427,17,35,15,18,85
2428,18,17,15,18,68
2429,17,33,16,23,89
2430,0,33,16,23,72
2431,18,39,12,14,83
2432,16,23,12,14,65
2433,23,26,19,18,86
2434,0,26,19,18,63
2435,14,37,12,18,81
2436,0,37,12,18,67
2437,18,30,19,14,81
2438,12,18,19,14,63
2439,18,33,16,19,86
2440,0,33,16,19,68
2441,14,35,15,16,80
2443,19,31,17,19,86
2444,15,16,17,19,67
2445,16,36,16,17,85
2446,0,36,16,17,69
2447,19,33,15,18,85
2448,0,33,15,18,66
2449,17,33,18,14,82
2450,15,18,18,14,65
2451,18,32,18,15,83
2453,14,33,17,18,82
2454,18,15,17,18,68
2456,17,18,15,17,67
2457,0,18,15,17,50
2458,15,17,16,19,67
2459,17,35,18,17,87
2462,0,35,16,14,65
2463,17,30,17,17,81
2464,16,14,17,17,64
2465,14,34,16,18,82
2466,0,34,16,18,68
2468,0,34,15,17,66
2469,18,32,19,17,86
2471,17,36,13,17,83
2475,17,36,13,20,86
2476,17,19,13,20,69
2479,20,21,11,16,68
2481,11,34,16,16,77
2482,16,18,16,16,66
2483,18,32,18,15,83
2484,16,16,18,15,65
2485,16,33,17,17,83
2486,18,15,17,17,67
2487,15,34,20,14,83
2488,17,17,20,14,68
2489,17,34,19,13,83
2490,0,34,19,13,66
2492,19,13,20,13,65
2493,13,33,18,16,80
2494,0,33,18,16,67
2495,13,34,17,17,81
2496,18,16,17,17,68
2497,16,34,15,17,82
2498,0,34,15,17,66
2499,17,32,18,18,85
2500,15,17,18,18,68
2501,17,36,15,18,86
2502,18,18,15,18,69
2503,18,33,18,17,86
2504,15,18,18,17,68
2506,18,17,13,20,68
2508,13,20,16,14,63
2509,20,30,18,18,86
2510,16,14,18,18,66
2511,14,36,15,18,83
2512,18,18,15,18,69
2513,18,33,14,16,81
2516,0,30,18,18,66
2518,0,36,15,18,69
2520,15,18,15,18,66
2521,18,33,18,15,84
2522,15,18,18,15,66
2523,18,33,18,17,86
2524,0,33,18,17,68
2525,15,35,16,16,82
2526,18,17,16,16,67
2527,17,32,17,18,84
2529,16,35,16,17,84
2530,17,18,16,17,68
2533,17,33,16,16,82
2534,14,19,16,16,65
2535,19,32,16,18,85
2536,16,16,16,18,66
2537,16,34,16,18,84
2538,0,34,16,18,68
2539,18,34,15,18,85
2541,18,33,17,18,86
2542,0,33,17,18,68
2543,18,35,14,17,84
2544,17,18,14,17,66
2545,18,31,19,14,82
2548,19,14,19,13,65
2550,19,13,19,16,67
2552,19,16,16,17,68
2553,16,33,16,18,83
2554,16,17,16,18,67
2556,16,18,15,19,68
2557,18,34,15,18,85
2559,19,33,16,16,84
2561,18,32,17,18,85
2562,16,16,17,18,67
2563,16,35,15,17,83
2564,0,35,15,17,67
2566,15,17,17,18,67
2567,17,35,16,15,83
2568,17,18,16,15,66
2569,18,31,18,17,84
2570,16,15,18,17,66
2573,17,34,16,18,85
2574,0,34,16,18,68
2575,17,34,15,15,81
2577,18,30,19,15,82
2578,15,15,19,15,64
2580,19,15,18,14,66
2581,15,32,17,21,85
2582,18,14,17,21,70
2583,14,38,15,15,82
2584,17,21,15,15,68
2586,15,15,18,18,66
2587,15,36,15,15,81
2588,0,36,15,15,66
2589,18,30,18,17,83
2590,0,30,18,17,65
2591,15,35,16,18,84
2592,0,35,16,18,69
2593,17,34,15,17,83
2594,16,18,15,17,66
2595,18,32,19,13,82
2596,0,32,19,13,64
2597,17,32,19,18,86
2598,0,32,19,18,69
2599,13,37,15,17,82
2600,19,18,15,17,69
2601,18,32,17,16,83
2602,15,17,17,16,65
2603,17,33,16,18,84
2604,17,16,16,18,67
2606,16,18,15,19,68
2608,0,34,16,15,65
2609,19,31,17,17,84
2611,15,34,17,17,83
2612,0,34,17,17,68
2613,17,34,16,16,83
2614,17,17,16,16,66
2615,17,32,16,20,85
2617,16,36,19,14,85
2618,16,20,19,14,69
2619,20,33,15,19,87
2622,15,19,16,16,66
2623,19,32,15,16,82
2624,16,16,15,16,63
2625,16,31,20,15,82
2626,15,16,20,15,66
2627,16,35,16,18,85
2628,0,35,16,18,69
2629,15,34,15,17,81
2632,0,32,17,18,67
2633,17,35,16,15,83
2635,18,31,18,17,84
2637,15,35,18,14,82
2638,0,35,18,14,67
2639,17,32,18,18,85
2640,18,14,18,18,68
2641,14,36,15,18,83
2642,0,36,15,18,69
2644,15,18,15,15,63
2645,18,30,18,21,87
2647,15,39,13,18,85
2648,0,39,13,18,70
2649,21,31,16,14,82
2650,13,18,16,14,61
2651,18,30,20,17,85
2652,0,30,20,17,67
2654,0,37,17,14,68
2655,17,31,18,18,84
2656,0,31,18,18,67
2657,14,36,17,15,82
2658,0,36,17,15,68
2659,18,32,15,19,84
2661,15,34,15,18,82
2663,19,33,15,19,86
2664,15,18,15,19,67
2665,18,34,14,18,84
2666,0,34,14,18,66
2669,18,35,14,18,85
2671,20,32,17,15,84
2672,14,18,17,15,64
2673,18,32,19,14,83
2675,15,33,19,14,81
2678,19,14,19,15,67
2679,14,34,19,15,82
2680,19,15,19,15,68
2681,15,34,18,15,82
2683,15,33,17,18,83
2684,0,33,17,18,68
2685,15,35,14,19,83
2687,18,33,16,19,86
2688,14,19,16,19,68
2689,19,35,14,15,83
2690,16,19,14,15,64
2691,19,29,20,16,84
2692,0,29,20,16,65
2694,0,36,15,18,69
2695,16,33,16,18,83
2696,0,33,16,18,67
2697,18,34,16,15,83
2698,16,18,16,15,65
2700,16,15,16,17,64
2701,15,33,16,18,82
2702,0,33,16,18,67
2703,17,34,20,15,86
2704,0,34,20,15,69
2705,18,35,17,16,86
2706,20,15,17,16,68
2707,15,33,16,15,79
2710,0,31,17,20,68
2711,15,37,16,14,82
2712,0,37,16,14,67
2713,20,30,19,15,84
2714,16,14,19,15,64
2716,0,34,19,14,67
2717,15,33,19,14,81
2718,19,14,19,14,66
2719,14,33,19,17,83
2722,19,17,15,16,67
2723,17,31,18,15,81
2724,0,31,18,15,64
2726,18,15,18,18,69
2727,15,36,15,17,83
2729,18,32,16,20,86
2730,0,32,16,20,68
2731,17,36,16,15,84
2732,16,20,16,15,67
2734,16,15,15,20,66
2735,15,35,16,17,83
2736,0,35,16,17,68
2737,20,33,18,14,85
2738,16,17,18,14,65
2739,17,32,18,17,84
2741,14,35,15,18,82
2742,18,17,15,18,68
2743,17,33,15,18,83
2745,18,33,15,19,85
2746,15,18,15,19,67
2747,18,34,15,18,85
2749,19,33,16,18,86
2750,15,18,16,18,67
2751,18,34,15,15,82
2752,16,18,15,15,64
2754,15,15,18,17,65
2755,15,35,18,13,81
2756,0,35,18,13,66
2757,17,31,19,16,83
2758,0,31,19,16,66
2759,13,35,19,14,81
2760,0,35,19,14,68
2761,16,33,17,18,84
2763,14,35,15,19,83
2767,19,31,19,14,83
2768,14,17,19,14,64
2770,19,14,15,19,67
2771,14,34,15,18,81
2772,0,34,15,18,67
2774,15,18,19,14,66
2775,18,33,18,18,87
2776,0,33,18,18,69
2780,15,18,14,17,64
2782,0,31,16,17,64
2783,17,33,18,17,85
2784,16,17,18,17,68
2785,17,35,16,18,86
2786,0,35,16,18,69
2787,17,34,18,14,83
2788,0,34,18,14,66
2789,18,32,18,17,85
2790,18,14,18,17,67
2791,14,35,15,18,82
2792,18,17,15,18,68
2793,17,33,16,18,84
2794,15,18,16,18,67
2798,0,30,21,15,66
2799,16,36,16,16,84
2800,21,15,16,16,68
2802,0,32,18,15,65
2803,16,33,18,16,83
2804,18,15,18,16,67
2805,15,34,18,14,81
2806,0,34,18,14,66
2807,16,32,19,15,82
2808,18,14,19,15,66
2810,0,34,19,15,68
2811,15,34,15,18,82
2812,0,34,15,18,67
2813,15,33,19,13,80
2814,0,33,19,13,65
2815,18,32,20,17,87
2816,19,13,20,17,69
2817,13,37,16,14,80
2819,17,30,18,18,83
2821,14,36,15,16,81
2822,18,18,15,16,67
2823,18,31,18,18,85
2827,18,33,18,16,85
2828,14,19,18,16,67
2829,19,34,13,17,83
2830,0,34,13,17,64
2831,16,30,16,20,82
2832,0,30,16,20,66
2833,17,36,16,17,86
2834,0,36,16,17,69
2835,20,33,15,17,85
2836,16,17,15,17,65
2837,17,32,16,19,84
2838,15,17,16,19,67
2839,17,35,16,17,85
2841,19,33,16,18,86
2842,16,17,16,18,67
2844,16,18,17,15,66
2845,18,32,14,18,82
2849,18,36,15,16,85
2850,19,17,15,16,67
2851,17,31,16,19,83
2852,0,31,16,19,66
2855,19,34,16,15,84
2856,16,18,16,15,65
2857,18,31,15,18,82
2858,16,15,15,18,64
2859,15,33,19,14,81
2860,0,33,19,14,66
2861,18,33,19,14,84
2863,14,33,17,19,83
2865,14,36,18,13,81
2866,17,19,18,13,67
2867,19,31,17,19,86
2869,13,36,16,15,80
2870,17,19,16,15,67
2871,19,31,17,15,82
2872,0,31,17,15,63
2873,15,32,20,14,81
2874,17,15,20,14,66
2875,15,34,16,19,84
2876,0,34,16,19,69
2879,19,33,19,14,85
2880,0,33,19,14,66
2881,14,33,19,13,79
2882,19,14,19,13,65
2883,14,32,20,17,83
2885,13,37,15,17,82
2886,20,17,15,17,69
2887,17,32,15,19,83
2888,0,32,15,19,66
2889,17,34,15,18,84
2890,15,19,15,18,67
2891,19,33,18,12,82
2892,15,18,18,12,63
2893,18,30,0,19,67
2895,12,38,15,15,80
2896,19,19,15,15,68
2897,19,30,16,19,84
2899,15,35,15,17,82
2901,19,32,19,14,84
2903,17,33,18,16,84
2904,0,33,18,16,67
2905,14,34,18,18,84
2906,0,34,18,18,70
2907,16,36,14,17,83
2908,18,18,14,17,67
2909,18,31,19,16,84
2910,0,31,19,16,66
2911,17,35,16,17,85
2912,0,35,16,17,68
2913,16,33,14,17,80
2914,0,33,14,17,64
2916,14,17,16,19,66
2917,17,35,15,19,86
2918,16,19,15,19,69
2922,0,31,19,15,65
2924,19,15,19,12,65
2926,19,12,22,17,70
2927,12,39,13,17,81
2928,22,17,13,17,69
2930,13,17,19,18,67
2932,19,18,16,13,66
2934,16,13,19,14,62
2936,19,14,18,15,66
2937,14,33,18,19,84
2939,15,37,16,14,82
2942,0,30,19,15,64
2943,14,34,17,18,83
2945,15,35,17,16,83
2946,17,18,17,16,68
2947,18,33,16,18,85
2949,16,34,18,16,84
2951,18,34,14,18,84
2952,0,34,14,18,66
2954,14,18,18,13,63
2955,18,31,20,16,85
2957,13,36,15,19,83
2959,16,34,14,18,82
2960,0,34,14,18,66
2962,14,18,15,18,65
2963,18,33,16,18,85
2964,0,33,16,18,67
2967,18,35,17,16,86
2968,0,35,17,16,68
2972,0,32,19,12,63
2973,19,31,17,19,86
2975,12,36,14,20,82
2976,0,36,14,20,70
2977,19,34,15,17,85
2978,14,20,15,17,66
2979,20,32,15,18,85
2980,0,32,15,18,65
2981,17,33,18,14,82
2984,0,32,18,19,69
2987,19,33,14,16,82
2988,0,33,14,16,63
2989,15,30,18,15,78
2990,14,16,18,15,63
2993,15,36,17,18,86
2995,17,35,14,16,82
2996,17,18,14,16,65
2999,16,34,16,17,83
3000,19,15,16,17,67
3002,16,17,18,14,65
3003,17,32,18,17,84
3004,18,14,18,17,67
3005,14,35,16,17,82
3006,0,35,16,17,68
3008,0,33,18,17,68
3010,18,17,14,18,67
3011,17,32,16,18,83
3012,14,18,16,18,66
3014,16,18,18,16,68
3015,18,34,15,17,84
3016,0,34,15,17,66
3017,16,32,20,13,81
3018,15,17,20,13,65
3019,17,33,18,17,85
3021,13,35,15,17,80
3022,0,35,15,17,67
3023,17,32,16,20,85
3024,0,32,16,20,68
3027,20,27,19,17,83
3031,17,35,18,13,83
3032,0,35,18,13,66
3033,17,31,19,14,81
3034,0,31,19,14,64
3037,14,35,18,15,82
3039,16,33,18,17,84
3040,0,33,18,17,68
3042,18,17,14,17,66
3043,17,31,0,18,66
3044,0,31,0,18,49
3047,18,34,14,16,82
3051,16,33,19,17,85
3053,16,36,15,21,88
3054,0,36,15,21,72
3055,17,36,13,16,82
3056,0,36,13,16,65
3057,21,29,18,18,86
3060,18,18,15,18,69
3062,15,18,21,28,82
3063,18,21,12,16,67
3064,21,42,20,14,97
3065,12,30,20,14,76
3066,16,14,20,14,64
3067,0,14,20,14,48
3070,19,15,17,16,67
3071,15,33,18,15,81
3073,16,33,18,19,86
3074,0,33,18,19,70
3075,15,37,15,17,84
3077,19,32,17,16,84
3078,0,32,17,16,65
3080,0,33,16,19,68
3082,16,19,15,18,68
3083,19,33,14,20,86
3084,15,18,14,20,67
3085,18,34,14,17,83
3086,14,20,14,17,65
3089,17,32,19,14,82
3090,16,16,19,14,65
3091,16,33,18,18,85
3092,19,14,18,18,69
3093,14,36,15,18,83
3096,15,18,19,13,65
3097,18,32,17,17,84
3098,0,32,17,17,66
3099,13,34,15,18,80
3100,17,17,15,18,67
3103,18,33,18,18,87
3106,18,18,14,15,65
3108,0,29,18,17,64
3109,15,35,18,18,86
3110,18,17,18,18,71
3113,18,31,18,14,81
3116,18,14,18,18,68
3120,0,33,16,15,64
3121,17,31,18,18,84
3123,15,36,16,17,84
3124,18,18,16,17,69
3125,18,33,16,17,84
3126,16,17,16,17,66
3127,17,33,17,13,80
3129,17,30,18,19,84
3130,17,13,18,19,67
3131,0,13,18,19,50
3132,0,37,16,18,71
3134,16,18,16,16,66
3135,18,32,16,17,83
3136,16,16,16,17,65
3137,16,33,15,20,84
3138,0,33,15,20,68
3140,0,35,16,16,67
3141,20,32,16,15,83
3142,16,16,16,15,63
3143,16,31,18,17,82
3144,16,15,18,17,66
3145,15,35,17,19,86
3146,18,17,17,19,71
3147,17,36,17,15,85
3148,0,36,17,15,68
3149,19,32,15,16,82
3150,17,15,15,16,63
3151,15,31,17,16,79
3155,0,16,20,13,49
3156,20,13,17,17,67
3159,17,36,16,15,84
3160,0,36,16,15,67
3162,16,15,19,15,65
3164,0,34,18,14,66
3165,15,32,20,16,83
3166,18,14,20,16,68
3167,14,36,16,16,82
3168,20,16,16,16,68
3169,16,32,19,16,83
3170,0,32,19,16,67
3171,16,35,14,18,83
3172,0,35,14,18,67
3175,18,33,16,18,85
3177,15,34,16,18,83
3178,0,34,16,18,68
3179,18,34,15,17,84
3180,0,34,15,17,66
3181,18,32,19,16,85
3186,15,18,15,17,65
3187,18,32,19,14,83
3191,14,33,18,18,83
3193,15,36,15,20,86
3195,18,35,15,14,82
3197,20,29,15,18,82
3200,0,33,19,16,68
3202,19,16,15,18,68
3204,15,18,18,15,66
3205,18,33,16,18,85
3206,18,15,16,18,67
3207,15,34,16,18,83
3208,16,18,16,18,68
3211,18,32,16,17,83
3212,15,17,16,17,65
3213,17,33,18,15,83
3215,17,33,19,14,83
3217,15,33,19,17,84
3219,14,36,14,17,81
3220,0,36,14,17,67
3221,17,31,17,17,82
3222,14,17,17,17,65
3223,17,34,18,14,83
3224,17,17,18,14,66
3225,17,32,20,15,84
3226,18,14,20,15,67
3227,14,35,16,17,82
3228,0,35,16,17,68
3229,15,33,16,18,82
3230,16,17,16,18,67
3232,0,34,13,22,69
3234,13,22,14,17,66
3235,22,31,17,19,89
3236,14,17,17,19,67
3237,17,36,15,15,83
3238,0,36,15,15,66
3239,19,30,19,15,83
3240,15,15,19,15,64
3241,15,34,18,14,81
3244,0,32,18,17,67
3247,17,36,13,17,83
3248,19,17,13,17,66
3252,16,18,16,18,68
3253,18,34,16,14,82
3254,0,34,16,14,64
3256,16,14,20,15,65
3257,14,35,17,17,83
3258,0,35,17,17,69
3259,15,34,17,19,85
3260,17,17,17,19,70
3261,17,36,13,17,83
3263,19,30,17,16,82
3265,17,33,18,16,84
3267,16,34,16,22,88
3268,0,34,16,22,72
3269,16,38,12,18,84
3270,16,22,12,18,68
3272,0,30,17,16,63
3273,18,33,16,18,85
3277,18,34,15,16,83
3278,16,18,15,16,65
3279,18,31,18,16,83
3280,15,16,18,16,65
3281,16,34,16,17,83
3282,0,34,16,17,67
3283,16,33,16,18,83
3285,17,34,15,17,83
3286,0,34,15,17,66
3287,18,32,19,14,83
3288,0,32,19,14,65
3289,17,33,18,19,87
3296,16,14,18,14,62
3297,14,32,20,17,83
3298,18,14,20,17,69
3299,14,37,16,12,79
3300,20,17,16,12,65
3301,17,28,22,14,81
3302,16,12,22,14,64
3303,12,36,19,18,85
3304,0,36,19,18,73
3305,14,37,13,19,83
3306,19,18,13,19,69
3307,18,32,16,17,83
3308,13,19,16,17,65
3309,19,33,15,19,86
3310,0,33,15,19,67
3312,15,19,15,16,65
3313,19,31,16,18,84
3314,0,31,16,18,65
3315,16,34,15,20,85
3316,16,18,15,20,69
3317,18,35,14,19,86
3318,15,20,14,19,68
3319,20,33,15,16,84
3321,19,31,19,14,83
3322,15,16,19,14,64
3323,16,33,18,18,85
3324,19,14,18,18,69
3325,14,36,15,17,82
3326,18,18,15,17,68
3327,18,32,15,18,83
3328,15,17,15,18,65
3329,17,33,15,15,80
3330,15,18,15,15,63
3331,18,30,22,14,84
3332,0,30,22,14,66
3334,22,14,18,17,71
3337,17,34,17,13,81
3339,17,30,18,17,82
3341,13,35,17,14,79
3343,17,31,18,18,84
3344,17,14,18,18,67
3345,14,36,18,13,81
3346,0,36,18,13,67
3347,18,31,18,18,85
3351,18,31,20,14,83
3354,20,14,17,18,69
3356,0,35,16,15,66
3357,18,31,19,15,83
3358,16,15,19,15,65
3359,15,34,19,16,84
3360,19,15,19,16,69
3361,15,35,16,19,85
3362,0,35,16,19,70
3364,16,19,15,18,68
3366,15,18,17,15,65
3367,18,32,15,18,83
3369,15,33,15,18,81
3370,0,33,15,18,66
3372,15,18,15,19,67
3373,18,34,15,18,85
3375,19,33,15,18,85
3376,0,33,15,18,66
3378,15,18,17,20,70
3379,18,37,13,17,85
3380,0,37,13,17,67
3382,13,17,15,20,65
3384,15,20,14,18,67
3389,20,32,18,17,87
3390,13,19,18,17,67
3391,19,35,13,20,87
3392,18,17,13,20,68
3393,17,33,13,18,81
3395,20,31,16,18,85
3396,0,31,16,18,65
3397,18,34,15,17,84
3398,16,18,15,17,66
3399,18,32,18,19,87
3401,17,37,14,15,83
3403,19,29,17,18,83
3404,14,15,17,18,64
3406,0,35,17,18,70
3407,18,35,14,18,85
3410,0,32,15,18,65
3411,18,33,17,15,83
3412,0,33,17,15,65
3414,17,15,18,17,67
3415,15,35,18,14,82
3416,0,35,18,14,67
3418,18,14,19,16,67
3420,19,16,17,16,68
3421,16,33,15,17,81
3423,16,32,17,17,82
3424,15,17,17,17,66
3425,17,34,18,17,86
3426,17,17,18,17,69
3427,17,35,19,13,84
3428,18,17,19,13,67
3432,16,16,19,18,69
3433,16,37,14,19,86
3434,19,18,14,19,70
3435,18,33,14,18,83
3437,19,32,17,14,82
3439,18,31,19,17,85
3440,0,31,19,17,67
3441,14,36,15,17,82
3442,0,36,15,17,68
3445,17,35,16,14,82
3447,20,30,17,16,83
3448,0,30,17,16,63
3450,17,16,19,18,70
3451,16,37,14,17,84
3453,18,31,17,17,83
3454,14,17,17,17,65
3456,17,17,17,14,65
3457,17,31,18,18,84
3458,17,14,18,18,67
3459,14,36,15,20,85
3461,18,35,18,15,86
3462,0,35,18,15,68
3463,20,33,16,15,84
3464,18,15,16,15,64
3465,15,31,18,18,82
3466,16,15,18,18,67
3467,15,36,15,15,81
3468,18,18,15,15,66
3469,18,30,19,14,81
3470,0,30,19,14,63
3471,15,33,17,18,83
3472,19,14,17,18,68
3473,14,35,18,16,83
3474,0,35,18,16,69
3475,18,34,16,17,85
3476,18,16,16,17,67
3478,16,17,14,18,65
3480,0,32,18,16,66
3481,18,34,16,17,85
3482,0,34,16,17,67
3483,16,33,17,16,82
3486,17,16,17,18,68
3487,16,35,18,16,85
3488,0,35,18,16,69
3492,0,31,20,13,64
3493,17,33,20,17,87
3494,20,13,20,17,70
3495,13,37,16,18,84
3496,20,17,16,18,71
3497,17,34,13,17,81
3499,18,30,19,15,82
3500,0,30,19,15,64
3501,17,34,17,16,84
3502,0,34,17,16,67
3504,0,33,17,15,65
3505,16,32,17,20,85
3507,15,37,16,16,84
3508,17,20,16,16,69
3509,20,32,16,16,84
3510,0,32,16,16,64
3511,16,32,17,18,83
3512,0,32,17,18,67
3513,16,35,16,18,85
3517,18,31,16,17,82
3518,0,31,16,17,64
3522,0,36,15,17,68
3523,22,32,16,17,87
3525,17,33,37,9,96
3526,16,17,37,9,79
3527,17,37,9,11,74
3530,11,35,16,30,92
3531,0,35,16,30,81
3533,16,30,17,19,82
3537,19,14,18,18,69
3538,14,36,17,14,81
3539,18,18,17,14,67
3540,18,31,19,16,84
3541,0,31,19,16,66
3542,14,35,18,14,81
3543,0,35,18,14,67
3546,0,14,17,20,51
3547,0,37,19,12,68
3548,20,31,18,15,84
3549,19,12,18,15,64
3551,18,15,16,16,65
3553,0,32,16,20,68
3554,16,36,16,15,83
3555,16,20,16,15,67
3556,20,31,16,20,87
3559,0,36,15,18,69
3561,0,33,16,15,64
3562,18,31,17,19,85
3563,0,31,17,19,67
3564,15,36,14,20,85
3565,17,19,14,20,70
3566,19,34,13,18,84
3569,0,31,15,18,64
3571,0,33,18,16,67
3572,18,34,18,16,86
3573,18,16,18,16,68
3574,16,34,18,13,81
3575,18,16,18,13,65
3576,16,31,18,17,82
3577,0,31,18,17,66
3578,13,35,17,17,82
3582,17,34,15,16,82
3583,0,34,15,16,65
3584,19,31,16,19,85
3587,0,35,17,15,67
3588,19,32,19,15,85
3590,15,34,16,18,83
3591,19,15,16,18,68
3592,15,34,15,16,80
3593,16,18,15,16,65
3595,0,31,20,15,66
3596,16,35,16,17,84
3597,20,15,16,17,68
3598,15,33,16,16,80
3599,0,33,16,16,65
3602,16,34,19,31,100
3603,17,17,19,31,84
3604,17,50,16,18,101
3605,19,31,16,18,84
3606,13,18,16,18,65
3608,16,34,19,17,86
3609,18,16,19,17,70
3610,16,36,14,17,83
3611,19,17,14,17,67
3612,17,31,18,16,82
3614,0,17,18,16,51
3615,18,16,18,15,67
3616,16,33,16,17,82
3617,18,15,16,17,66
3618,15,33,16,19,83
3622,19,32,17,15,83
3623,0,32,17,15,64
3624,16,32,19,15,82
3626,0,15,19,15,49
3627,0,34,16,19,69
3629,16,19,16,18,69
3630,19,34,15,17,85
3631,16,18,15,17,66
3633,0,32,18,17,67
3635,0,35,13,20,68
3636,17,33,12,19,81
3637,0,33,12,19,64
3638,20,31,19,15,85
3639,12,19,19,15,65
3641,0,34,19,14,67
3642,15,33,15,18,81
3643,19,14,15,18,66
3644,14,33,16,19,82
3645,15,18,16,19,68
3646,18,35,16,15,84
3647,16,19,16,15,66
3648,19,31,19,17,86
3650,15,36,16,19,86
3651,0,36,16,19,71
3652,17,35,16,14,82
3653,16,19,16,14,65
3654,19,30,17,18,84
3658,18,32,17,18,85
3661,0,35,16,15,66
3664,15,33,19,15,82
3669,0,35,16,14,65
3672,14,34,17,19,84
3673,16,18,17,19,70
3674,18,36,15,16,85
3675,17,19,15,16,67
3676,19,31,18,16,84
3678,16,34,16,18,84
3682,18,32,20,15,85
3684,14,35,16,18,83
3685,20,15,16,18,69
3686,15,34,15,18,82
3688,18,33,15,17,83
3689,15,18,15,17,65
3691,15,17,18,15,65
3692,17,33,18,15,83
3693,0,33,18,15,66
3694,15,33,19,15,82
3697,19,15,19,15,68
3698,15,34,17,17,83
3699,19,15,17,17,68
3700,15,34,16,15,80
3702,17,31,16,20,84
3703,16,15,16,20,67
3705,16,20,16,15,67
3708,15,36,15,18,84
3709,18,18,15,18,69
3710,18,33,16,15,82
3711,15,18,16,15,64
3712,18,31,18,19,86
3713,16,15,18,19,68
3714,15,37,16,15,83
3715,18,19,16,15,68
3716,19,31,16,18,84
3717,16,15,16,18,65
3718,15,34,15,16,80
3719,16,18,15,16,65
3720,18,31,19,17,85
3722,16,36,16,17,85
3723,19,17,16,17,69
3724,17,33,14,18,82
3725,16,17,14,18,65
3726,17,32,16,18,83
3727,14,18,16,18,66
3728,18,34,15,17,84
3729,16,18,15,17,66
3731,15,17,16,18,66
3735,18,15,16,18,67
3736,15,34,22,15,86
3737,16,18,22,15,71
3739,22,15,15,15,67
3740,15,30,0,16,61
3741,0,30,0,16,46
3742,15,34,15,18,82
3744,18,33,16,18,85
3745,15,18,16,18,67
3746,18,34,15,16,83
3750,16,33,17,19,85
3751,0,33,17,19,69
3752,15,36,15,18,84
3753,0,36,15,18,69
3754,19,33,16,18,86
3755,15,18,16,18,67
3756,18,34,15,16,83
3757,16,18,15,16,65
3758,18,31,17,19,85
3760,16,36,15,19,86
3761,17,19,15,19,70
3762,19,34,16,15,84
3763,0,34,16,15,65
3766,15,34,16,16,81
3768,19,32,17,17,85
3769,16,16,17,17,66
3770,16,34,17,31,98
3771,17,17,17,31,82
3772,17,48,20,16,101
3774,14,17,20,16,67
3775,17,20,16,17,70
3777,16,17,15,18,66
3780,18,31,18,19,86
3781,0,31,18,19,68
3782,15,37,16,15,83
3783,0,37,16,15,68
3784,19,31,15,20,85
3785,16,15,15,20,66
3786,15,35,15,18,83
3788,20,33,15,18,86
3789,15,18,15,18,66
3791,15,18,17,15,65
3792,18,32,18,16,84
3793,0,32,18,16,66
3794,15,34,17,18,84
3795,0,34,17,18,69
3796,16,35,13,17,81
3797,17,18,13,17,65
3798,18,30,19,16,83
3800,17,35,14,21,87
3801,19,16,14,21,70
3802,16,35,17,13,81
3803,0,35,17,13,65
3804,21,30,18,17,86
3806,13,35,17,15,80
3807,18,17,17,15,67
3808,17,32,16,17,82
3809,17,15,16,17,65
3810,15,33,19,15,82
3811,0,33,19,15,67
3812,17,34,16,19,86
3814,15,35,16,17,83
3816,19,33,17,15,84
3817,16,17,17,15,65
3818,17,32,19,14,82
3819,17,15,19,14,65
3822,14,35,16,18,83
3827,0,32,15,19,66
3829,15,19,17,16,67
3830,19,33,15,18,85
3831,17,16,15,18,66
3832,16,33,16,19,84
3833,0,33,16,19,68
3834,18,35,15,17,85
3835,16,19,15,17,67
3836,19,32,18,16,85
3837,0,32,18,16,66
3838,17,34,15,16,82
3839,0,34,15,16,65
3841,15,16,16,19,66
3842,16,35,13,18,82
3843,0,35,13,18,66
3844,19,31,19,15,84
3845,13,18,19,15,65
3846,18,34,17,18,87
3847,19,15,17,18,69
3850,18,35,15,18,86
3851,18,17,15,18,68
3852,17,33,16,14,80
3853,0,33,16,14,63
3854,18,30,20,16,84
3855,16,14,20,16,66
3857,0,36,17,15,68
3860,15,34,17,14,80
3861,0,34,17,14,65
3864,14,35,16,18,83
3865,0,35,16,18,69
3866,16,34,16,18,84
3867,16,18,16,18,68
3868,18,34,15,18,85
3870,18,33,15,18,84
3871,15,18,15,18,66
3873,15,18,15,17,65
3874,18,32,19,31,100
3876,17,50,17,20,104
3878,0,31,17,20,68
3879,18,17,20,13,68
3880,0,17,20,13,50
3881,20,13,19,16,68
3882,0,13,19,16,48
3883,19,16,16,18,69
3885,0,34,15,18,67
3886,18,33,17,18,86
3888,18,35,13,19,85
3890,18,32,14,19,83
3892,19,33,14,18,84
3893,14,19,14,18,65
3894,19,32,17,18,86
3896,18,35,14,19,86
3897,17,18,14,19,68
3899,0,33,16,15,64
3900,19,31,17,17,84
3901,0,31,17,17,65
3903,0,34,17,17,68
3905,17,17,17,17,68
3907,0,34,18,14,66
3909,0,32,18,17,67
3910,14,35,14,18,81
3911,18,17,14,18,67
3912,17,32,17,16,82
3914,18,33,19,15,85
3915,0,33,19,15,67
3917,0,34,19,16,69
3918,15,35,15,15,80
3919,0,35,15,15,65
3920,0,16,15,15,46
3922,15,34,17,18,84
3923,21,13,17,18,69
3925,0,35,17,17,69
3926,18,34,16,16,84
3927,17,17,16,16,66
3928,17,32,16,19,84
3929,0,32,16,19,67
3930,16,35,16,14,81
3931,16,19,16,14,65
3932,19,30,17,19,85
3933,16,14,17,19,66
3935,0,36,14,17,67
3937,14,17,17,20,68
3939,17,20,13,17,67
3942,17,33,17,19,86
3943,20,13,17,19,69
3944,13,36,16,16,81
3945,0,36,16,16,68
3946,0,19,16,16,51
3947,16,16,15,18,65
3950,18,34,15,18,85
3951,18,16,15,18,67
3952,16,33,18,14,81
3953,0,33,18,14,65
3955,0,32,22,30,84
3956,14,52,17,14,97
3957,0,52,17,14,83
3958,11,19,17,14,61
3959,19,17,14,19,69
3960,17,33,16,15,81
3961,14,19,16,15,64
3962,0,19,16,15,50
3964,15,35,16,16,82
3966,16,32,17,19,84
3967,16,16,17,19,68
3970,19,31,17,16,83
3973,17,16,20,16,69
3974,16,36,14,18,84
3975,0,36,14,18,68
3976,16,32,18,15,81
3978,18,33,19,15,85
3980,15,34,15,17,81
3981,19,15,15,17,66
3983,0,32,18,17,67
3984,17,35,16,15,83
3986,17,31,15,21,84
3987,0,31,15,21,67
3988,15,36,16,16,83
3990,21,32,16,17,86
3991,16,16,16,17,65
3992,16,33,16,16,81
3993,16,17,16,16,65
3994,17,32,18,18,85
3995,0,32,18,18,68
3996,16,36,16,15,83
3997,0,36,16,15,67
3999,16,15,20,15,66
4000,15,35,15,19,84
4002,15,34,16,16,81
4005,16,16,19,18,69
4006,16,37,14,15,82
4007,19,18,14,15,66
4008,18,29,17,17,81
4010,15,34,17,17,83
4011,17,17,17,17,68
4012,17,34,17,17,85
4014,17,34,18,17,86
4016,17,35,13,19,84
4019,0,32,16,15,63
4020,19,31,20,14,84
4021,0,31,20,14,65
4022,15,34,16,18,83
4023,20,14,16,18,68
4024,14,34,15,18,81
4026,18,33,16,18,85
4027,15,18,16,18,67
4028,18,34,16,16,84
4029,16,18,16,16,66
4030,18,32,18,15,83
4031,16,16,18,15,65
4032,16,33,18,15,82
4033,18,15,18,15,66
4034,15,33,18,17,83
4035,18,15,18,17,68
4036,15,35,17,18,85
4037,18,17,17,18,70
4042,18,31,17,17,83
4043,0,31,17,17,65
4045,0,34,18,16,68
4046,17,34,16,19,86
4047,18,16,16,19,69
4048,16,35,15,18,84
4049,16,19,15,18,68
4051,15,18,16,17,66
4052,18,33,15,15,81
4053,16,17,15,15,63
4055,0,30,18,33,81
4057,18,33,16,19,86
4058,15,18,16,19,68
4060,16,35,16,18,85
4061,19,16,16,18,69
4062,16,34,16,16,82
4063,0,34,16,16,66
4064,18,32,16,18,84
4065,0,32,16,18,66
4066,16,34,17,15,82
4067,0,34,17,15,66
4068,18,32,19,14,83
4069,17,15,19,14,65
4070,15,33,19,16,83
4071,19,14,19,16,68
4072,14,35,18,15,82
4073,0,35,18,15,68
4074,16,33,18,16,83
4075,0,33,18,16,67
4076,15,34,16,16,81
4077,18,16,16,16,66
4081,18,17,17,17,69
4082,17,34,17,16,84
4083,17,17,17,16,67
4084,17,33,15,18,83
4085,0,33,15,18,66
4087,0,33,15,16,64
4089,15,16,17,18,66
4090,16,35,15,17,83
4093,0,32,17,16,65
4094,17,33,17,19,86
4095,0,33,17,19,69
4096,16,36,17,16,85
4098,19,33,18,32,102
4100,16,50,15,18,99
4101,0,50,15,18,83
4103,19,15,18,16,68
4104,15,34,16,17,82
4105,18,16,16,17,67
4106,0,16,16,17,49
4107,16,17,17,18,68
4108,17,35,15,17,84
4109,0,35,15,17,67
4110,18,32,16,19,85
4111,15,17,16,19,67
4112,17,35,16,15,83
4114,19,31,19,15,84
4115,0,31,19,15,65
4116,15,34,15,18,82
4117,0,34,15,18,67
4119,15,18,17,18,68
4120,18,35,16,15,84
4121,17,18,16,15,66
4122,18,31,19,15,83
4123,16,15,19,15,65
4124,15,34,19,15,83
4127,0,34,15,19,68
4128,15,34,16,17,82
4129,15,19,16,17,67
4130,19,33,16,17,85
4131,16,17,16,17,66
4133,0,33,15,18,66
4135,15,18,15,18,66
4137,0,33,16,17,66
4138,18,33,16,18,85
4139,0,33,16,18,67
4140,17,34,15,18,84
4142,18,33,17,17,85
4144,18,34,16,22,90
4146,17,38,12,15,82
4147,16,22,12,15,65
4148,22,27,20,14,83
4149,0,27,20,14,61
4150,15,34,17,16,82
4152,14,33,19,14,80
4153,17,16,19,14,66
4154,16,33,19,15,83
4155,19,14,19,15,67
4158,15,34,16,19,84
4161,16,19,15,18,68
4162,19,33,14,18,84
4164,18,32,18,15,83
4165,14,18,18,15,65
4166,18,33,17,16,84
4168,15,33,17,18,83
4169,0,33,17,18,68
4170,16,35,17,15,83
4173,17,15,19,16,67
4175,19,16,17,15,67
4177,0,32,15,18,65
4178,15,33,16,18,82
4179,15,18,16,18,67
4180,18,34,16,18,86
4181,0,34,16,18,68
4182,18,34,15,19,86
4183,0,34,15,19,68
4186,19,32,16,16,83
4187,0,32,16,16,64
4188,15,32,19,14,80
4189,0,32,19,14,65
4190,16,33,17,20,86
4191,19,14,17,20,70
4193,0,37,16,14,67
4195,0,30,20,14,64
4196,14,34,17,15,80
4197,20,14,17,15,66
4198,14,32,17,17,80
4199,0,32,17,17,66
4201,17,17,17,18,69
4202,17,35,16,18,86
4203,17,18,16,18,69
4204,18,34,16,16,84
4206,18,32,16,17,83
4207,16,16,16,17,65
4208,16,33,16,18,83
4209,0,33,16,18,67
4212,18,35,16,14,83
4213,15,20,16,14,65
4214,20,30,16,19,85
4216,14,35,15,19,83
4217,0,35,15,19,69
4218,19,34,15,18,86
4220,19,33,16,18,86
4223,16,18,15,18,67
4225,15,18,16,17,66
4226,18,33,15,19,85
4227,16,17,15,19,67
4228,17,34,16,17,84
4229,15,19,16,17,67
4231,16,17,17,17,67
4232,17,34,14,19,84
4233,17,17,14,19,67
4234,17,33,17,16,83
4235,14,19,17,16,66
4236,19,33,16,15,83
4237,0,33,16,15,64
4238,16,31,19,16,82
4239,0,31,19,16,66
4242,16,35,16,14,81
4244,19,30,20,14,83
4245,0,30,20,14,64
4247,20,14,19,14,67
4248,14,33,20,15,82
4249,19,14,20,15,68
4250,14,35,16,33,98
4251,0,35,16,33,84
4253,16,33,18,15,82
4255,18,18,15,18,69
4257,15,18,18,16,67
4259,0,34,15,18,67
4260,16,33,16,35,100
4263,16,35,15,15,81
4264,15,20,15,15,65
4265,20,15,15,19,69
4266,15,34,16,15,80
4268,0,19,16,15,50
4269,16,15,19,14,64
4270,15,33,19,15,82
4271,0,33,19,15,67
4273,0,34,19,15,68
4276,15,34,18,16,83
4277,0,34,18,16,68
4279,0,34,17,14,65
4282,14,34,15,19,82
4283,17,17,15,19,68
4285,15,19,17,17,68
4286,19,34,18,15,86
4287,17,17,18,15,67
4288,17,33,17,15,82
4290,15,32,18,32,97
4291,17,15,18,32,82
4292,15,50,19,15,99
4293,0,50,19,15,84
4296,0,19,15,16,50
4297,15,16,18,16,65
4298,16,34,18,16,84
4300,16,34,16,18,84
4301,18,16,16,18,68
4302,16,34,16,17,83
4305,16,17,17,14,64
4309,19,16,18,16,69
4310,16,34,15,18,83
4312,16,33,15,20,84
4314,18,35,16,17,86
4315,15,20,16,17,68
4317,16,17,15,18,66
4319,0,33,14,18,65
4320,18,32,15,20,85
4321,0,32,15,20,67
4322,18,35,15,18,86
4324,20,33,15,18,86
4326,18,33,15,19,85
4328,18,34,15,16,83
4330,19,31,16,18,84
4331,0,31,16,18,65
4332,16,34,15,20,85
4334,18,35,15,19,87
4336,20,34,15,17,86
4337,15,19,15,17,66
4338,19,32,17,15,83
4340,17,32,19,15,83
4341,17,15,19,15,66
4343,19,15,19,14,67
4344,15,33,17,16,81
4346,14,33,18,15,80
4349,0,33,18,18,69
4350,15,36,15,15,81
4351,0,36,15,15,66
4352,18,30,18,16,82
4353,15,15,18,16,64
4354,15,34,17,17,83
4355,18,16,17,17,68
4356,16,34,17,19,86
4359,0,36,14,19,69
4360,19,33,15,18,85
4361,0,33,15,18,66
4363,15,18,14,16,63
4364,0,18,14,16,48
4365,14,16,19,16,65
4367,19,16,17,15,67
4368,16,32,16,18,82
4369,17,15,16,18,66
4371,0,34,19,16,69
4376,18,31,19,15,83
4377,17,14,19,15,65
4378,14,34,16,18,82
4379,0,34,16,18,68
4381,16,18,16,16,66
4385,19,15,16,20,70
4386,15,36,12,17,80
4387,16,20,12,17,65
4388,20,29,18,18,85
4389,12,17,18,18,65
4390,17,36,16,33,102
4392,18,49,18,14,99
4393,16,33,18,14,81
4394,14,19,18,14,65
4395,19,18,14,18,69
4396,18,32,16,18,84
4397,14,18,16,18,66
4398,0,18,16,18,52
4399,16,18,17,16,67
4402,16,34,14,18,82
4404,17,32,17,16,82
4406,18,33,16,19,86
4408,16,35,16,15,82
4409,0,35,16,15,66
4410,19,31,18,16,84
4411,0,31,18,16,65
4412,15,34,16,19,84
4414,16,35,17,15,83
4419,0,34,16,17,67
4421,0,33,18,17,68
4422,17,35,14,17,83
4423,18,17,14,17,66
4424,17,31,17,17,82
4425,14,17,17,17,65
4427,0,34,17,16,67
4428,17,33,16,18,84
4429,17,16,16,18,67
4431,16,18,17,15,66
4432,18,32,17,19,86
4433,0,32,17,19,68
4434,15,36,17,16,84
4436,19,33,16,15,83
4437,17,16,16,15,64
4438,16,31,16,19,82
4440,15,35,17,17,84
4441,16,19,17,17,69
4442,19,34,16,18,87
4444,0,17,16,18,51
4445,0,34,16,16,66
4446,18,32,16,18,84
4447,16,16,16,18,66
4449,16,18,17,15,66
4450,18,32,16,18,84
4451,0,32,16,18,66
4452,15,34,15,19,83
4454,18,34,17,17,86
4455,15,19,17,17,68
4456,19,34,13,17,83
4457,0,34,13,17,64
4459,13,17,19,18,67
4460,0,17,19,18,54
4461,0,37,12,18,67
4462,18,30,18,16,82
4464,0,18,18,16,52
4466,16,39,10,17,82
4468,23,27,18,17,85
4470,17,35,17,17,86
4471,18,17,17,17,69
4472,17,34,16,17,84
4473,17,17,16,17,67
4474,17,33,17,15,82
4476,17,32,16,19,84
4477,0,32,16,19,67
4478,15,35,15,16,81
4480,19,31,17,19,86
4482,16,36,15,17,84
4483,17,19,15,17,68
4484,19,32,16,19,86
4486,17,35,15,17,84
4489,15,17,16,17,65
4490,17,33,17,17,84
4491,16,17,17,17,67
4493,0,34,15,17,66
4494,17,32,19,15,83
4495,15,17,19,15,66
4496,17,34,15,19,85
4497,19,15,15,19,68
4499,0,34,17,14,65
4500,19,31,19,17,86
4501,0,31,19,17,67
4502,14,36,13,20,83
4503,0,36,13,20,69
4504,17,33,14,20,84
4506,0,20,14,20,54
4507,0,34,14,20,68
4508,20,34,14,16,84
4510,20,30,18,17,85
4511,14,16,18,17,65
4512,16,35,17,16,84
4514,17,33,18,16,84
4515,17,16,18,16,67
4516,16,34,16,16,82
4517,0,34,16,16,66
4518,16,32,15,19,82
4519,16,16,15,19,66
4521,15,19,16,18,68
4523,0,34,16,16,66
4526,16,33,17,18,84
4528,16,35,17,14,82
4530,18,31,18,17,84
4532,14,35,16,17,82
4533,18,17,16,17,68
4534,17,33,15,20,85
4536,17,35,15,18,85
4538,20,33,15,22,90
4539,15,18,15,22,70
4540,18,37,10,19,84
4541,15,22,10,19,66
4542,22,29,16,19,86
4543,10,19,16,19,64
4544,19,35,17,13,84
4545,0,35,17,13,65
4547,17,13,17,16,63
4548,13,33,18,17,81
4549,0,33,18,17,68
4550,16,35,17,18,86
4552,17,35,16,16,84
4555,16,16,18,16,66
4556,16,34,15,18,83
4557,0,34,15,18,67
4559,15,18,17,16,66
4560,18,33,15,18,84
4561,17,16,15,18,66
4565,16,35,16,16,83
4566,15,20,16,16,67
4569,16,16,16,20,68
4572,20,33,16,18,87
4573,0,33,16,18,67
4574,0,16,16,18,50
4576,18,33,15,15,81
4577,0,33,15,15,63
4579,15,15,21,30,81
4580,15,51,17,15,98
4581,0,51,17,15,83
4582,12,18,17,15,62
4583,18,17,15,20,70
4584,17,35,15,20,87
4585,15,20,15,20,70
4586,0,20,15,20,55
4587,15,20,12,20,67
4589,12,20,16,14,62
4590,20,30,19,15,84
4591,16,14,19,15,64
4592,14,34,19,15,82
4593,19,15,19,15,68
4594,15,34,18,14,81
4597,18,14,19,14,65
4600,14,34,16,20,84
4601,0,34,16,20,70
4602,14,36,14,20,84
4603,16,20,14,20,70
4606,20,33,15,15,83
4607,0,33,15,15,63
4608,19,30,18,19,86
4609,15,15,18,19,67
4611,0,37,14,19,70
4612,19,33,15,16,83
4613,14,19,15,16,64
4615,15,16,16,20,67
4617,16,20,15,15,66
4618,20,30,18,15,83
4619,0,30,18,15,63
4621,0,33,19,15,67
4622,15,34,17,17,83
4624,15,34,17,17,83
4627,17,17,17,16,67
4628,17,33,16,16,82
4629,0,33,16,16,65
4633,16,19,15,17,67
4634,19,32,20,13,84
4636,17,33,19,18,87
4637,0,33,19,18,70
4638,13,37,16,16,82
4639,19,18,16,16,69
4640,18,32,17,15,82
4641,16,16,17,15,64
4645,0,32,18,19,69
4646,16,37,14,18,85
4647,18,19,14,18,69
4649,14,18,18,16,66
4650,18,34,14,20,86
4652,16,34,16,15,81
4653,14,20,16,15,65
4655,0,31,19,15,65
4657,19,15,18,14,66
4658,15,32,19,15,81
4660,14,34,16,17,81
4661,19,15,16,17,67
4663,0,33,16,17,66
4664,17,33,20,15,85
4665,16,17,20,15,68
4667,20,15,15,18,68
4669,15,18,15,19,67
4670,18,34,15,19,86
4676,15,33,19,15,82
4677,0,33,19,15,67
4678,15,34,18,16,83
4679,19,15,18,16,68
4682,16,32,17,18,83
4683,15,17,17,18,67
4684,17,35,17,14,83
4685,0,35,17,14,66
4686,18,31,18,19,86
4687,0,31,18,19,68
4688,14,37,13,18,82
4689,18,19,13,18,68
4691,0,31,16,19,66
4694,19,30,19,16,84
4695,15,15,19,16,65
4697,19,16,15,18,68
4700,18,33,18,15,84
4701,0,33,18,15,66
4702,16,33,18,19,86
4705,0,37,14,17,68
4707,0,31,17,17,65
4708,17,34,17,16,84
4709,17,17,17,16,67
4710,0,17,17,16,50
4711,17,16,17,16,66
4712,16,33,16,17,82
4713,0,33,16,17,66
4715,16,17,15,18,66
4716,17,33,18,15,83
4717,0,33,18,15,66
4720,15,37,16,14,82
4721,0,37,16,14,67
4722,20,30,22,11,83
4723,0,30,22,11,63
4725,0,33,19,15,67
4727,19,15,18,16,68
4728,15,34,16,18,83
4729,18,16,16,18,68
4730,16,34,15,19,84
4731,0,34,15,19,68
4732,18,34,16,16,84
4733,15,19,16,16,66
4734,19,32,17,16,84
4736,16,33,16,17,82
4738,16,33,18,17,84
4739,16,17,18,17,68
4741,18,17,14,17,66
4742,17,31,16,18,82
4745,16,18,16,33,83
4746,18,49,19,14,100
4747,16,33,19,14,82
4748,15,18,19,14,66
4749,18,19,14,17,68
4750,0,19,14,17,50
4751,14,17,17,17,65
4752,17,34,18,14,83
4753,17,17,18,14,66
4755,18,14,20,14,66
4756,14,34,23,13,84
4757,0,34,23,13,70
4758,14,36,15,16,81
4759,23,13,15,16,67
4762,16,33,17,20,86
4763,0,33,17,20,70
4765,17,20,16,15,68
4766,20,31,16,19,86
4767,16,15,16,19,66
4768,15,35,17,13,80
4769,0,35,17,13,65
4770,19,30,17,17,83
4772,13,34,17,17,81
4773,0,34,17,17,68
4774,17,34,18,15,84
4775,0,34,18,15,67
4777,0,33,15,19,67
4778,15,34,15,18,82
4779,15,19,15,18,67
4781,15,18,16,19,68
4782,18,35,16,15,84
4783,16,19,16,15,66
4785,0,31,18,15,64
4787,18,15,16,18,67
4788,15,34,16,20,85
4792,20,30,18,15,83
4793,0,30,18,15,63
4795,0,33,19,14,66
4797,19,14,19,15,67
4798,14,34,19,15,82
4799,19,15,19,15,68
4800,15,34,16,18,83
4801,0,34,16,18,68
4802,15,34,15,18,82
4803,0,34,15,18,67
4806,18,35,17,14,84
4808,19,31,16,17,83
4809,17,14,16,17,64
4810,14,33,19,15,81
4811,0,33,19,15,67
4812,17,34,15,19,85
4813,0,34,15,19,68
4814,15,34,18,15,82
4819,16,18,16,16,66
4820,18,32,19,15,84
4821,0,32,19,15,66
4822,16,34,19,15,84
4825,19,15,16,17,67
4826,15,33,17,16,81
4827,16,17,17,16,66
4828,17,33,16,18,84
4831,16,18,17,14,65
4832,18,31,19,15,83
4833,17,14,19,15,65
4834,14,34,17,18,83
4835,19,15,17,18,69
4836,15,35,16,16,82
4837,0,35,16,16,67
4839,16,16,20,16,68
4840,16,36,16,15,83
4842,16,31,17,15,79
4843,0,31,17,15,63
4844,15,32,19,16,82
4845,17,15,19,16,67
4846,15,35,16,18,84
4847,19,16,16,18,69
4849,0,34,17,14,65
4851,17,14,20,15,66
4854,15,33,15,18,81
4855,16,17,15,18,66
4856,17,33,16,18,84
4857,15,18,16,18,67
4858,18,34,16,16,84
4859,16,18,16,16,66
4860,18,32,19,15,84
4861,16,16,19,15,66
4862,16,34,16,18,84
4863,0,34,16,18,68
4864,15,34,17,19,85
4865,0,34,17,19,70
4866,18,36,16,15,85
4870,15,35,13,19,82
4871,0,35,13,19,67
4872,16,32,16,15,79
4874,19,31,18,18,86
4875,16,15,18,18,67
4876,15,36,16,15,82
4877,0,36,16,15,67
4878,18,31,17,19,85
4880,15,36,15,19,85
4881,17,19,15,19,70
4887,18,15,19,15,67
4888,15,34,18,15,82
4889,19,15,18,15,67
4891,0,33,19,14,66
4893,19,14,17,22,72
4894,14,39,13,15,81
4895,0,39,13,15,67
4898,15,35,18,17,85
4901,0,35,14,16,65
4902,17,30,18,17,82
4903,0,30,18,17,65
4904,16,35,16,18,85
4905,0,35,16,18,69
4906,17,34,15,18,84
4907,0,34,15,18,67
4908,18,33,16,16,83
4909,0,33,16,16,65
4910,18,32,18,15,83
4911,0,32,18,15,65
4914,15,34,18,15,82
4915,19,15,18,15,67
4916,15,33,18,15,81
4917,0,33,18,15,66
4918,15,33,17,16,81
4920,15,33,17,17,82
4922,16,34,16,18,84
4924,17,34,17,18,86
4925,16,18,17,18,69
4926,18,35,16,31,100
4927,17,18,16,31,82
4928,18,47,18,18,101
4929,16,31,18,18,83
4930,14,17,18,18,67
4931,17,18,18,14,67
4933,18,14,18,18,68
4934,14,36,14,18,82
4935,18,18,14,18,68
4936,18,32,16,17,83
4937,0,32,16,17,65
4938,18,33,16,21,88
4942,21,30,18,16,85
4943,0,30,18,16,64
4944,15,34,16,15,80
4945,0,34,16,15,65
4946,16,31,19,18,84
4947,16,15,19,18,68
4948,15,37,13,18,83
4950,18,31,16,16,81
4952,18,32,19,18,87
4953,16,16,19,18,69
4954,16,37,15,18,86
4956,18,33,15,16,82
4957,0,33,15,16,64
4958,18,31,17,19,85
4959,0,31,17,19,67
4960,16,36,15,16,83
4961,17,19,15,16,67
4962,19,31,16,20,86
4963,15,16,16,20,67
4964,16,36,15,16,83
4965,16,20,15,16,67
4966,20,31,19,15,85
4968,16,34,15,18,83
4969,0,34,15,18,67
4970,15,33,17,17,82
4971,15,18,17,17,67
4972,18,34,17,15,84
4974,17,32,16,19,84
4978,19,33,17,15,84
4979,0,33,17,15,65
4980,18,32,18,15,83
4981,0,32,18,15,65
4982,15,33,17,18,83
4985,0,35,15,19,69
4986,18,34,15,16,83
4987,15,19,15,16,65
4988,19,31,19,15,84
4989,15,16,19,15,65
4991,19,15,16,16,66
4992,15,32,18,18,83
4995,18,18,15,17,68
4997,15,17,15,20,67
4999,15,20,13,18,66
5000,20,31,20,15,86
5003,0,35,16,17,68
5004,15,33,16,15,79
5006,17,31,20,17,85
5007,0,31,20,17,68
5008,15,37,16,17,85
5010,17,33,14,17,81
5013,0,31,16,19,66
5014,17,35,14,19,85
5015,16,19,14,19,68
5016,19,33,18,17,87
5019,0,35,15,16,66
5020,17,31,15,19,82
5021,0,31,15,19,65
5022,16,34,15,17,82
5023,0,34,15,17,66
5024,19,32,19,14,84
5026,17,33,19,15,84
5027,0,33,19,15,67
5028,14,34,16,18,82
5029,0,34,16,18,68
5030,15,34,16,18,83
5032,18,34,17,15,84
5033,16,18,17,15,66
5034,18,32,20,16,86
5035,17,15,20,16,68
5036,15,36,13,18,82
5037,20,16,13,18,67
5040,18,33,16,18,85
5042,17,34,15,18,84
5044,18,33,16,17,84
5045,15,18,16,17,66
5046,18,33,16,19,86
5047,0,33,16,19,68
5049,0,35,16,18,69
5050,19,34,16,15,84
5052,18,31,16,18,83
5053,16,15,16,18,65
5055,16,18,17,15,66
5057,17,15,19,15,66
5058,15,34,17,17,83
5060,15,34,15,19,83
5061,0,34,15,19,68
5062,17,34,15,19,85
5064,19,34,14,18,85
5065,15,19,14,18,66
5066,19,32,16,18,85
5067,14,18,16,18,66
5068,18,34,16,20,88
5070,18,36,13,17,84
5071,16,20,13,17,66
5072,20,30,16,18,84
5075,16,18,16,17,67
5076,18,33,16,18,85
5077,0,33,16,18,67
5078,17,34,15,19,85
5079,16,18,15,19,68
5080,18,34,15,19,86
5081,0,34,15,19,68
5083,0,34,15,15,64
5084,19,30,17,16,82
5085,0,30,17,16,63
5088,16,36,15,19,86
5090,18,34,16,14,82
5091,15,19,16,14,64
5092,19,30,19,14,82
5093,0,30,19,14,63
5094,14,33,19,16,82
5095,0,33,19,16,68
5096,14,35,15,19,83
5097,0,35,15,19,69
5098,16,34,15,17,82
5100,19,32,16,17,84
5101,15,17,16,17,65
5102,17,33,16,19,85
5103,0,33,16,19,68
5105,16,19,15,16,66
5108,16,34,20,14,84
5109,20,14,20,14,68
5110,14,34,15,19,82
5111,0,34,15,19,68
5113,15,19,17,14,65
5114,19,31,20,14,84
5116,14,34,16,19,83
5117,0,34,16,19,69
5118,14,35,16,18,83
5119,16,19,16,18,69
5124,16,34,19,16,85
5125,19,15,19,16,69
5126,15,35,16,16,82
5127,0,35,16,16,67
5129,16,16,15,18,65
5130,16,33,17,18,84
5133,17,18,16,15,66
5134,18,31,19,14,82
5135,0,31,19,14,64
5136,15,33,19,16,83
5137,19,14,19,16,68
5138,14,35,16,16,81
5139,19,16,16,16,67
5141,16,16,17,19,68
5142,16,36,16,14,82
5143,0,36,16,14,66
5144,19,30,17,17,83
5145,16,14,17,17,64
5146,14,34,18,18,84
5147,17,17,18,18,70
5148,17,36,16,15,84
5149,18,18,16,15,67
5150,18,31,16,19,84
5152,15,35,16,15,81
5154,19,31,19,14,83
5155,0,31,19,14,64
5156,15,33,19,16,83
5158,14,35,16,18,83
5161,0,34,15,18,67
5162,18,33,16,18,85
5164,18,34,15,16,83
5165,0,34,15,16,65
5166,18,31,18,18,85
5167,15,16,18,18,67
5168,16,36,16,15,83
5169,18,18,16,15,67
5170,18,31,19,15,83
5171,0,31,19,15,65
5172,15,34,19,15,83
5175,19,15,15,19,68
5176,15,34,17,20,86
5177,15,19,17,20,71
5179,0,37,12,16,65
5181,12,16,20,15,63
5182,16,35,16,18,85
5183,0,35,16,18,69
5184,15,34,16,15,80
5185,0,34,16,15,65
5187,16,15,16,18,65
5188,15,34,19,14,82
5189,16,18,19,14,67
5190,18,33,16,19,86
5191,19,14,16,19,68
5192,14,35,16,16,81
5193,16,19,16,16,67
5194,19,32,16,18,85
5196,16,34,15,18,83
5197,16,18,15,18,67
5198,18,33,15,18,84
5201,0,33,17,18,68
5202,18,35,15,18,86
5203,0,35,15,18,68
5204,18,33,16,15,82
5205,15,18,16,15,64
5206,18,31,19,15,83
5207,0,31,19,15,65
5208,15,34,16,19,84
5209,0,34,16,19,69
5210,15,35,15,18,83
5211,16,19,15,18,68
5213,15,18,16,18,67
5215,0,34,16,15,65
5216,18,31,19,15,83
5218,15,34,15,19,83
5219,0,34,15,19,68
5220,15,34,15,16,80
5222,19,31,19,17,86
5223,15,16,19,17,67
5225,19,17,16,16,68
5229,19,15,16,16,66
5231,16,16,17,18,67
5232,16,35,16,18,85
5233,17,18,16,18,69
5234,18,34,15,17,84
5235,16,18,15,17,66
5236,18,32,17,15,82
5238,17,32,20,15,84
5239,0,32,20,15,67
5240,15,35,15,19,84
5241,0,35,15,19,69
5243,15,19,17,14,65
5244,19,31,18,18,86
5247,0,36,15,18,69
5248,18,33,16,18,85
5249,15,18,16,18,67
5250,18,34,17,14,83
5252,18,31,16,20,85
5253,17,14,16,20,67
5256,20,32,16,18,86
5257,15,17,16,18,66
5258,17,34,16,17,84
5260,18,33,15,18,84
5261,0,33,15,18,66
5262,17,33,17,15,82
5265,17,15,18,15,65
5266,15,33,19,15,82
5267,0,33,19,15,67
5268,15,34,16,18,83
5269,19,15,16,18,68
5271,16,18,16,16,66
5272,18,32,19,14,83
5273,16,16,19,14,65
5274,16,33,19,16,84
5275,0,33,19,16,68
5276,14,35,15,19,83
5278,16,34,16,18,84
5279,15,19,16,18,68
5282,18,32,17,18,85
5283,15,17,17,18,67
5284,17,35,16,14,82
5286,18,30,18,18,84
5289,0,36,16,15,67
5290,18,31,16,19,84
5293,0,35,16,16,67
5294,19,32,19,15,85
5297,0,34,16,18,68
5298,15,34,16,18,83
5299,0,34,16,18,68
5300,18,34,16,14,82
5301,16,18,16,14,64
5302,18,30,20,15,83
5303,16,14,20,15,65
5305,20,15,16,19,70
5306,15,35,15,18,83
5307,16,19,15,18,68
5308,19,33,15,19,86
5310,18,34,14,19,85
5312,19,33,16,16,84
5313,14,19,16,16,65
5315,0,32,17,18,67
5316,16,35,16,14,81
5317,0,35,16,14,65
5318,18,30,16,18,82
5322,18,33,17,16,84
5323,18,15,17,16,66
5324,15,33,18,20,86
5325,0,33,18,20,71
5326,16,38,13,18,85
5327,0,38,13,18,69
5328,20,31,14,17,82
5329,0,31,14,17,62
5330,18,31,17,18,84
5333,0,35,15,18,68
5335,0,33,16,17,66
5336,18,33,16,19,86
5337,16,17,16,19,68
5338,17,35,16,16,84
5339,16,19,16,16,67
5340,19,32,16,18,85
5341,0,32,16,18,66
5342,16,34,16,18,84
5343,0,34,16,18,68
5346,18,31,18,18,85
5347,0,31,18,18,67
5348,15,36,15,17,83
5349,18,18,15,17,68
5350,18,32,18,31,99
5351,15,17,18,31,81
5353,0,49,18,17,84
5355,18,18,17,16,69
5357,17,16,16,17,66
5358,16,33,17,17,83
5359,0,33,17,17,67
5361,17,17,18,30,82
5362,17,48,19,30,114
5364,13,17,19,30,79
5366,0,19,14,16,49
5367,14,34,17,17,82
5368,16,18,17,17,68
5369,0,18,17,17,52
5371,17,36,14,18,85
5372,0,36,14,18,68
5374,0,14,18,15,47
5375,18,15,17,17,67
5378,17,34,17,14,82
5380,18,31,17,17,83
5382,14,34,17,17,82
5385,0,34,16,19,69
5387,0,35,18,15,68
5388,19,33,15,16,83
5389,18,15,15,16,64
5390,15,31,17,19,82
5393,17,19,17,15,68
5394,19,32,17,16,84
5395,0,32,17,16,65
5397,17,16,16,16,65
5400,16,34,16,20,86
5401,19,15,16,20,70
5402,15,36,15,16,82
5403,16,20,15,16,67
5406,16,35,16,15,82
5407,16,19,16,15,66
5408,19,31,19,15,84
5411,0,34,16,18,68
5412,15,34,17,16,82
5413,16,18,17,16,67
5415,0,33,17,18,68
5416,16,35,17,16,84
5417,17,18,17,16,68
5418,18,33,16,17,84
5419,17,16,16,17,66
5421,16,17,17,18,68
5422,17,35,16,15,83
5425,16,15,17,16,64
5426,15,33,15,19,82
5427,0,33,15,19,67
5428,16,34,15,19,84
5429,0,34,15,19,68
5431,0,34,15,17,66
5432,19,32,17,18,86
5433,0,32,17,18,67
5434,17,35,16,18,86
5435,0,35,16,18,69
5436,18,34,13,18,83
5438,18,31,16,18,83
5440,18,34,16,16,84
5442,18,32,19,16,85
5444,16,35,18,17,86
5447,0,35,14,18,67
5448,17,32,14,19,82
5449,0,32,14,19,65
5450,18,33,16,19,86
5451,0,33,16,19,68
5453,16,19,17,15,67
5454,19,32,16,15,82
5455,17,15,16,15,63
5456,15,31,18,18,82
5457,16,15,18,18,67
5458,15,36,17,15,83
5459,18,18,17,15,68
5460,18,32,16,16,82
5461,17,15,16,16,64
5462,15,32,19,15,81
5464,16,34,16,19,85
5465,19,15,16,19,69
5466,15,35,16,18,84
5467,16,19,16,18,69
5468,19,34,17,15,85
5469,0,34,17,15,66
5470,18,32,16,19,85
5473,16,19,13,18,66
5474,19,31,18,15,83
5476,18,33,16,20,87
5479,0,36,15,15,66
5480,20,30,20,15,85
5481,15,15,20,15,65
5482,15,35,15,19,84
5483,20,15,15,19,69
5486,19,34,16,15,84
5487,0,34,16,15,65
5488,17,31,19,15,82
5489,0,31,19,15,65
5490,15,34,19,16,84
5492,15,35,16,32,98
5493,0,35,16,32,83
5494,16,48,16,17,97
5495,0,48,16,17,81
5497,18,16,17,16,67
5498,16,33,19,18,86
5499,17,16,19,18,70
5500,0,16,19,18,53
5501,19,18,15,16,68
5502,18,31,18,19,86
5504,16,37,16,14,83
5505,18,19,16,14,67
5506,19,30,15,19,83
5508,14,34,15,19,82
5509,15,19,15,19,68
5512,19,30,19,15,83
5513,0,30,19,15,64
5516,15,35,16,18,84
5519,0,34,15,18,67
5521,15,18,16,15,64
5522,18,31,19,15,83
5523,0,31,19,15,65
5524,15,34,18,15,82
5525,19,15,18,15,67
5528,15,34,16,18,83
5531,16,18,16,19,69
5534,19,30,19,15,83
5537,19,15,18,16,68
5538,15,34,17,21,87
5539,0,34,17,21,72
5541,17,21,12,18,68
5543,12,18,15,17,62
5544,18,32,18,15,83
5545,15,17,18,15,65
5546,17,33,19,14,83
5547,18,15,19,14,66
5548,15,33,19,16,83
5549,19,14,19,16,68
5550,14,35,16,18,83
5551,0,35,16,18,69
5553,16,18,14,18,66
5554,18,32,16,17,83
5555,14,18,16,17,65
5556,18,33,18,16,85
5557,16,17,18,16,67
5558,17,34,16,16,83
5561,16,16,18,16,66
5563,18,16,17,18,69
5564,16,35,16,17,84
5565,17,18,16,17,68
5567,16,17,17,14,64
5568,17,31,17,17,82
5569,17,14,17,17,65
5571,17,17,16,18,68
5572,17,34,16,18,85
5573,0,34,16,18,68
5574,18,34,17,15,84
5577,17,15,16,18,66
5578,15,34,15,20,84
5580,18,35,16,15,84
5582,20,31,16,19,86
5584,15,35,16,18,84
5587,16,18,15,16,65
5588,18,31,17,18,84
5589,15,16,17,18,66
5590,16,35,16,15,82
5593,16,15,19,16,66
5594,15,35,16,18,84
5595,19,16,16,18,69
5599,17,15,16,18,66
5600,15,34,16,19,84
5601,16,18,16,19,69
5602,18,35,19,13,85
5604,19,32,14,18,83
5605,19,13,14,18,64
5608,18,35,15,17,85
5610,16,32,14,21,83
5611,0,32,14,21,67
5613,14,21,17,16,68
5614,21,33,15,20,89
5615,17,16,15,20,68
5618,20,33,16,17,86
5620,20,33,16,16,85
5621,16,17,16,16,65
5622,17,32,18,17,84
5623,0,32,18,17,67
5625,0,35,16,18,69
5626,17,34,14,17,82
5629,0,31,17,16,64
5630,17,33,18,17,85
5631,17,16,18,17,68
5632,16,35,15,15,81
5633,0,35,15,15,65
5635,0,30,20,27,77
5637,0,47,7,14,68
5638,27,21,18,16,82
5640,0,14,18,16,48
5641,18,16,16,17,67
5642,16,33,17,17,83
5643,16,17,17,17,67
5644,17,34,14,20,85
5645,17,17,14,20,68
5646,17,34,14,18,83
5648,20,32,22,10,84
5652,10,37,13,18,78
5653,18,19,13,18,68
5654,19,31,17,17,84
5655,13,18,17,17,65
5657,17,17,19,15,68
5658,17,34,16,17,84
5661,0,33,16,15,64
5663,16,15,0,19,50
5664,15,34,16,18,83
5665,0,34,16,18,68
5666,15,34,16,35,100
5667,16,18,16,35,85
5668,18,51,15,18,102
5669,16,35,15,18,84
5671,20,15,18,16,69
5672,0,15,18,16,49
5673,18,16,15,19,68
5675,15,19,16,17,67
5677,16,17,16,15,64
5678,17,31,18,17,83
5679,16,15,18,17,66
5680,15,35,16,19,85
5681,0,35,16,19,70
5682,17,35,14,19,85
5684,19,33,16,14,82
5686,19,30,20,17,86
5687,16,14,20,17,67
5689,0,37,16,14,67
5690,17,30,23,13,83
5691,0,30,23,13,66
5693,23,13,17,16,69
5695,17,16,17,17,67
5697,17,17,17,14,65
5698,17,31,17,16,81
5699,17,14,17,16,64
5700,14,33,18,15,80
5703,18,15,20,18,71
5704,15,38,16,14,83
5705,0,38,16,14,68
5706,18,30,17,15,80
5707,0,30,17,15,62
5708,14,32,19,17,82
5709,17,15,19,17,68
5710,15,36,17,17,85
5712,17,34,13,17,81
5713,0,34,13,17,64
5715,13,17,17,19,66
5716,17,36,16,15,84
5717,0,36,16,15,67
5719,0,31,20,14,65
5721,0,34,20,16,70
5722,14,36,16,19,85
5723,20,16,16,19,71
5724,16,35,12,18,81
5729,0,33,16,19,68
5731,0,35,17,16,68
5732,19,33,16,16,84
5733,17,16,16,16,65
5736,16,34,17,16,83
5737,15,19,17,16,67
5738,19,33,15,17,84
5739,0,33,15,17,65
5741,15,17,17,16,65
5742,17,33,20,16,86
5743,17,16,20,16,69
5744,16,36,15,19,86
5746,16,34,14,19,83
5748,19,33,15,15,82
5751,15,15,20,16,66
5752,15,36,17,16,84
5753,20,16,17,16,69
5755,0,33,15,19,67
5756,16,34,17,14,81
5757,0,34,17,14,65
5758,19,31,16,35,101
5759,17,14,16,35,82
5760,14,51,16,16,97
5763,19,16,16,19,70
5765,16,19,17,15,67
5766,19,32,17,18,86
5767,17,15,17,18,67
5768,15,35,16,15,81
5769,0,35,16,15,66
5770,18,31,16,20,85
5773,16,20,17,15,68
5774,20,32,17,15,84
5778,15,35,17,16,83
5783,16,16,16,19,67
5784,16,35,16,15,82
5785,0,35,16,15,66
5786,19,31,17,20,87
5787,0,31,17,20,68
5788,15,37,15,16,83
5789,17,20,15,16,68
5791,0,31,18,15,64
5792,16,33,16,17,82
5793,0,33,16,17,66
5794,15,33,19,16,83
5795,0,33,19,16,68
5796,17,35,15,20,87
5797,19,16,15,20,70
5798,16,35,17,17,85
5799,15,20,17,17,69
5800,20,34,15,15,84
5801,0,34,15,15,64
5802,17,30,20,14,81
5803,0,30,20,14,64
5804,15,34,17,15,81
5805,0,34,17,15,66
5806,14,32,20,16,82
5807,0,32,20,16,68
5808,15,36,16,14,81
5809,20,16,16,14,66
5811,16,14,21,15,66
5813,0,36,15,16,67
5816,0,16,20,14,50
5817,20,14,19,14,67
5818,14,33,17,18,82
5819,0,33,17,18,68
5820,14,35,15,19,83
5821,0,35,15,19,69
5823,15,19,15,18,67
5824,19,33,17,16,85
5826,18,33,17,15,83
5827,17,16,17,15,65
5828,16,32,16,19,83
5829,0,32,16,19,67
5830,15,35,16,16,82
5831,16,19,16,16,67
5832,19,32,16,19,86
5834,16,35,16,15,82
5835,0,35,16,15,66
5836,19,31,18,15,83
5840,15,35,16,18,84
5842,19,34,15,16,84
5843,16,18,15,16,65
5844,18,31,17,19,85
5845,0,31,17,19,67
5846,16,36,16,15,83
5848,19,31,16,21,87
5849,16,15,16,21,68
5850,15,37,15,15,82
5854,15,34,16,16,81
5856,18,32,16,21,87
5857,0,32,16,21,69
5858,16,37,16,16,85
5859,0,37,16,16,69
5860,21,32,16,15,84
5861,0,32,16,15,63
5862,16,31,16,19,82
5863,0,31,16,19,66
5864,15,35,16,18,84
5865,16,19,16,18,69
5866,19,34,16,15,84
5867,0,34,16,15,65
5868,18,31,17,19,85
5869,16,15,17,19,67
5870,15,36,21,10,82
5871,17,19,21,10,67
5872,19,31,17,19,86
5874,10,36,18,15,79
5875,17,19,18,15,69
5876,19,33,15,17,84
5877,0,33,15,17,65
5880,17,32,17,16,82
5881,17,15,17,16,65
5882,15,33,17,18,83
5883,17,16,17,18,68
5884,16,35,15,18,84
5885,0,35,15,18,68
5886,18,33,16,18,85
5888,18,34,15,20,87
5889,0,34,15,20,69
5890,18,35,15,15,83
5891,0,35,15,15,65
5892,20,30,20,15,85
5893,15,15,20,15,65
5894,15,35,16,18,84
5896,15,34,16,18,83
5897,0,34,16,18,68
5898,18,34,15,18,85
5899,16,18,15,18,67
5900,18,33,16,16,83
5901,15,18,16,16,65
5902,18,32,15,19,84
5903,0,32,15,19,66
5904,16,34,17,16,83
5905,0,34,17,16,67
5906,19,33,15,16,83
5907,0,33,15,16,64
5909,15,16,21,13,65
5910,16,34,16,19,85
5911,0,34,16,19,69
5912,13,35,14,21,83
5914,19,35,16,14,84
5918,14,33,19,16,82
5919,21,12,19,16,68
5920,12,35,17,16,80
5922,16,33,16,19,84
5923,0,33,16,19,68
5924,16,35,0,16,67
5926,19,31,16,19,85
5927,16,15,16,19,66
5928,15,35,16,19,85
5930,19,35,13,18,85
5931,16,19,13,18,66
5935,15,18,19,13,65
5936,18,32,18,17,85
5937,0,32,18,17,67
5938,13,35,15,17,80
5941,15,17,17,18,67
5942,17,35,15,17,84
5945,15,17,17,17,66
5946,17,34,20,18,89
5947,17,17,20,18,72
5948,17,38,14,14,83
5949,20,18,14,14,66
5951,0,28,17,18,63
5952,14,35,14,17,80
5953,0,35,14,17,66
5954,18,31,17,20,86
5956,17,37,13,17,84
5957,0,37,13,17,67
5959,0,30,17,17,64
5960,17,34,17,17,85
5961,0,34,17,17,68
5962,17,34,16,16,83
5963,0,34,16,16,66
5964,17,32,20,13,82
5967,0,33,19,17,69
5970,17,33,16,15,81
5971,0,33,16,15,64
5973,0,31,17,18,66
5974,15,35,15,17,82
5976,18,32,20,15,85
5978,17,35,18,14,84
5979,20,15,18,14,67
5980,15,32,16,19,82
5981,18,14,16,19,67
5982,14,35,16,18,83
5983,0,35,16,18,69
5985,0,34,15,18,67
5986,18,33,16,15,82
5987,15,18,16,15,64
5988,18,31,19,16,84
5989,16,15,19,16,66
5990,15,35,17,19,86
5992,16,36,12,17,81
5993,17,19,12,17,65
5994,19,29,19,15,82
5995,12,17,19,15,63
5996,17,34,19,16,86
5997,19,15,19,16,69
