序号,发送->接收,接收->转发,转发->接收,接收->处理,总计
1,113,16,117,17,263
2,117,16,101,15,249
3,104,16,101,15,236
5,117,33,134,16,300
6,115,18,134,16,283
7,116,34,116,16,282
9,117,32,118,16,283
11,116,35,133,17,301
12,115,19,133,17,284
13,119,33,132,18,302
14,101,33,132,18,284
15,117,32,134,17,300
16,116,16,134,17,283
17,101,16,134,17,268
18,100,34,117,16,267
19,118,34,116,17,285
22,117,15,118,16,266
23,116,34,117,16,283
24,118,16,117,16,267
25,116,33,133,16,298
26,100,33,133,16,282
27,117,34,115,17,283
30,118,16,116,16,266
33,116,33,133,16,298
34,133,33,135,17,318
35,116,33,135,17,301
37,115,33,119,14,281
39,115,34,116,17,282
40,118,15,116,17,266
43,117,35,101,16,269
44,116,19,101,16,252
45,118,31,135,15,299
46,102,31,135,15,283
47,114,34,135,15,298
49,117,36,130,19,302
51,120,30,119,17,286
52,101,30,119,17,267
53,133,16,118,16,283
54,119,16,118,16,269
56,116,19,132,17,284
58,130,36,132,17,315
60,119,17,132,17,285
61,117,33,116,16,282
62,118,16,116,16,266
63,119,32,117,16,284
64,132,34,115,19,300
65,117,34,115,19,285
67,116,33,118,15,282
68,115,17,118,15,265
69,132,16,117,17,282
70,116,16,117,17,266
71,116,33,118,16,283
72,117,16,118,16,267
73,116,35,117,16,284
75,118,32,116,17,283
76,118,15,116,17,266
77,116,34,132,18,300
79,117,33,134,17,301
81,118,34,117,16,285
82,117,16,117,16,266
83,116,32,101,17,266
84,116,17,101,17,251
88,117,17,132,17,283
89,116,33,132,17,298
90,117,16,132,17,282
92,101,33,133,16,283
93,133,17,116,18,284
94,117,17,116,18,268
96,132,33,119,16,300
97,115,33,119,16,283
98,116,16,119,16,267
100,116,17,118,15,266
101,133,18,132,19,302
102,116,18,132,19,285
103,118,34,132,19,303
104,117,18,132,19,286
105,118,33,118,14,283
106,119,16,118,14,267
108,118,15,118,15,266
109,117,33,117,19,286
111,116,34,119,16,285
112,117,15,119,16,267
113,115,33,102,15,265
114,118,14,102,15,249
115,115,33,117,16,281
116,100,33,117,16,266
117,114,36,116,17,283
118,117,19,116,17,269
120,102,33,132,16,283
122,102,32,100,16,250
124,117,16,117,19,269
125,116,36,117,15,284
126,116,17,117,15,265
128,132,34,132,17,315
129,117,34,132,17,300
130,100,34,132,17,283
131,100,18,132,17,267
132,117,19,131,17,284
134,117,15,135,16,283
135,116,33,102,16,267
136,117,16,102,16,251
138,132,33,119,17,301
140,115,16,119,17,267
142,116,19,133,15,283
143,118,33,132,16,299
144,102,33,132,16,283
146,119,16,134,14,283
148,102,34,114,18,268
149,102,17,114,18,251
151,117,32,133,18,300
152,115,17,133,18,283
153,115,35,133,16,299
154,115,19,133,16,283
157,116,32,118,16,282
158,115,16,118,16,265
159,116,34,119,14,283
160,133,35,132,17,317
161,117,35,132,17,301
162,116,17,132,17,282
163,119,32,133,17,301
164,101,32,133,17,283
165,117,33,134,17,301
166,101,33,134,17,285
168,119,14,134,16,283
169,115,34,116,17,282
170,116,16,116,17,265
171,116,33,118,15,282
172,117,16,118,15,266
173,116,34,135,15,300
174,117,17,135,15,284
175,115,33,117,17,282
177,116,33,118,15,282
178,116,17,118,15,266
180,118,15,117,19,269
181,116,36,117,15,284
182,135,32,134,16,317
183,118,32,134,16,300
184,117,17,134,16,284
185,101,17,134,16,268
188,117,19,131,18,285
189,119,32,117,17,285
192,117,17,116,17,267
193,117,33,115,18,283
195,101,17,115,18,251
196,131,35,117,16,299
197,132,17,117,16,282
198,117,17,117,16,267
199,117,33,121,27,298
200,116,17,121,27,281
203,117,33,135,16,301
204,118,16,135,16,285
205,116,34,117,17,284
206,117,16,117,17,267
207,117,48,119,16,300
208,121,27,119,16,283
209,133,18,117,18,286
210,115,18,117,18,268
212,135,33,134,16,318
213,117,33,134,16,300
215,113,33,134,16,296
216,121,16,134,16,287
217,119,34,131,16,300
218,117,18,131,16,282
220,117,16,114,17,264
221,117,34,132,17,300
225,118,31,117,18,284
226,116,15,117,18,266
228,114,17,102,18,251
229,117,35,134,16,302
230,132,32,118,17,299
231,116,32,118,17,283
232,116,15,118,17,266
233,115,35,117,17,284
234,117,18,117,17,269
236,102,33,101,15,251
237,102,15,101,15,233
238,134,33,115,17,299
239,133,17,115,17,282
240,118,17,115,17,267
242,117,17,114,18,266
243,116,31,134,17,298
245,115,33,118,16,282
246,131,34,117,16,298
248,115,17,117,16,265
249,115,34,133,16,298
250,114,18,133,16,281
252,101,33,116,19,269
253,117,33,117,16,283
258,133,35,133,16,317
259,117,35,133,16,301
260,116,19,133,16,284
261,118,31,118,16,283
262,102,31,118,16,267
265,116,36,130,19,301
266,116,19,130,19,284
267,119,33,116,16,284
268,116,17,116,16,265
269,118,32,116,17,283
270,102,32,116,17,267
271,102,16,116,17,251
272,101,34,132,16,283
274,130,35,133,17,315
275,133,16,133,17,299
276,116,16,133,17,282
277,116,33,117,16,282
279,116,33,118,16,283
281,117,34,117,15,283
283,116,33,134,16,299
284,133,33,117,17,300
287,116,34,116,16,282
288,118,16,116,16,266
289,118,32,117,18,285
290,117,15,117,18,267
292,134,33,115,19,301
293,117,33,115,19,284
294,117,17,115,19,268
297,115,35,133,16,299
298,117,18,133,16,284
299,117,34,132,17,300
300,100,34,132,17,283
301,102,16,132,17,267
302,101,33,116,16,266
304,117,18,133,16,284
307,115,33,134,16,298
309,118,33,117,18,286
311,117,34,101,15,267
312,133,33,116,19,301
313,117,33,116,19,285
314,116,17,116,19,268
315,117,34,116,18,285
316,118,16,116,18,268
317,117,34,132,18,301
318,117,18,132,18,285
319,119,31,119,17,286
321,116,36,114,19,285
322,116,19,114,19,268
324,101,33,115,18,267
325,118,32,118,16,284
327,117,35,132,17,301
329,102,17,132,17,268
330,114,19,116,17,266
332,115,18,133,16,282
334,118,16,133,16,283
335,116,33,116,17,282
336,132,34,116,16,298
337,118,34,116,16,284
338,116,17,116,16,265
339,101,17,116,16,250
341,116,33,133,16,298
342,116,17,133,16,282
343,116,33,116,18,283
345,116,33,134,17,300
346,116,16,134,17,283
347,115,34,117,17,283
348,117,16,117,17,267
350,116,17,101,16,250
351,117,34,116,16,283
353,117,33,116,18,284
354,134,34,116,16,300
355,116,34,116,16,282
356,117,17,116,16,266
357,118,33,117,16,284
360,116,16,101,16,249
361,117,35,133,17,302
362,116,18,133,17,284
365,116,34,133,20,303
367,117,34,119,14,284
369,134,17,133,17,301
370,116,17,133,17,283
371,117,34,133,16,300
373,117,32,117,16,282
375,117,34,132,18,301
377,103,14,132,18,267
378,133,34,116,17,300
379,116,34,116,17,283
380,116,17,116,17,266
381,133,16,117,17,283
384,132,35,116,17,300
386,117,17,116,17,267
389,117,33,116,18,284
390,117,17,116,18,268
391,117,32,118,17,284
392,101,32,118,17,268
393,115,35,133,16,299
394,116,17,133,16,282
395,117,32,117,16,282
396,116,16,117,16,265
397,116,35,116,16,283
399,118,33,132,17,300
400,102,33,132,17,284
401,117,33,116,16,282
402,133,32,117,18,300
403,117,32,117,18,284
404,101,32,117,18,268
406,116,16,118,16,266
407,116,33,117,16,282
408,132,33,117,19,301
409,116,33,117,19,285
410,116,16,117,19,268
413,117,33,117,16,283
414,118,16,117,16,267
415,117,32,134,17,300
416,117,16,134,17,284
417,116,36,115,17,284
419,119,32,117,16,284
420,116,17,117,16,266
421,116,33,134,17,300
424,101,33,118,16,268
425,117,34,100,16,267
426,115,17,100,16,248
427,117,33,116,17,283
428,117,16,116,17,266
429,116,34,132,16,298
430,134,33,115,18,300
431,134,16,115,18,283
432,118,16,115,18,267
434,100,32,118,17,267
435,115,34,118,16,283
436,116,17,118,16,267
437,117,33,117,16,283
438,132,34,134,17,317
439,131,18,134,17,300
440,115,18,134,17,284
442,118,17,117,16,268
443,118,33,115,17,283
444,101,33,115,17,266
445,117,32,117,18,284
447,117,35,133,17,302
448,134,33,134,16,317
449,117,33,134,16,300
450,117,16,134,16,283
451,116,32,118,16,282
452,100,32,118,16,266
453,116,35,136,14,301
454,117,18,136,14,285
458,117,17,133,17,284
459,119,32,118,16,285
460,102,32,118,16,268
461,101,16,118,16,251
463,119,31,115,17,282
464,117,17,115,17,266
465,117,33,117,16,283
466,133,33,134,17,317
467,117,33,134,17,301
468,118,16,134,17,285
469,102,16,134,17,269
472,115,17,102,14,248
473,117,34,115,19,285
474,117,16,115,19,267
475,116,34,117,16,283
476,117,17,117,16,267
478,118,17,131,17,283
481,131,19,115,17,282
483,117,33,117,17,284
485,116,32,102,15,265
486,131,34,133,16,314
487,117,34,133,16,300
488,115,17,133,16,281
489,118,33,116,17,284
490,115,17,116,17,265
491,115,35,116,15,281
492,117,17,116,15,265
493,118,31,118,17,284
494,102,31,118,17,268
495,133,17,116,18,284
496,133,33,118,16,300
498,116,17,118,16,267
499,115,33,118,16,282
500,116,15,118,16,265
501,116,35,132,17,300
502,118,17,132,17,284
503,118,33,132,17,300
504,101,33,132,17,283
505,118,33,116,18,285
507,116,33,116,19,284
508,118,16,116,19,269
509,116,33,118,17,284
511,117,33,117,17,284
514,116,18,118,33,285
515,117,34,117,15,283
517,118,33,116,17,284
518,102,33,116,17,268
524,117,15,116,18,266
525,116,34,117,15,282
526,116,17,117,15,265
527,118,32,135,15,300
529,114,35,132,17,298
530,119,17,132,17,285
531,131,18,116,17,282
533,117,32,134,16,299
534,117,15,134,16,282
535,115,35,132,16,298
536,100,35,132,16,283
537,117,32,116,19,284
538,132,34,116,18,300
540,116,17,116,18,267
541,116,33,116,17,282
542,134,33,117,16,300
544,115,17,117,16,265
545,117,35,132,17,301
546,116,19,132,17,284
547,118,33,116,17,284
549,118,32,118,16,284
551,117,33,118,17,285
552,117,16,118,17,268
554,132,34,117,16,299
556,116,17,117,16,266
557,101,17,117,16,251
559,101,16,117,15,249
560,118,17,133,17,285
561,118,32,118,16,284
562,117,16,118,16,267
563,116,34,117,16,283
566,117,15,134,17,283
567,115,35,132,18,300
568,133,33,117,17,300
570,118,16,117,17,268
571,116,33,118,16,283
572,117,16,118,16,267
573,116,33,118,16,283
575,117,33,121,14,285
576,116,16,121,14,267
577,115,35,132,17,299
578,117,17,132,17,283
579,117,33,116,16,282
580,118,16,116,16,266
581,117,33,116,17,283
583,117,34,133,16,300
584,121,14,133,16,284
586,118,14,117,16,265
588,116,16,133,19,284
589,115,34,135,15,299
592,133,32,117,18,300
593,131,16,117,18,282
594,117,16,117,18,268
595,116,33,102,15,266
597,116,36,131,18,301
598,118,17,131,18,284
599,119,32,117,17,285
600,116,17,117,17,267
601,117,34,132,34,317
602,117,18,132,34,301
603,118,32,115,19,284
604,102,32,115,19,268
606,131,35,117,14,297
607,116,35,117,14,282
608,117,17,117,14,265
609,101,17,117,14,249
613,117,33,101,17,268
615,116,32,119,16,283
616,117,14,119,16,266
617,115,34,117,18,284
618,133,35,133,16,317
621,118,33,116,16,283
624,102,33,134,16,285
625,117,34,116,17,284
626,101,34,116,17,268
627,117,33,116,16,282
628,133,32,135,33,333
629,116,32,135,33,316
630,116,16,135,33,300
631,115,35,113,20,283
633,118,33,117,16,284
634,116,17,117,16,266
637,116,35,115,17,283
638,100,35,115,17,267
640,100,33,133,16,282
641,117,33,116,17,283
643,117,32,118,17,284
644,101,32,118,17,268
645,100,16,118,17,251
648,133,33,116,18,300
650,116,17,116,18,267
651,117,34,117,16,284
654,101,33,134,16,284
655,116,32,118,17,283
656,117,15,118,17,267
657,101,15,118,17,251
659,117,33,136,15,301
660,100,33,136,15,284
661,101,16,136,15,268
662,134,33,116,17,300
663,117,33,116,17,283
664,102,33,116,17,268
666,132,37,130,18,317
667,115,37,130,18,300
668,116,20,130,18,284
669,119,30,118,17,284
670,102,30,118,17,267
671,101,15,118,17,251
672,116,17,101,16,250
673,117,34,117,17,285
674,118,17,117,17,269
675,118,32,102,15,267
676,130,35,114,19,298
677,115,35,114,19,283
678,118,17,114,19,268
679,118,33,117,16,284
680,101,33,117,16,267
681,100,17,117,16,250
684,102,32,116,17,267
685,116,34,134,14,298
686,114,19,134,14,281
687,117,33,115,17,282
688,117,16,115,17,265
694,134,31,118,16,299
695,117,31,118,16,282
696,101,31,118,16,266
697,100,17,118,16,251
698,120,15,115,16,266
700,102,30,101,17,250
701,115,34,134,17,300
703,117,34,117,18,286
704,118,16,117,18,269
705,113,33,102,15,263
706,115,16,102,15,248
707,116,33,117,17,283
711,116,35,115,17,283
712,117,18,115,17,267
713,118,32,133,17,300
714,102,32,133,17,284
715,117,33,117,16,283
716,101,33,117,16,267
717,116,33,117,18,284
718,117,16,117,18,268
720,115,17,101,17,250
721,117,33,133,17,300
722,133,33,117,16,299
723,117,33,117,16,283
725,116,35,115,18,284
726,117,18,115,18,268
728,101,31,102,16,250
729,115,34,117,17,283
730,133,33,117,16,299
731,116,33,117,16,282
732,117,16,117,16,266
733,116,35,132,17,300
736,102,32,117,16,267
737,116,34,134,16,300
738,100,34,134,16,284
740,101,32,118,17,268
743,116,33,135,16,300
744,117,16,135,16,284
745,116,35,116,17,284
747,118,33,135,15,301
748,102,33,135,15,285
749,100,17,135,15,267
750,118,16,117,16,267
751,117,34,133,15,299
752,135,33,115,17,300
753,118,33,115,17,283
754,100,33,115,17,265
755,117,35,132,16,300
756,100,35,132,16,283
758,117,16,117,16,266
759,117,34,116,16,283
760,133,32,118,16,299
762,115,17,118,16,266
763,115,35,132,18,300
764,132,32,118,17,299
765,117,32,118,17,284
767,116,33,102,15,266
771,117,33,133,17,300
772,132,35,115,18,300
773,116,35,115,18,284
774,118,17,115,18,268
775,118,31,102,16,267
776,102,31,102,16,251
777,115,34,120,14,283
778,133,33,118,16,300
779,116,33,118,16,283
780,117,16,118,16,267
781,115,35,117,16,283
782,115,18,117,16,266
783,118,33,117,16,284
785,118,33,134,16,301
786,101,33,134,16,284
787,117,33,117,17,284
788,118,16,117,17,268
790,117,16,117,16,266
791,117,33,100,15,265
792,117,16,100,15,248
793,114,34,116,17,281
794,134,33,132,17,316
795,117,33,132,17,299
797,116,33,116,16,281
798,100,33,116,16,265
799,116,34,132,16,298
801,118,33,115,18,284
802,116,17,115,18,266
804,100,32,101,17,250
805,115,33,117,18,283
806,116,16,117,18,267
809,116,34,134,16,300
810,115,18,134,16,283
811,101,18,134,16,269
812,101,33,133,17,284
813,101,16,133,17,267
815,117,34,116,17,284
816,101,34,116,17,268
817,105,14,116,17,252
818,134,32,134,16,316
819,117,32,134,16,299
820,117,16,134,16,283
822,116,16,117,18,267
823,112,35,116,17,280
824,116,17,116,17,266
825,101,17,116,17,251
826,117,15,101,17,250
828,134,34,116,16,300
829,117,34,116,16,283
831,117,33,134,15,299
832,100,33,134,15,282
833,116,33,116,18,283
834,101,33,116,18,268
835,101,16,116,18,251
836,100,33,101,15,249
837,117,33,121,13,284
838,116,16,121,13,266
839,116,35,131,19,301
842,116,18,132,16,282
844,101,33,115,19,268
847,104,13,118,17,252
848,131,34,118,17,300
849,116,34,118,17,285
850,117,15,118,17,267
851,117,35,117,17,286
852,115,19,117,17,268
853,114,34,133,16,297
855,118,32,117,15,282
856,103,32,117,15,267
857,116,34,115,17,282
858,118,17,115,17,267
859,119,34,131,18,302
860,117,17,131,18,283
862,133,31,102,15,281
863,119,31,102,15,267
864,101,31,102,15,249
866,115,17,116,18,266
867,115,33,101,17,266
868,131,35,148,17,331
869,116,35,148,17,316
871,117,32,116,17,282
872,102,32,116,17,267
875,118,33,116,16,283
876,101,33,116,16,266
877,116,49,118,16,299
879,133,17,117,17,284
881,117,33,134,18,302
882,132,33,119,16,300
883,115,33,119,16,283
886,102,35,117,17,271
889,117,33,117,16,283
890,134,34,116,16,300
893,116,34,132,16,298
894,117,17,132,16,282
895,118,33,132,18,301
897,118,32,134,15,299
901,115,34,134,15,298
902,132,33,116,19,300
903,116,33,116,19,284
904,115,17,116,19,267
906,118,16,116,18,268
907,117,34,100,17,268
908,101,34,100,17,252
911,118,34,115,16,283
912,101,34,115,16,266
913,117,33,133,16,299
914,116,18,133,16,283
915,119,33,116,17,285
917,115,33,100,17,265
918,133,32,117,17,299
919,118,32,117,17,284
920,115,16,117,17,265
922,133,33,117,17,300
924,116,17,117,17,267
925,117,33,117,17,284
926,100,33,117,17,267
928,117,17,118,16,268
929,116,33,118,16,283
930,132,35,133,16,316
931,116,35,133,16,300
935,118,33,116,16,283
936,101,33,116,16,266
937,117,33,133,16,299
938,101,33,133,16,283
939,116,34,115,17,282
942,116,17,133,17,283
943,116,32,118,16,282
946,133,33,119,15,300
948,115,17,119,15,266
949,116,34,116,17,283
950,133,33,116,19,301
951,117,33,116,19,285
953,117,34,101,16,268
954,100,34,101,16,251
956,119,15,117,17,268
957,117,33,118,15,283
958,100,33,118,15,266
960,116,19,133,16,284
962,101,33,116,17,267
963,116,33,100,15,264
964,117,17,100,15,249
965,118,32,133,18,301
967,117,35,116,17,285
969,117,33,117,16,283
970,116,17,117,16,266
975,116,35,116,16,283
976,116,17,116,16,265
977,117,33,133,17,300
978,117,16,133,17,283
979,118,34,116,17,285
982,102,32,117,17,268
983,101,15,117,17,250
986,133,34,115,19,301
987,115,34,115,19,283
988,116,17,115,19,267
989,116,33,101,14,264
991,100,17,101,14,232
993,117,33,117,16,283
995,116,35,114,18,283
997,118,32,117,17,284
999,116,34,117,17,284
1000,116,18,117,17,268
1001,118,32,102,16,268
1002,101,32,102,16,251
1003,101,16,102,16,235
1004,114,18,118,16,266
1005,118,34,133,15,300
1006,100,34,133,15,282
1007,118,34,131,17,300
1008,117,17,131,17,282
1009,118,32,116,17,283
1011,102,16,116,17,251
1012,118,16,132,18,284
1013,101,16,132,18,267
1014,133,32,118,16,299
1017,115,34,116,19,284
1018,116,17,116,19,268
1019,115,33,102,16,266
1020,132,34,133,17,316
1021,116,34,133,17,300
1025,117,35,115,18,285
1026,100,35,115,18,268
1030,101,32,118,16,267
1031,116,33,101,17,267
1033,117,35,116,17,285
1034,115,18,116,17,266
1035,117,32,134,16,299
1036,132,34,116,17,299
1038,118,16,116,17,267
1039,101,16,116,17,250
1040,101,34,132,18,285
1042,100,33,133,16,282
1044,134,33,135,16,318
1046,116,17,135,16,284
1047,116,33,118,16,283
1048,132,34,133,16,315
1051,118,33,116,16,283
1052,116,17,116,16,265
1054,135,32,116,17,300
1055,118,32,116,17,283
1056,102,32,116,17,267
1057,116,33,100,17,266
1058,133,32,135,17,317
1059,117,32,135,17,301
1060,116,16,135,17,284
1061,116,35,117,16,284
1062,132,33,133,18,316
1063,116,33,133,18,300
1065,116,33,118,14,281
1066,100,33,118,14,265
1067,101,16,118,14,249
1069,116,33,116,17,282
1070,117,16,116,17,266
1071,117,33,118,16,284
1072,133,32,119,16,300
1073,116,32,119,16,283
1074,118,14,119,16,267
1075,101,14,119,16,250
1076,133,33,118,16,300
1077,116,33,118,16,283
1081,116,33,116,18,283
1082,102,33,116,18,269
1083,100,16,116,18,250
1084,116,18,116,17,267
1086,101,33,134,16,284
1087,100,16,134,16,266
1088,116,16,118,16,266
1089,115,35,116,18,284
1090,116,18,116,18,268
1095,118,32,119,15,284
1096,102,32,119,15,268
1097,117,35,133,17,302
1098,116,18,133,17,284
1100,101,32,118,16,267
1101,117,52,131,17,317
1102,130,21,131,17,299
1103,114,21,131,17,283
1105,102,15,116,17,250
1106,133,33,133,18,317
1109,117,49,116,19,301
1111,113,18,116,19,266
1112,116,17,134,17,284
1113,100,17,134,17,268
1114,117,15,118,15,265
1117,117,32,102,16,267
1118,102,32,102,16,252
1119,102,14,102,16,234
1120,118,16,133,18,285
1121,116,32,119,16,283
1122,101,32,119,16,268
1124,116,18,132,16,282
1125,116,31,117,17,281
1126,102,31,117,17,267
1129,116,34,115,16,281
1131,102,16,115,16,249
1132,132,33,115,19,299
1133,116,33,115,19,283
1134,117,17,115,19,268
1135,115,33,101,17,266
1136,116,16,101,17,250
1137,114,33,135,16,298
1138,115,16,135,16,282
1140,117,16,117,16,266
1141,117,34,116,17,284
1143,117,33,100,16,266
1144,101,33,100,16,250
1147,117,32,118,17,284
1148,101,32,118,17,268
1150,116,17,133,17,283
1151,116,34,133,16,299
1155,117,34,116,16,283
1156,101,34,116,16,267
1159,117,34,132,19,302
1160,116,17,132,19,284
1161,118,32,119,16,285
1162,100,32,119,16,267
1163,115,34,101,17,267
1166,100,33,118,17,268
1167,116,33,102,15,266
1168,132,35,116,16,299
1169,116,35,116,16,283
1170,119,16,116,16,267
1172,101,33,133,17,284
1173,101,16,133,17,267
1175,101,17,133,17,268
1176,102,35,115,17,269
1177,118,30,102,16,266
1178,116,16,102,16,250
1180,133,34,116,16,299
1182,116,17,116,16,265
1183,118,34,115,16,283
1186,102,33,132,18,285
1188,101,34,116,15,266
1189,118,31,117,17,283
1192,115,16,118,18,267
1193,115,34,102,16,267
1194,132,33,117,18,300
1196,116,15,117,18,266
1197,116,34,101,17,268
1198,117,17,101,17,252
1199,117,35,132,16,300
1200,101,35,132,16,284
1202,102,32,133,19,286
1204,117,18,118,17,270
1206,101,32,118,16,267
1207,101,15,118,16,250
1210,116,17,134,16,283
1212,118,17,114,17,266
1213,101,17,114,17,249
1214,118,16,117,16,267
1216,100,32,118,16,266
1218,134,33,116,17,300
1219,115,33,116,17,281
1220,114,17,116,17,264
1221,116,33,133,17,299
1222,117,16,133,17,283
1224,101,33,133,19,286
1225,117,34,118,16,285
1226,116,17,118,16,267
1227,117,33,117,16,283
1228,116,17,117,16,266
1229,116,33,117,16,282
1230,100,33,117,16,266
1233,116,35,101,32,284
1234,118,16,101,32,267
1236,117,16,118,17,268
1237,116,33,102,16,267
1238,100,33,102,16,251
1239,116,36,115,16,283
1241,117,32,133,18,300
1243,117,34,117,16,284
1245,101,17,117,16,251
1246,102,33,117,16,268
1247,116,32,101,18,267
1249,118,34,117,17,286
1250,133,34,134,16,317
1251,116,34,134,16,300
1254,100,33,117,16,266
1255,117,34,133,16,300
1256,101,34,133,16,284
1258,101,33,116,17,267
1260,117,17,116,16,266
1261,117,32,116,17,282
1263,115,34,117,16,282
1264,133,33,132,18,316
1266,116,17,132,18,283
1267,116,33,117,17,283
1269,116,33,134,16,299
1270,116,17,134,16,283
1273,117,32,118,17,284
1274,132,35,100,17,284
1275,115,35,100,17,267
1276,117,17,100,17,251
1277,118,33,117,16,284
1278,101,33,117,16,267
1279,116,33,134,17,300
1280,100,33,134,17,284
1282,101,34,117,17,269
1283,117,34,117,16,284
1284,100,34,117,16,267
1286,117,16,101,17,251
1289,117,34,132,18,301
1293,117,33,117,16,283
1294,101,33,117,16,267
1295,134,16,117,16,283
1296,117,16,117,16,266
1297,116,33,117,17,283
1298,132,34,117,16,299
1299,115,34,117,16,282
1301,116,33,117,16,282
1303,116,33,117,17,283
1305,116,34,132,19,301
1307,116,33,118,16,283
1308,100,33,118,16,267
1310,100,33,101,16,250
1313,117,32,135,16,300
1314,132,35,116,17,300
1315,115,35,116,17,283
1316,118,16,116,17,267
1317,117,33,131,19,300
1321,116,35,117,15,283
1322,135,33,134,15,317
1323,116,33,134,15,298
1324,116,17,134,15,282
1325,117,50,117,17,301
1327,116,19,117,17,269
1328,118,16,118,14,266
1329,101,16,118,14,249
1331,116,35,115,16,282
1332,115,19,115,16,265
1333,117,33,132,18,300
1334,103,33,132,18,286
1335,117,31,119,17,284
1336,101,31,119,17,268
1337,114,35,117,17,283
1338,118,16,117,17,268
1339,118,32,118,15,283
1340,115,16,118,15,264
1343,115,35,116,17,283
1344,119,17,116,17,269
1345,117,33,117,16,283
1346,101,33,117,16,267
1348,102,31,102,20,255
1349,116,34,118,16,284
1350,119,14,118,16,267
1351,101,14,118,16,249
1352,116,17,134,16,283
1353,117,33,117,15,282
1356,102,34,132,18,286
1357,102,14,132,18,266
1358,102,32,118,14,266
1359,116,35,132,16,299
1360,134,31,117,17,299
1361,117,31,117,17,282
1363,112,34,118,17,281
1364,132,32,103,16,283
1365,116,32,103,16,267
1366,118,14,103,16,251
1369,116,33,116,19,284
1370,117,17,116,19,269
1371,115,35,114,19,283
1372,118,17,114,19,268
1373,117,32,117,17,283
1375,116,33,101,16,266
1376,100,33,101,16,250
1379,117,33,116,16,282
1380,114,19,116,16,265
1381,117,33,132,16,298
1382,101,33,132,16,282
1384,101,33,115,19,268
1385,101,17,115,19,252
1386,116,15,102,16,249
1387,117,34,119,16,286
1388,116,16,119,16,267
1389,116,33,102,17,268
1390,132,35,115,18,300
1391,116,35,115,18,284
1392,115,19,115,18,267
1394,102,32,118,15,267
1395,100,16,118,15,249
1396,119,16,133,16,284
1397,116,34,115,16,281
1398,102,34,115,16,267
1400,115,18,116,17,266
1402,118,15,117,16,266
1404,133,32,100,17,282
1405,116,32,100,17,265
1406,115,16,100,17,248
1407,117,34,117,16,284
1409,116,32,101,17,266
1413,116,34,119,14,283
1414,100,34,119,14,267
1416,117,16,117,16,266
1417,117,34,132,16,299
1419,117,34,114,18,283
1420,117,18,114,18,267
1422,101,32,117,16,266
1423,116,33,116,18,283
1425,116,33,117,19,285
1426,132,34,119,13,298
1427,116,34,119,13,282
1430,117,16,133,19,285
1431,116,34,118,15,283
1434,101,35,114,18,268
1435,101,19,114,18,252
1436,102,30,102,17,251
1437,102,13,102,17,234
1438,118,15,118,16,267
1439,117,34,117,15,283
1440,118,15,117,15,265
1441,102,15,117,15,249
1442,114,18,134,16,282
1443,115,34,116,17,282
1446,102,32,101,17,252
1447,115,32,119,16,282
1448,117,15,119,16,267
1449,116,36,116,16,284
1451,117,33,115,17,282
1453,117,34,131,17,299
1456,103,32,116,16,267
1457,119,33,118,14,284
1458,116,16,118,14,264
1459,116,33,132,19,300
1460,115,17,132,19,283
1461,115,33,118,17,283
1462,131,33,102,15,281
1463,132,16,102,15,265
1465,115,33,118,16,282
1466,118,14,118,16,266
1467,116,33,118,16,283
1469,114,36,115,16,281
1471,118,32,118,15,283
1472,102,32,118,15,267
1476,118,16,135,16,285
1477,115,33,118,17,283
1479,116,34,118,16,284
1480,118,15,118,16,267
1481,116,33,101,15,265
1482,100,33,101,15,249
1483,116,35,117,16,284
1484,116,19,117,16,268
1486,102,33,134,16,285
1487,116,33,117,17,283
1488,101,33,117,17,268
1491,119,33,115,17,284
1492,117,16,115,17,265
1494,134,33,116,16,299
1495,117,33,116,16,282
1496,101,33,116,16,266
1498,132,33,102,17,284
1500,115,17,102,17,251
1501,117,34,118,15,284
1502,132,33,134,17,316
1504,116,16,134,17,283
1505,116,35,116,16,283
1508,102,33,132,18,285
1509,102,16,132,18,268
1510,101,32,134,17,284
1511,116,34,117,17,284
1512,100,34,117,17,268
1513,116,33,101,17,267
1514,116,16,101,17,250
1515,115,33,117,16,281
1516,132,34,132,17,315
1518,118,16,132,17,283
1519,117,34,115,17,283
1520,117,17,115,17,266
1521,117,33,133,16,299
1522,101,33,133,16,283
1525,115,33,119,16,283
1526,116,16,119,16,267
1527,115,34,117,16,282
1528,115,17,117,16,265
1529,115,34,135,14,298
1531,117,34,132,16,299
1532,117,18,132,16,283
1533,118,33,115,18,284
1535,102,16,115,18,251
1536,101,32,116,17,266
1538,116,19,132,15,282
1540,115,17,116,19,267
1541,115,34,117,17,283
1542,115,18,117,17,267
1543,117,32,118,16,283
1544,101,32,118,16,267
1545,116,35,116,16,283
1546,132,34,115,18,299
1547,118,34,115,18,285
1548,101,34,115,18,268
1549,100,19,115,18,252
1550,101,33,117,15,266
1552,102,32,135,16,285
1553,117,33,118,17,285
1554,116,16,118,17,267
1556,115,18,132,18,283
1557,117,32,118,17,284
1558,117,15,118,17,267
1559,116,35,132,16,299
1560,135,33,115,18,301
1561,118,33,115,18,284
1562,102,33,115,18,268
1564,132,35,132,17,316
1565,115,35,132,17,299
1567,118,32,117,16,283
1569,116,34,133,17,300
1570,115,18,133,17,283
1573,116,33,132,19,300
1574,132,33,118,16,299
1575,117,33,118,16,284
1576,100,33,118,16,267
1577,101,16,118,16,251
1578,133,33,117,16,299
1580,100,33,117,16,266
1581,116,32,118,16,282
1583,115,35,134,16,300
1586,133,33,117,16,299
1587,116,33,117,16,282
1588,117,16,117,16,266
1589,116,33,117,16,282
1590,101,33,117,16,267
1591,115,35,133,17,300
1592,134,32,118,17,301
1593,117,32,118,17,284
1594,101,32,118,17,268
1595,116,33,102,15,266
1596,117,16,102,15,250
1598,117,16,134,17,284
1599,116,35,132,18,301
1600,133,34,131,19,317
1602,118,17,131,19,285
1604,102,31,119,15,267
1607,115,33,117,17,282
1608,116,16,117,17,266
1609,115,33,101,17,266
1610,116,15,101,17,249
1611,116,34,133,17,300
1614,134,33,133,18,318
1616,101,33,133,18,285
1619,115,33,101,17,266
1621,115,34,134,16,299
1623,117,33,117,16,283
1624,117,16,117,16,266
1625,116,34,134,15,299
1626,100,34,134,15,283
1627,116,33,116,17,282
1629,117,34,116,16,283
1630,100,34,116,16,266
1632,101,32,134,20,287
1633,115,35,119,14,283
1634,134,32,118,16,300
1635,117,32,118,16,283
1636,101,32,118,16,267
1641,117,34,116,17,284
1642,119,14,116,17,266
1643,118,33,116,16,283
1644,118,16,116,16,266
1645,101,16,116,16,249
1646,101,32,135,17,285
1647,116,34,118,15,283
1648,116,17,118,15,266
1651,116,32,117,17,282
1652,116,16,117,17,266
1653,115,35,133,16,299
1654,118,17,133,16,284
1655,118,32,117,16,283
1657,101,15,117,16,249
1658,134,32,118,15,299
1659,118,32,118,15,283
1660,117,17,118,15,267
1661,116,34,116,17,283
1662,133,32,118,17,300
1664,117,16,118,17,268
1665,100,16,118,17,251
1667,117,33,135,15,300
1668,100,33,135,15,283
1670,99,34,116,17,266
1671,117,34,115,19,285
1672,101,34,115,19,269
1674,101,32,118,17,268
1675,115,35,115,17,282
1676,135,32,117,17,301
1677,118,32,117,17,284
1679,116,35,115,16,282
1680,115,19,115,16,265
1681,117,33,133,16,299
1682,102,33,133,16,284
1683,101,17,133,16,267
1684,100,32,117,16,265
1685,117,34,116,16,283
1686,117,17,116,16,266
1689,115,35,133,16,299
1691,118,32,117,17,284
1693,116,33,118,17,284
1694,116,16,118,17,267
1695,116,34,133,16,299
1696,134,34,115,19,302
1697,117,34,115,19,285
1698,117,16,115,19,267
1700,101,33,101,18,253
1701,117,34,132,18,301
1702,118,17,132,18,285
1703,118,32,118,15,283
1705,115,35,115,18,283
1707,118,33,116,18,285
1708,101,33,116,18,268
1709,102,15,116,18,251
1710,100,32,102,17,251
1711,116,33,134,18,301
1712,118,15,134,18,285
1713,117,35,117,16,285
1714,115,18,117,16,266
1715,115,34,133,16,298
1716,116,18,133,16,283
1718,102,31,118,17,268
1721,117,34,134,17,302
1722,117,16,134,17,284
1724,133,33,133,16,315
1727,101,17,133,16,267
1728,117,17,116,18,268
1729,116,34,132,16,298
1731,117,34,131,17,299
1732,100,34,131,17,282
1733,118,32,116,17,283
1734,101,32,116,17,266
1735,117,34,132,17,300
1736,100,34,132,17,283
1737,117,32,117,18,284
1738,132,33,102,14,281
1739,115,33,102,14,264
1740,114,17,102,14,247
1741,115,34,116,18,283
1742,116,17,116,18,267
1743,117,33,116,18,284
1744,116,16,116,18,266
1746,117,18,116,15,266
1748,102,33,115,18,268
1749,118,33,132,17,300
1751,117,33,116,19,285
1752,116,18,116,19,269
1753,117,32,103,15,267
1754,116,15,103,15,249
1756,115,18,116,16,265
1757,118,32,134,16,300
1758,132,36,132,15,315
1759,117,36,132,15,300
1760,116,19,132,15,282
1761,118,31,116,18,283
1764,116,16,118,17,267
1765,116,34,117,17,284
1766,134,34,133,16,317
1767,117,34,133,16,300
1768,114,18,133,16,281
1770,101,33,116,17,267
1771,117,34,132,16,299
1772,101,34,132,16,283
1774,101,33,115,17,266
1776,133,33,133,16,315
1777,118,33,133,16,300
1778,116,17,133,16,282
1779,116,33,116,19,284
1780,132,33,133,17,315
1781,116,33,133,17,299
1782,115,17,133,17,282
1783,117,34,116,17,284
1785,117,33,100,17,267
1788,116,19,115,16,266
1789,119,31,117,18,285
1790,102,31,117,18,268
1791,116,34,101,17,268
1794,100,34,132,19,285
1795,101,17,132,19,269
1796,115,16,119,15,265
1797,116,35,115,19,285
1798,117,18,115,19,269
1799,118,33,133,17,301
1800,101,33,133,17,284
1803,116,34,118,15,283
1804,119,15,118,15,267
1805,117,35,133,15,300
1807,117,32,116,19,284
1808,133,34,101,16,284
1810,101,34,101,16,252
1811,116,32,118,16,282
1812,118,15,118,16,267
1813,117,35,132,16,300
1814,133,34,114,19,300
1817,118,31,102,15,266
1819,100,15,102,15,232
1821,117,33,117,16,283
1822,132,35,132,16,315
1823,117,35,132,16,300
1825,117,31,117,17,282
1826,102,31,117,17,267
1827,115,35,133,16,299
1828,134,32,117,17,300
1829,117,32,117,17,283
1833,117,33,135,15,300
1834,117,17,135,15,284
1835,117,34,134,15,300
1837,117,33,101,15,266
1839,117,34,117,16,284
1840,100,34,117,16,267
1842,135,33,116,17,301
1845,118,32,117,17,284
1846,101,32,117,17,267
1847,116,34,116,17,283
1848,117,16,116,17,266
1849,117,32,134,18,301
1850,131,35,117,16,299
1851,116,35,117,16,284
1852,116,17,117,16,266
1853,101,17,117,16,251
1854,117,17,117,15,266
1857,117,33,101,17,268
1858,134,34,117,17,302
1860,117,16,117,17,267
1861,117,32,118,16,283
1862,100,32,118,16,266
1863,116,35,133,16,300
1864,116,18,133,16,283
1866,101,32,117,34,284
1867,115,35,116,17,283
1868,117,17,116,17,267
1869,117,32,101,17,267
1870,102,32,101,17,252
1873,116,50,116,16,298
1874,101,50,116,16,283
1876,116,17,115,19,267
1877,100,17,115,19,251
1878,101,32,117,16,266
1879,102,15,117,16,250
1880,133,33,117,17,300
1881,117,33,117,17,284
1882,102,33,117,17,269
1883,116,35,131,19,301
1885,117,31,119,15,282
1886,102,31,119,15,267
1887,115,34,117,17,283
1888,133,34,117,15,299
1891,118,32,117,17,284
1893,116,34,116,18,284
1894,119,15,116,18,268
1897,117,32,135,16,300
1898,100,32,135,16,283
1899,116,34,117,17,284
1900,100,34,117,17,268
1901,115,34,117,16,282
1902,100,34,117,16,267
1903,117,33,117,17,284
1904,100,33,117,17,267
1905,116,34,133,16,299
1906,135,33,133,16,317
1907,118,33,133,16,300
1911,114,34,133,16,297
1912,117,17,133,16,283
1913,117,33,116,17,283
1914,133,33,117,17,300
1915,117,33,117,17,284
1916,116,17,117,17,267
1919,116,34,133,17,300
1922,100,33,133,17,283
1923,117,34,116,18,285
1924,100,34,116,18,268
1925,118,32,102,15,267
1926,101,32,102,15,250
1927,101,15,102,15,233
1928,133,33,101,17,284
1929,117,33,101,17,268
1930,117,16,101,17,251
1932,116,18,116,16,266
1935,116,34,133,16,299
1936,100,34,133,16,283
1939,101,17,115,18,251
1940,116,16,117,17,266
1942,117,17,116,16,266
1943,118,33,116,16,283
1944,133,34,117,16,300
1946,115,18,117,16,266
1947,117,33,117,15,282
1948,101,33,117,15,266
1951,115,33,101,17,266
1954,117,16,133,17,283
1955,101,16,133,17,267
1956,100,32,118,17,267
1957,116,34,118,16,284
1958,100,34,118,16,268
1959,117,34,134,16,301
1960,101,34,134,16,285
1961,116,33,117,17,283
1963,116,34,133,16,299
1964,118,17,133,16,284
1966,118,16,116,17,267
1967,117,34,132,17,300
1968,134,33,116,17,300
1969,118,33,116,17,284
1973,116,33,133,16,298
1976,132,34,116,18,300
1978,116,17,116,18,267
1979,117,32,102,16,267
1980,115,17,102,16,250
1982,133,34,136,13,316
1983,116,34,136,13,299
1984,116,18,136,13,283
1985,117,34,115,17,283
1987,119,32,134,16,301
1989,116,33,117,17,283
1991,117,37,129,17,300
1992,136,30,116,18,300
1993,120,30,116,18,284
1994,102,30,116,18,266
1995,116,34,100,17,267
2000,129,35,116,16,296
2001,116,35,116,16,283
2002,116,18,116,16,266
2003,117,33,134,17,301
2005,101,16,134,17,268
2006,116,18,117,14,265
2007,117,32,117,18,284
2008,102,32,117,18,269
2013,118,31,118,17,284
2014,117,14,118,17,266
2015,114,36,132,17,299
2016,117,18,132,17,284
2018,102,33,116,16,267
2019,118,32,117,16,283
2020,132,34,116,16,298
2021,115,34,116,16,281
2022,118,17,116,16,267
2023,100,17,116,16,249
2025,117,33,117,16,283
2026,116,16,117,16,265
2027,116,33,117,17,283
2028,100,33,117,17,267
2029,116,33,117,18,284
2030,116,16,117,18,267
2031,115,35,116,17,283
2032,116,18,116,17,267
2033,117,32,101,16,266
2034,101,32,101,16,250
2035,116,34,116,17,283
2037,117,34,134,16,301
2039,118,33,117,16,284
2041,117,33,116,18,284
2042,101,33,116,18,268
2043,117,33,101,15,266
2044,116,17,101,15,249
2045,117,35,133,16,301
2046,134,32,101,16,283
2047,118,32,101,16,267
2048,117,16,101,16,250
2049,101,16,101,16,234
2050,116,18,117,16,267
2052,101,32,101,17,251
2054,133,34,116,16,299
2055,117,34,116,16,283
2056,101,34,116,16,267
2057,101,18,116,16,251
2058,117,16,134,17,284
2059,118,33,118,16,285
2060,101,33,118,16,268
2061,116,33,119,16,284
2062,132,34,115,18,299
2063,116,34,115,18,283
2065,116,34,132,17,299
2066,134,33,116,17,300
2068,118,16,116,17,267
2069,117,34,115,17,283
2070,101,34,115,17,267
2072,115,18,118,17,268
2074,132,34,117,17,300
2077,115,33,117,17,282
2079,118,35,132,16,301
2080,118,17,132,16,283
2081,102,17,132,16,267
2082,102,33,132,17,284
2083,118,33,116,17,284
2085,118,33,116,17,284
2086,101,33,116,17,267
2087,116,33,117,15,281
2088,132,33,116,16,297
2089,118,33,116,16,283
2091,116,34,115,18,283
2092,116,17,115,18,266
2093,117,33,133,16,299
2095,116,32,117,17,282
2098,116,16,119,15,266
2099,115,35,133,16,299
2100,115,18,133,16,282
2101,117,33,116,17,283
2102,100,33,116,17,266
2103,116,33,134,17,300
2104,117,17,134,17,285
2106,101,33,118,17,269
2108,133,33,118,16,300
2109,116,33,118,16,283
2110,100,33,118,16,267
2111,117,34,117,16,284
2112,134,34,133,16,317
2113,116,34,133,16,299
2114,118,17,133,16,284
2115,118,32,117,16,283
2116,101,32,117,16,266
2119,116,33,116,17,282
2120,100,33,116,17,266
2121,116,34,116,16,282
2122,99,34,116,16,265
2124,101,32,135,16,284
2125,115,33,118,17,283
2126,99,33,118,17,267
2127,115,34,117,16,282
2128,116,17,117,16,266
2129,115,33,133,17,298
2130,116,16,133,17,282
2131,116,35,115,17,283
2132,135,33,133,16,317
2133,116,33,133,16,298
2134,102,33,133,16,284
2136,117,16,117,17,267
2137,116,33,101,17,267
2138,117,16,101,17,251
2139,116,34,117,17,284
2140,115,17,117,17,266
2141,116,34,116,17,283
2142,133,33,132,18,316
2144,117,17,132,18,284
2145,117,34,116,17,284
2146,101,34,116,17,268
2147,101,17,116,17,251
2148,117,17,134,16,284
2150,100,33,117,16,266
2151,117,32,101,18,268
2153,115,35,117,16,283
2155,117,34,117,16,284
2157,118,32,101,17,268
2158,101,32,101,17,251
2159,116,34,116,17,283
2160,101,34,116,17,268
2162,100,33,117,15,265
2165,117,34,132,17,300
2166,101,34,132,17,284
2169,116,32,102,17,267
2171,114,35,117,17,283
2172,115,18,117,17,267
2173,116,33,117,16,282
2174,132,34,135,14,315
2175,117,34,135,14,300
2178,102,34,115,16,267
2179,102,17,115,16,250
2180,117,17,133,17,284
2181,117,32,118,16,283
2182,117,16,118,16,267
2183,116,36,132,17,301
2185,118,30,119,14,281
2186,115,16,119,14,264
2187,115,35,132,19,301
2188,133,33,118,14,298
2189,117,33,118,14,282
2190,101,33,118,14,266
2191,101,16,118,14,249
2192,132,31,102,15,280
2195,116,34,134,16,300
2196,132,33,117,17,299
2198,118,14,117,17,266
2199,115,35,132,17,299
2201,116,32,117,17,282
2203,115,34,117,17,283
2205,115,33,118,16,282
2206,117,17,118,16,268
2207,116,33,135,17,301
2211,116,34,115,19,284
2212,100,34,115,19,268
2213,101,17,115,19,252
2214,101,33,101,16,251
2215,117,34,132,17,300
2216,135,32,117,17,301
2217,118,32,117,17,284
2218,101,32,117,17,267
2219,116,35,115,16,282
2221,117,32,134,16,299
2222,101,32,134,16,283
2223,117,33,117,16,283
2224,132,34,116,16,298
2225,115,34,116,16,281
2228,115,16,119,16,266
2229,115,35,133,16,299
2230,134,32,117,18,301
2233,116,33,118,17,284
2234,116,16,118,17,267
2236,119,16,132,17,284
2237,102,16,132,17,267
2238,133,34,116,17,300
2240,101,34,116,17,268
2241,100,18,116,17,251
2243,116,32,117,17,282
2245,116,34,133,17,300
2246,116,17,133,17,283
2247,117,34,116,17,284
2248,116,17,116,17,266
2249,117,33,133,16,299
2250,133,33,116,17,299
2251,117,33,116,17,283
2252,101,33,116,17,267
2253,117,33,117,18,285
2255,116,34,117,17,284
2256,116,17,117,17,267
2257,116,33,101,16,266
2259,117,33,116,18,284
2261,116,35,115,16,282
2265,101,17,132,16,266
2266,101,32,116,17,266
2268,116,18,116,18,268
2270,115,16,135,15,281
2273,116,33,117,16,282
2274,116,17,117,16,266
2275,117,35,115,16,283
2276,116,18,115,16,265
2277,118,33,116,16,283
2278,102,33,116,16,267
2279,118,32,133,18,301
2280,101,32,133,18,284
2281,117,33,118,17,285
2282,100,33,118,17,268
2283,116,33,102,15,266
2284,115,16,102,15,248
2285,115,34,134,16,299
2286,116,16,134,16,282
2287,117,33,117,17,284
2289,116,35,115,17,283
2290,118,17,115,17,267
2291,101,17,115,17,250
2292,102,32,118,17,269
2293,116,34,133,17,300
2294,134,33,117,17,301
2296,117,17,117,17,268
2298,115,17,117,16,265
2299,117,35,132,17,301
2300,118,17,132,17,284
2302,133,34,115,18,300
2303,117,34,115,18,284
2305,118,32,118,16,284
2306,101,32,118,16,267
2307,115,34,100,17,266
2308,132,33,117,16,298
2309,116,33,117,16,282
2311,116,34,133,18,301
2314,118,16,118,17,269
2315,117,34,101,15,267
2316,100,34,101,15,250
2317,117,32,117,17,283
2318,101,32,117,17,267
2319,117,34,133,17,301
2320,133,35,115,16,299
2321,116,35,115,16,282
2322,118,17,115,16,266
2323,101,17,115,16,249
2324,101,32,117,17,267
2325,100,17,117,17,251
2326,117,17,101,16,251
2327,116,33,117,18,284
2330,115,16,102,15,248
2331,116,35,116,16,283
2333,118,33,132,19,302
2335,117,34,117,16,284
2336,101,34,117,16,268
2337,118,33,116,18,285
2338,102,33,116,18,269
2340,116,16,118,16,266
2341,116,33,118,16,283
2342,132,35,133,16,316
2343,116,35,133,16,300
2344,117,16,133,16,282
2345,102,16,133,16,267
2347,118,32,134,16,300
2348,102,32,134,16,284
2349,117,33,117,17,284
2350,101,33,117,17,268
2353,117,32,117,16,282
2356,134,33,116,17,300
2357,117,33,116,17,283
2358,101,33,116,17,267
2360,100,34,116,16,266
2362,102,31,118,16,267
2364,133,33,116,17,299
2365,117,33,116,17,283
2366,116,17,116,17,266
2367,116,33,117,16,282
2368,116,16,117,16,265
2369,117,33,133,17,300
2371,117,34,116,17,284
2372,133,33,118,15,299
2373,117,33,118,15,283
2374,116,17,118,15,266
2375,116,33,118,17,284
2377,116,33,117,17,283
2378,100,33,117,17,267
2379,117,34,120,12,283
2381,117,33,134,17,301
2382,100,33,134,17,284
2383,116,35,116,16,283
2384,100,35,116,16,267
2385,117,32,117,17,283
2388,120,12,102,16,250
2389,114,35,118,16,283
2390,134,33,101,16,284
2391,116,33,101,16,266
2393,101,16,101,16,234
2394,117,17,116,16,266
2395,114,32,118,17,281
2397,117,35,133,17,302
2398,118,16,133,17,284
2399,117,31,119,15,282
2400,101,31,119,15,266
2401,100,15,119,15,249
2402,116,16,117,18,267
2403,116,35,133,17,301
2404,118,17,133,17,285
2405,116,33,117,17,283
2407,117,32,102,15,266
2408,119,15,102,15,251
2409,101,15,102,15,233
2410,117,18,132,18,285
2412,133,34,132,20,319
2414,117,17,132,20,286
2415,117,31,121,12,281
2416,102,31,121,12,266
2417,116,34,118,16,284
2418,132,34,117,17,300
2419,116,34,117,17,284
2420,117,16,117,17,267
2422,132,32,134,18,316
2425,104,12,134,18,268
2426,118,16,134,15,283
2427,116,34,115,18,283
2428,117,17,115,18,267
2429,116,32,118,17,283
2430,101,32,118,17,268
2431,113,33,102,16,264
2432,118,16,102,16,252
2434,117,17,117,16,267
2435,117,33,115,18,283
2439,118,33,132,17,300
2440,102,33,132,17,284
2441,117,33,99,17,266
2442,117,16,99,17,249
2444,115,18,117,16,266
2445,116,34,134,16,300
2446,133,32,118,15,298
2450,99,34,117,17,267
2451,101,17,117,17,252
2452,100,33,117,30,280
2453,101,16,117,30,264
2454,134,31,119,16,300
2456,102,31,119,16,268
2457,116,35,117,15,283
2458,117,17,117,15,266
2460,101,46,120,18,285
2461,114,15,120,18,267
2462,112,19,119,16,266
2463,115,35,117,15,282
2465,101,16,117,15,249
2469,120,34,116,16,286
2470,101,34,116,16,267
2473,115,33,101,17,266
2474,133,34,118,16,301
2477,115,33,101,16,265
2478,116,16,101,16,249
2479,115,34,134,17,300
2480,117,17,134,17,285
2481,116,33,118,17,284
2482,101,33,118,17,269
2483,116,34,134,17,301
2484,118,16,134,17,285
2485,117,33,118,16,284
2486,101,33,118,16,268
2487,117,34,100,15,266
2488,134,34,131,18,317
2489,117,34,131,18,300
2491,117,33,116,16,282
2492,134,33,134,16,317
2493,118,33,134,16,301
2495,101,16,134,16,267
2496,100,32,118,16,266
2497,115,33,119,15,282
2502,134,32,118,16,300
2503,119,32,118,16,285
2505,101,16,118,16,251
2508,100,35,116,17,268
2510,117,15,117,17,266
2511,116,34,117,16,283
2512,100,34,117,16,267
2514,117,17,117,16,267
2515,117,34,117,16,284
2516,116,17,117,16,266
2518,101,33,133,17,284
2519,116,33,117,15,281
2520,117,16,117,15,265
2523,116,34,118,15,283
2524,117,16,118,15,266
2525,117,33,100,18,268
2526,100,33,100,18,251
2527,116,32,118,15,281
2531,116,33,117,17,283
2532,118,15,117,17,267
2534,100,32,102,16,250
2536,118,15,136,15,284
2537,114,35,116,19,284
2538,133,34,116,16,299
2540,117,17,116,16,266
2541,116,31,101,17,265
2542,102,31,101,17,251
2543,100,15,101,17,233
2544,136,34,115,17,302
2547,118,31,118,16,283
2549,116,34,132,19,301
2550,101,34,132,19,286
2552,132,34,117,17,300
2553,117,34,117,17,285
2554,115,17,117,17,266
2555,117,33,116,18,284
2556,118,16,116,18,268
2557,117,32,119,17,285
2559,116,35,116,16,283
2560,118,16,116,16,266
2561,117,34,117,15,283
2562,100,34,117,15,266
2563,117,33,132,18,300
2564,101,33,132,18,284
2566,102,34,116,16,268
2567,117,31,101,17,266
2572,132,34,132,19,317
2573,115,34,132,19,300
2574,116,16,132,19,283
2575,101,16,132,19,268
2577,115,34,134,17,300
2578,116,18,134,17,285
2579,116,33,118,14,281
2581,100,16,118,14,248
2583,115,35,117,16,283
2584,118,16,117,16,267
2586,134,31,119,16,300
2587,117,31,119,16,283
2588,101,31,119,16,267
2590,117,19,117,15,268
2591,117,32,118,16,283
2592,117,16,118,16,267
2593,100,16,118,16,250
2594,136,30,118,17,301
2595,119,30,118,17,284
2596,105,30,118,17,270
2597,102,16,118,17,253
2600,100,34,117,16,267
2602,131,34,132,17,314
2603,117,34,132,17,300
2605,117,33,116,16,282
2606,102,33,116,16,267
2607,117,32,133,16,298
2608,117,16,133,16,282
2609,102,16,133,16,267
2611,115,34,134,16,299
2612,115,17,134,16,282
2614,116,16,117,17,266
2615,116,33,101,18,268
2617,117,32,118,16,283
2618,116,16,118,16,266
2620,134,33,131,20,318
2621,117,33,131,20,301
2624,101,32,119,16,268
2625,103,14,119,16,252
2626,101,33,102,15,251
2627,114,34,118,16,282
2629,116,32,102,17,267
2630,131,36,132,16,315
2631,113,36,132,16,297
2633,118,33,115,16,282
2634,102,33,115,16,266
2635,117,33,133,15,298
2636,101,33,133,15,282
2637,102,16,133,15,266
2638,102,34,114,19,269
2639,116,32,116,17,281
2642,115,16,119,17,267
2644,133,34,116,16,299
2645,116,34,116,16,282
2646,114,19,116,16,265
2648,101,32,117,19,269
2649,117,35,101,15,268
2650,119,17,101,15,252
2652,101,32,133,16,282
2653,102,16,133,16,267
2654,116,16,116,19,267
2655,117,36,130,17,300
2656,100,36,130,17,283
2657,118,31,116,16,281
2658,101,31,116,16,264
2660,133,35,116,17,301
2661,116,35,116,17,284
2662,116,19,116,17,268
2663,118,31,102,16,267
2664,130,33,135,17,315
2666,116,16,135,17,284
2667,115,35,133,16,299
2669,118,34,131,17,300
2670,116,17,131,17,281
2673,101,15,117,19,252
2674,119,16,117,16,268
2675,116,33,133,16,298
2676,117,16,133,16,282
2677,116,32,117,17,282
2680,117,19,131,18,285
2681,117,32,117,18,284
2682,101,32,117,18,268
2683,116,33,102,16,267
2685,133,17,119,14,283
2686,117,17,119,14,267
2687,117,33,100,17,267
2688,131,36,132,16,315
2691,103,18,132,16,269
2692,102,32,116,16,266
2693,102,16,116,16,250
2694,101,32,135,15,283
2696,100,35,115,17,267
2697,117,33,117,16,283
2698,132,32,101,17,282
2699,116,32,101,17,266
2700,116,16,101,17,250
2701,114,35,117,16,282
2702,135,32,101,18,286
2703,118,32,101,18,269
2704,115,17,101,18,251
2705,115,34,117,18,284
2706,117,16,117,18,268
2709,116,33,115,20,284
2710,117,16,115,20,268
2712,101,32,103,14,250
2713,115,36,114,17,282
2714,117,18,114,17,266
2715,118,33,131,18,300
2717,117,34,115,17,283
2718,115,20,115,17,267
2719,117,32,116,16,281
2720,103,32,116,16,267
2722,114,17,117,18,266
2724,131,35,133,15,314
2725,117,35,133,15,300
2727,118,32,116,17,283
2728,116,16,116,17,265
2730,100,35,132,16,283
2735,117,32,118,17,284
2737,116,34,117,16,283
2738,132,34,132,18,316
2739,116,34,132,18,300
2740,100,34,132,18,284
2742,100,33,117,16,266
2743,118,34,132,18,302
2744,101,34,132,18,285
2745,117,32,118,17,284
2747,101,16,118,17,252
2748,116,16,102,16,250
2750,117,16,117,16,266
2752,132,35,132,16,315
2753,116,35,132,16,299
2754,118,17,132,16,283
2755,118,33,115,17,283
2757,100,17,115,17,249
2758,101,32,116,17,266
2759,116,33,100,17,266
2760,117,16,100,17,250
2761,115,34,117,17,283
2763,116,33,101,17,267
2764,115,17,101,17,250
2766,116,17,117,18,268
2767,116,35,117,16,284
2771,101,17,116,16,250
2774,117,18,117,15,267
2775,118,33,116,17,284
2776,117,16,116,17,266
2777,117,32,117,18,284
2778,116,16,117,18,267
2779,115,34,134,16,299
2780,116,17,134,16,283
2781,117,33,117,16,283
2782,117,15,117,16,265
2783,100,15,117,16,248
2784,116,17,118,16,267
2785,117,34,132,17,300
2786,117,18,132,17,284
2787,118,33,116,16,283
2788,101,33,116,16,266
2789,132,16,117,18,283
2793,102,16,132,17,267
2794,100,32,117,16,265
2795,117,33,117,17,284
2797,116,35,115,17,283
2798,117,18,115,17,267
2799,116,32,133,16,297
2800,132,33,116,17,298
2802,100,33,116,17,266
2803,116,34,116,17,283
2804,117,17,116,17,267
2805,117,33,132,19,301
2806,115,17,132,19,283
2809,116,33,118,17,284
2810,116,17,118,17,268
2811,116,34,101,16,267
2812,116,17,101,16,250
2814,132,35,116,17,300
2815,115,35,116,17,283
2816,118,16,116,17,267
2817,118,34,116,17,285
2818,118,17,116,17,268
2821,114,33,117,16,280
2822,102,33,117,16,268
2823,116,33,116,19,284
2825,116,34,117,15,282
2827,117,33,133,18,301
2828,133,33,118,16,300
2831,117,35,116,16,284
2832,100,35,116,16,267
2833,118,31,134,18,301
2834,101,31,134,18,284
2836,133,34,117,20,304
2837,116,34,117,20,287
2838,100,34,117,20,271
2839,102,16,117,20,255
2841,116,33,134,16,299
2842,134,35,133,16,318
2843,117,35,133,16,301
2844,118,17,133,16,284
2845,117,36,113,18,284
2846,101,36,113,18,268
2847,100,20,113,18,251
2848,104,28,103,14,249
2849,102,14,103,14,233
2850,134,34,115,17,300
2851,116,34,115,17,282
2852,115,18,115,17,265
2853,117,34,132,16,299
2855,117,31,117,16,281
2856,103,31,117,16,267
2857,116,34,134,16,300
2859,117,33,117,16,283
2860,115,17,117,16,265
2862,132,32,102,17,283
2863,118,32,102,17,269
2865,115,35,116,16,282
2866,134,32,117,18,301
2867,118,32,117,18,285
2869,117,35,133,16,301
2870,116,18,133,16,283
2871,118,32,117,18,285
2873,116,33,102,16,267
2874,116,16,102,16,250
2876,117,18,132,17,284
2877,118,33,116,17,284
2878,133,34,116,16,299
2879,116,34,116,16,282
2880,101,34,116,16,267
2882,102,32,117,17,268
2883,101,16,117,17,251
2886,116,17,132,19,284
2887,117,33,118,15,283
2888,116,16,118,15,265
2890,117,17,115,19,268
2892,101,33,117,17,268
2896,118,15,101,16,250
2900,101,33,117,16,267
2901,101,17,117,16,251
2903,116,33,133,17,299
2904,101,33,133,17,284
2906,133,33,117,16,299
2907,117,33,117,16,283
2909,117,33,116,16,282
2910,117,16,116,16,265
2911,117,33,134,16,300
2912,133,34,116,17,300
2913,117,34,116,17,284
2914,116,17,116,17,266
2915,116,33,115,17,281
2917,116,32,135,16,299
2918,116,16,135,16,283
2920,134,33,117,17,301
2922,100,33,117,17,267
2923,116,32,102,15,265
2924,100,32,102,15,249
2925,116,35,134,16,301
2927,116,33,117,17,283
2928,116,17,117,17,267
2929,117,34,115,18,284
2930,117,17,115,18,267
2931,102,17,115,18,252
2932,102,32,101,16,251
2933,117,35,132,16,300
2934,134,33,115,17,299
2935,118,33,115,17,283
2936,101,33,115,17,266
2938,115,18,133,17,283
2941,116,33,115,18,282
2942,132,33,117,16,298
2943,116,33,117,16,282
2944,115,17,117,16,265
2946,133,34,115,18,300
2947,117,34,115,18,284
2948,117,17,115,18,267
2949,117,32,101,15,265
2952,100,33,135,16,284
2955,116,34,133,16,299
2957,119,33,116,17,285
2958,101,33,116,17,267
2959,117,34,133,16,300
2960,101,34,133,16,284
2961,117,33,116,17,283
2962,101,33,116,17,267
2963,118,33,116,17,284
2964,133,33,133,18,317
2965,118,33,133,18,302
2966,116,17,133,18,284
2968,133,33,133,16,315
2969,117,33,133,16,299
2972,100,33,116,17,266
2974,117,16,133,18,284
2975,116,34,117,17,284
2976,117,16,117,17,267
2977,117,33,101,19,270
2978,100,33,101,19,253
2980,116,17,117,16,266
2981,116,33,134,16,299
2982,133,35,115,18,301
2983,115,35,115,18,283
2984,117,17,115,18,267
2985,117,33,100,17,267
2987,104,14,100,17,235
2989,115,34,118,16,283
2990,134,34,117,17,302
2991,116,34,117,17,284
2994,100,33,117,17,267
2995,101,16,117,17,251
2996,117,18,132,17,284
2997,117,33,116,17,283
2998,101,33,116,17,267
3000,117,17,132,16,282
3001,117,33,115,17,282
3003,118,32,134,16,300
3006,116,17,116,17,266
3007,116,33,133,17,299
3009,116,33,117,18,284
3010,115,17,117,18,267
3011,116,34,117,16,283
3012,100,34,117,16,267
3014,116,17,131,20,284
3015,116,33,118,17,284
3016,133,35,116,16,300
3019,119,32,117,16,284
3020,117,16,117,16,266
3022,131,20,117,16,284
3023,114,20,117,16,267
3024,118,17,116,16,267
3026,116,16,117,17,266
3027,100,16,117,17,250
3028,100,33,118,15,266
3029,116,35,132,17,300
3031,117,32,117,17,283
3032,116,16,117,17,266
3033,116,34,117,16,283
3035,117,32,118,16,283
3036,118,15,118,16,267
3037,116,34,117,16,283
3038,132,34,117,16,299
3040,117,17,117,16,267
3041,117,33,133,18,301
3043,116,33,118,14,281
3044,101,33,118,14,266
3045,116,33,116,18,283
3047,116,34,133,17,300
3048,117,16,133,17,283
3050,133,32,102,18,285
3051,116,32,102,18,268
3052,118,14,102,18,252
3053,115,35,117,15,282
3054,116,18,117,15,266
3056,100,33,117,17,267
3058,117,17,115,17,266
3061,103,14,119,15,251
3062,117,15,101,16,249
3063,115,35,133,17,300
3064,117,17,133,17,284
3065,117,32,118,17,284
3066,115,17,118,17,267
3068,100,34,117,16,267
3071,117,33,133,18,301
3072,133,34,117,14,298
3073,118,34,117,14,283
3074,118,17,117,14,266
3075,116,32,118,17,283
3076,117,16,118,17,268
3078,132,34,117,18,301
3079,116,34,117,18,285
3082,117,14,118,17,266
3083,115,36,115,17,283
3084,118,17,115,17,267
3085,119,33,133,17,302
3086,102,33,133,17,285
3088,101,34,116,14,265
3089,117,32,134,17,300
3090,103,32,134,17,286
3093,117,34,115,19,285
3094,133,31,103,17,284
3095,117,31,103,17,268
3097,101,14,103,17,235
3098,134,32,117,18,301
3099,118,32,117,18,285
3100,118,15,117,18,268
3101,116,35,115,17,283
3103,117,32,117,17,283
3104,103,32,117,17,269
3105,102,15,117,17,251
3106,131,36,133,16,316
3107,114,36,133,16,299
3108,117,18,133,16,284
3109,119,32,117,17,285
3110,115,17,117,17,266
3111,115,34,116,16,281
3112,117,17,116,16,266
3113,117,32,133,18,300
3114,102,32,133,18,285
3116,133,33,115,18,299
3117,118,33,115,18,284
3118,117,17,115,18,267
3119,117,32,118,16,283
3121,115,33,101,18,267
3122,133,35,133,16,317
3123,116,35,133,16,300
3125,117,33,116,17,283
3126,115,18,116,17,266
3127,117,33,117,16,283
3128,101,33,117,16,267
3129,117,34,115,17,283
3130,101,34,115,17,267
3132,117,16,134,17,284
3133,118,33,118,17,286
3134,100,33,118,17,268
3136,117,16,102,15,250
3138,115,17,117,18,267
3139,115,35,132,18,300
3140,134,34,116,16,300
3142,118,17,116,16,267
3146,102,33,115,19,269
3147,118,32,102,16,268
3149,115,34,118,16,283
3150,116,16,118,16,266
3151,117,34,100,15,266
3152,133,34,115,16,298
3153,118,34,115,16,283
3155,118,33,115,18,284
3157,117,33,132,17,299
3158,118,16,132,17,283
3159,117,32,117,17,283
3161,117,33,118,17,285
3164,115,18,116,33,282
3165,116,32,117,17,282
3167,117,34,100,16,267
3168,117,17,100,16,250
3169,117,34,133,16,300
3170,101,34,133,16,284
3172,116,33,117,16,282
3175,117,32,118,17,284
3176,100,32,118,17,267
3177,115,35,133,16,299
3178,133,33,116,16,298
3180,102,33,116,16,267
3182,116,18,133,15,282
3183,118,33,115,19,285
3184,102,33,115,19,269
3185,118,33,101,16,268
3187,117,32,118,16,283
3188,116,16,118,16,266
3189,116,35,133,16,300
3192,115,19,115,17,266
3193,118,33,115,35,301
3196,102,32,118,15,267
3199,118,33,117,16,284
3201,116,51,133,16,316
3202,115,35,133,16,299
3203,134,15,118,16,283
3204,118,15,118,16,267
3206,116,18,115,17,266
3207,118,32,134,17,301
3208,117,16,134,17,284
3211,117,32,101,16,266
3212,118,16,101,16,251
3214,115,17,133,18,283
3216,134,34,133,17,318
3217,118,34,133,17,302
3218,116,17,133,17,283
3219,100,17,133,17,267
3220,101,32,118,16,267
3221,117,33,101,18,269
3222,100,33,101,18,252
3224,117,17,117,15,266
3225,117,33,133,17,300
3226,133,33,117,16,299
3227,117,33,117,16,283
3228,101,33,117,16,267
3229,101,16,117,16,250
3231,117,32,134,16,299
3232,117,15,134,16,282
3233,115,34,116,18,283
3234,133,33,117,17,300
3235,116,33,117,17,283
3236,117,16,117,17,267
3238,115,18,117,16,266
3239,116,33,133,16,298
3241,114,34,133,17,298
3242,100,34,133,17,284
3243,117,33,117,16,283
3244,101,33,117,16,267
3245,118,33,132,17,300
3247,118,33,134,16,301
3249,117,34,116,17,284
3250,115,18,116,17,266
3252,100,33,135,14,282
3256,116,18,115,35,284
3258,116,17,117,17,267
3259,116,35,115,16,282
3262,103,30,101,17,251
3263,116,52,132,18,318
3265,134,17,133,15,299
3267,101,17,133,15,266
3269,117,33,117,18,285
3270,101,33,117,18,269
3271,117,34,116,17,284
3272,102,34,116,17,269
3273,116,34,132,18,300
3274,133,33,133,17,316
3275,117,33,133,17,300
3277,117,34,116,17,284
3278,101,34,116,17,268
3279,117,32,101,17,267
3280,101,32,101,17,251
3281,117,33,118,16,284
3282,132,34,117,18,301
3283,117,34,117,18,286
3284,117,16,117,18,268
3286,116,17,116,16,265
3287,101,17,116,16,250
3288,101,33,132,17,283
3289,118,33,116,17,284
3290,101,33,116,17,267
3291,116,35,115,16,282
3293,118,31,117,18,284
3294,101,31,117,18,267
3295,115,33,102,16,266
3296,132,34,117,18,301
3297,115,34,117,18,284
3298,116,17,117,18,268
3299,116,33,102,17,268
3300,115,16,102,17,250
3301,116,35,133,15,299
3304,102,32,116,20,270
3306,100,35,115,17,267
3307,118,33,133,17,301
3309,102,16,133,17,268
3310,133,35,114,17,299
3311,117,35,114,17,283
3312,116,20,114,17,267
3314,101,31,135,14,281
3315,115,34,132,17,298
3316,133,33,133,16,315
3317,113,33,133,16,295
3318,100,33,133,16,282
3319,102,16,133,16,267
3321,117,35,116,16,284
3322,135,31,118,16,300
3324,115,17,118,16,266
3326,116,17,118,16,267
3327,117,38,113,16,284
3328,116,22,113,16,267
3330,103,29,133,16,281
3331,102,16,133,16,267
3332,118,16,116,18,268
3333,117,34,117,16,284
3334,100,34,117,16,267
3335,118,33,132,19,302
3336,113,16,132,19,280
3342,117,16,133,16,282
3343,116,32,117,18,283
3344,132,35,117,16,300
3345,115,35,117,16,283
3346,118,16,117,16,267
3348,115,17,101,17,250
3349,115,34,133,17,299
3350,133,34,116,20,303
3352,101,34,116,20,271
3353,116,33,103,14,266
3354,117,16,103,14,250
3355,118,33,134,16,301
3356,101,33,134,16,284
3357,115,33,117,16,281
3358,133,37,115,16,301
3360,116,20,115,16,267
3362,103,30,101,17,251
3364,134,32,118,16,300
3366,101,32,118,16,267
3367,116,35,116,17,284
3368,115,16,116,17,264
3369,117,31,102,15,265
3370,101,31,102,15,249
3371,115,36,116,16,283
3372,134,32,134,16,316
3373,118,32,134,16,300
3374,102,32,134,16,284
3376,116,17,116,17,266
3377,116,33,100,17,266
3378,102,33,100,17,252
3379,118,33,116,17,284
3381,116,34,116,16,282
3383,117,33,117,18,285
3384,116,17,117,18,268
3385,101,17,117,18,253
3386,100,33,102,14,249
3387,116,33,133,17,299
3388,100,33,133,17,283
3393,118,30,119,17,284
3396,133,34,101,17,285
3397,116,34,101,17,268
3398,100,34,101,17,252
3399,116,34,133,16,299
3400,132,34,115,17,298
3401,118,34,115,17,284
3402,102,34,115,17,268
3403,118,33,117,17,285
3404,102,33,117,17,269
3406,101,31,103,15,250
3407,114,35,116,16,281
3408,133,33,116,18,300
3409,116,33,116,18,283
3410,115,17,116,18,266
3411,115,35,132,17,299
3413,117,32,117,17,283
3415,117,32,102,15,266
3417,116,35,133,16,300
3419,116,33,116,18,283
3420,132,34,115,33,314
3421,117,34,115,33,299
3422,117,17,115,33,282
3423,118,33,115,18,284
3424,102,33,115,18,268
3425,118,33,100,17,268
3427,116,34,133,17,300
3428,116,18,133,17,284
3430,115,33,102,17,267
3431,115,18,102,17,252
3432,115,18,101,15,249
3434,100,34,133,16,283
3435,118,33,116,16,283
3436,116,17,116,16,265
3438,103,34,116,17,270
3439,102,17,116,17,252
3441,132,18,133,16,299
3442,133,32,117,19,301
3443,117,32,117,19,285
3444,116,16,117,19,268
3445,115,35,101,17,268
3447,118,39,126,17,300
3448,102,39,126,17,284
3450,133,35,116,16,300
3451,117,35,116,16,284
3452,117,19,116,16,268
3453,118,31,117,17,283
3454,101,31,117,17,266
3455,102,14,117,17,250
3456,126,35,115,16,292
3458,116,18,115,16,265
3459,118,33,119,13,283
3460,116,16,119,13,264
3461,115,33,132,18,298
3462,101,33,132,18,284
3463,100,17,132,18,267
3464,101,33,117,17,268
3465,117,32,102,16,267
3466,115,16,102,16,249
3467,114,34,136,15,299
3468,119,13,136,15,283
3469,103,13,136,15,267
3470,132,35,117,17,301
3473,118,32,102,15,267
3474,102,32,102,15,251
3475,130,19,131,17,297
3477,119,31,117,17,284
3478,103,31,117,17,268
3479,116,35,115,17,283
3480,117,17,115,17,266
3484,131,34,117,17,299
3485,116,34,117,17,284
3489,117,32,103,16,268
3490,101,32,103,16,252
3491,116,34,134,18,302
3492,133,35,117,16,301
3493,116,35,117,16,284
3494,117,17,117,16,267
3495,118,34,131,16,299
3496,101,34,131,16,282
3498,103,31,116,17,267
3500,134,34,115,17,300
3502,117,16,115,17,265
3505,115,33,134,18,300
3506,116,17,134,18,285
3508,99,34,118,15,266
3509,102,13,118,15,248
3510,115,17,135,15,282
3511,117,33,117,18,285
3513,117,34,116,19,286
3515,113,33,118,17,281
3520,102,33,116,17,268
3524,102,33,132,18,285
3527,116,35,117,16,284
3529,118,33,118,15,284
3530,115,17,118,15,265
3532,132,34,116,16,298
3533,115,34,116,16,281
3534,101,34,116,16,267
3537,117,33,101,16,267
3538,100,33,101,16,250
3541,116,32,118,15,281
3542,116,16,118,15,265
3543,115,35,115,17,282
3545,116,32,118,17,283
3546,101,32,118,17,268
3547,115,34,118,21,288
3550,101,32,107,15,255
3551,115,34,122,17,288
3553,116,35,104,16,271
3554,100,35,104,16,255
3555,117,38,132,18,305
3556,118,21,132,18,289
3557,122,32,118,16,288
3558,107,32,118,16,273
3559,105,17,118,16,256
3560,105,34,116,17,272
3561,121,33,100,16,270
3563,103,17,100,16,236
3564,132,34,115,17,298
3565,117,34,115,17,283
3566,118,16,115,17,266
3567,117,33,117,17,284
3568,116,17,117,17,267
3569,117,31,103,16,267
3570,100,31,103,16,250
3571,114,34,118,16,282
3572,116,16,118,16,266
3573,114,34,117,16,281
3574,115,17,117,16,265
3575,116,35,133,16,300
3576,117,17,133,16,283
3577,118,31,118,17,284
3578,103,31,118,17,269
3579,101,15,118,17,251
3582,100,33,102,15,250
3583,115,35,116,17,283
3584,133,33,116,17,299
3586,102,33,116,17,268
3587,117,34,117,15,283
3588,118,17,117,15,267
3589,118,32,117,18,285
3590,102,32,117,18,269
3594,116,17,117,17,267
3595,116,33,101,17,267
3596,117,15,101,17,250
3597,102,15,101,17,235
3598,100,35,115,17,267
3599,118,31,117,17,283
3600,101,31,117,17,266
3601,116,35,132,18,301
3602,117,17,132,18,284
3603,116,33,133,17,299
3607,118,33,117,16,284
3608,117,17,117,16,267
3609,116,33,134,16,299
3610,132,34,116,17,299
3612,117,16,116,17,266
3613,117,32,117,17,283
3615,101,15,117,17,250
3619,116,33,133,18,300
3620,116,17,133,18,284
3621,116,33,118,17,284
3622,101,33,118,17,269
3624,134,34,134,16,318
3625,118,34,134,16,302
3627,118,32,118,15,283
3629,117,35,115,17,284
3630,100,35,115,17,267
3632,101,32,117,16,266
3633,117,35,131,17,300
3635,117,31,117,18,283
3636,102,31,117,18,268
3637,115,34,118,16,283
3638,115,17,118,16,266
3640,100,33,134,16,283
3641,117,33,117,18,285
3643,115,35,116,17,283
3644,117,18,116,17,268
3645,118,33,117,16,284
3647,101,16,117,16,250
3649,117,34,116,17,284
3650,117,18,116,17,268
3651,118,33,116,16,283
3652,116,17,116,16,265
3655,117,32,101,16,266
3657,116,35,117,17,285
3658,116,17,117,17,267
3660,116,16,119,14,265
3661,115,34,116,18,283
3663,117,35,115,17,284
3664,101,35,115,17,268
3665,118,33,116,17,284
3666,101,33,116,17,267
3667,101,17,116,17,251
3668,102,31,102,17,252
3669,102,14,102,17,235
3670,116,18,116,18,268
3671,118,33,117,16,284
3672,115,17,117,16,265
3676,102,32,133,17,284
3678,116,18,115,17,266
3679,118,32,134,16,300
3680,101,32,134,16,283
3681,116,34,116,17,283
3682,116,17,116,17,266
3683,116,32,115,19,282
3684,133,34,117,17,301
3686,115,17,117,17,266
3688,134,33,117,17,301
3689,117,33,117,17,284
3690,116,17,117,17,267
3691,117,33,118,15,283
3692,115,19,118,15,267
3693,117,34,116,16,283
3696,133,34,117,15,299
3701,116,33,120,14,283
3702,116,16,120,14,266
3703,115,35,132,16,298
3704,134,32,116,19,301
3705,117,32,116,19,284
3707,100,15,116,19,250
3708,135,32,117,17,301
3713,115,35,116,16,282
3714,116,19,116,16,267
3715,118,32,119,16,285
3716,100,32,119,16,267
3717,114,34,134,15,297
3718,117,17,134,15,283
3722,116,16,101,16,249
3723,116,35,115,16,282
3724,119,16,115,16,266
3726,134,33,133,17,317
3727,117,33,133,17,300
3729,117,33,117,16,283
3731,115,32,101,17,265
3733,114,35,117,17,283
3735,118,33,116,16,283
3737,117,33,134,17,301
3739,117,34,117,16,284
3740,101,34,117,16,268
3742,117,17,132,17,283
3743,117,31,135,17,300
3744,101,31,135,17,284
3745,115,35,117,17,284
3746,134,33,101,17,285
3749,116,33,133,16,298
3752,118,17,115,17,267
3756,101,31,102,15,249
3758,133,33,117,18,301
3759,116,33,117,18,284
3760,115,17,117,18,267
3761,115,35,115,17,282
3762,115,18,115,17,265
3763,116,30,102,17,265
3764,102,30,102,17,251
3765,100,15,102,17,234
3766,133,35,115,18,301
3767,117,35,115,18,285
3768,117,18,115,18,268
3769,100,18,115,18,251
3773,118,32,119,15,284
3774,118,15,119,15,267
3778,134,33,117,17,301
3780,116,17,117,17,267
3782,101,33,101,17,252
3783,102,15,101,17,235
3784,116,15,118,17,266
3786,132,35,133,17,317
3788,117,17,133,17,284
3789,116,33,117,16,282
3790,101,33,117,16,267
3792,118,17,137,13,285
3793,116,33,117,17,283
3794,101,33,117,17,268
3795,116,34,100,17,267
3796,133,33,117,17,300
3798,117,16,117,17,267
3799,101,16,117,17,251
3800,137,30,134,15,316
3801,120,30,134,15,299
3802,104,30,134,15,283
3803,101,17,134,15,267
3804,100,34,115,17,266
3805,117,33,133,16,299
3806,101,33,133,16,283
3807,119,32,117,17,285
3808,129,35,115,18,297
3809,116,35,115,18,284
3810,117,17,115,18,267
3812,115,17,118,16,266
3813,116,34,115,18,283
3814,133,33,116,18,300
3815,117,33,116,18,284
3816,101,33,116,18,268
3817,116,34,116,17,283
3821,101,16,133,15,265
3822,115,18,115,19,267
3823,117,34,117,16,284
3825,118,33,100,16,267
3827,116,33,117,17,283
3828,133,34,116,15,298
3830,115,19,116,15,265
3832,100,33,132,18,283
3833,117,34,116,16,283
3834,100,34,116,16,266
3836,101,33,134,15,283
3837,119,31,118,16,284
3838,116,15,118,16,265
3839,114,34,117,17,282
3841,116,34,133,17,300
3843,116,35,115,17,283
3844,134,31,101,16,282
3846,103,31,101,16,251
3847,115,34,118,15,282
3849,116,33,100,18,267
3853,100,17,116,17,250
3854,101,33,134,17,285
3855,117,33,118,15,283
3856,118,15,118,15,266
3857,116,33,117,17,283
3859,101,15,117,17,250
3860,116,17,133,16,282
3861,117,34,115,17,283
3865,115,34,117,17,283
3867,117,33,101,41,292
3868,133,33,109,6,281
3869,117,33,109,6,265
3870,115,17,109,6,247
3871,115,34,127,16,292
3873,117,34,109,17,277
3875,118,41,135,17,311
3876,101,41,135,17,294
3877,126,34,118,17,295
3879,125,34,118,15,292
3880,127,16,118,15,276
3881,126,33,100,18,277
3882,109,33,100,18,260
3884,129,34,116,17,296
3885,118,34,116,17,285
3887,100,17,116,17,250
3888,101,32,118,16,267
3889,116,33,101,16,266
3890,100,33,101,16,250
3891,101,15,101,16,233
3892,117,16,133,17,283
3894,116,17,116,17,266
3895,116,33,133,16,298
3897,116,33,116,17,282
3898,101,33,116,17,267
3899,99,17,116,17,249
3900,133,34,120,29,316
3901,116,34,120,29,299
3902,116,17,120,29,282
3903,116,33,116,17,282
3904,133,33,134,17,317
3905,117,33,134,17,301
3907,100,17,134,17,268
3911,105,46,117,16,284
3912,116,17,117,16,266
3913,117,34,133,18,302
3914,100,34,133,18,285
3915,117,34,117,16,284
3916,101,34,117,16,268
3918,115,18,115,19,267
3919,100,18,115,19,252
3921,117,34,116,18,285
3924,117,16,134,16,283
3925,102,16,134,16,268
3927,118,32,100,17,267
3928,102,32,100,17,251
3929,132,18,118,31,299
3930,116,18,118,31,283
3931,116,34,115,18,283
3932,134,32,132,17,315
3933,119,32,132,17,300
3934,116,16,132,17,281
3935,117,33,116,18,284
3936,100,33,116,18,267
3937,117,19,115,17,268
3939,118,34,115,19,286
3940,115,18,115,19,267
3941,117,31,119,15,282
3942,132,35,117,16,300
3943,115,35,117,16,283
3945,115,32,101,16,264
3946,117,15,101,16,249
3947,101,15,101,16,233
3949,118,31,118,17,284
3950,103,31,118,17,269
3951,102,15,118,17,252
3952,117,16,101,16,250
3953,116,33,117,17,283
3955,117,33,118,17,285
3956,131,35,133,16,315
3957,115,35,133,16,299
3959,117,32,117,16,282
3961,101,16,117,16,250
3962,100,34,117,16,267
3963,116,34,117,16,283
3964,118,17,117,16,268
3965,117,33,100,17,267
3966,133,32,117,17,299
3967,117,32,117,17,283
3969,116,34,118,15,283
3972,117,16,134,16,283
3974,100,33,117,16,266
3976,101,33,118,16,268
3977,116,33,101,16,266
3978,118,15,101,16,250
3979,115,35,133,16,299
3980,134,32,117,16,299
3981,117,32,117,16,282
3982,117,16,117,16,266
3984,100,34,116,16,266
3986,101,32,100,18,251
3987,116,35,133,15,299
3990,101,32,116,18,267
3991,115,33,101,16,265
3994,100,34,116,17,267
3995,116,34,132,18,300
3997,117,33,117,16,283
3999,117,34,116,17,284
4000,101,34,116,17,268
4001,117,32,101,16,266
4002,116,17,101,16,250
4003,116,33,117,18,284
4004,132,34,116,18,300
4005,117,34,116,18,285
4006,117,16,116,18,267
4008,116,17,134,15,282
4009,101,17,134,15,267
4010,101,32,117,18,268
4011,116,35,116,16,283
4013,117,33,116,16,282
4015,117,34,133,16,300
4020,116,16,117,16,265
4021,117,33,134,17,301
4022,116,16,134,17,283
4024,133,32,116,17,298
4026,116,16,116,17,265
4027,116,33,134,16,299
4029,116,34,116,19,285
4031,116,32,103,31,282
4032,116,15,103,31,265
4033,115,34,118,16,283
4035,116,34,116,18,284
4036,134,35,132,17,318
4038,116,19,132,17,284
4040,103,31,118,17,269
4041,117,34,134,17,302
4042,118,16,134,17,285
4043,117,34,117,17,285
4045,118,33,116,16,283
4046,132,34,115,18,299
4047,117,34,115,18,284
4048,118,17,115,18,268
4049,100,17,115,18,250
4050,101,33,116,18,268
4051,118,34,115,18,285
4052,100,34,115,18,267
4053,119,31,119,15,284
4054,101,31,119,15,266
4055,115,35,132,17,299
4056,115,18,132,17,282
4058,116,18,132,17,283
4060,115,18,133,17,283
4061,118,32,118,16,284
4062,102,32,118,16,268
4063,102,15,118,16,251
4064,132,34,121,29,316
4065,116,34,121,29,300
4066,115,17,121,29,282
4068,116,17,116,17,266
4071,117,33,101,17,268
4072,101,33,101,17,252
4076,116,17,134,16,283
4077,116,34,116,16,282
4079,116,32,117,18,283
4081,112,34,117,16,279
4083,117,34,116,17,284
4085,118,32,116,17,283
4086,100,32,116,17,265
4087,115,35,115,16,281
4089,118,32,134,16,300
4093,117,32,133,18,300
4095,116,33,118,17,284
4096,115,16,118,17,266
4097,115,35,100,17,267
4099,117,33,118,17,285
4100,116,17,118,17,268
4101,101,17,118,17,253
4103,116,35,132,18,301
4104,118,17,132,18,285
4105,116,32,118,17,283
4106,100,32,118,17,267
4107,101,15,118,17,251
4108,118,49,132,17,316
4109,102,49,132,17,300
4110,103,32,132,17,284
4111,117,32,117,17,283
4112,132,35,116,16,299
4113,133,17,116,16,282
4115,116,33,116,16,281
4116,116,16,116,16,264
4117,116,32,134,16,298
4118,132,34,116,18,300
4120,117,17,116,18,268
4122,116,16,101,17,250
4123,115,33,118,15,281
4124,116,16,118,15,265
4126,134,34,117,15,300
4127,117,34,117,15,283
4128,116,18,117,15,266
4129,117,34,131,17,299
4130,101,34,131,17,283
4131,118,31,117,17,283
4132,118,15,117,17,267
4133,116,35,116,18,285
4134,116,18,116,18,268
4135,118,32,102,15,267
4136,117,15,102,15,249
4137,115,33,117,18,283
4138,131,34,101,17,283
4141,117,35,116,16,284
4143,117,32,133,16,298
4145,117,34,115,17,283
4147,118,33,116,17,284
4148,101,33,116,17,267
4149,101,16,116,17,250
4150,116,16,117,16,265
4151,117,33,134,16,300
4154,115,17,117,17,266
4155,115,34,100,18,267
4157,116,33,117,18,284
4159,116,34,133,16,299
4160,134,33,116,17,300
4162,117,17,116,17,267
4163,117,35,131,17,300
4164,100,35,131,17,283
4165,101,17,131,17,266
4166,102,33,115,17,267
4167,119,32,117,16,284
4168,133,33,117,15,298
4169,117,33,117,15,282
4170,116,17,117,15,265
4171,115,33,119,32,299
4174,115,17,117,17,266
4175,117,33,116,17,283
4177,117,32,101,29,279
4179,115,20,110,22,267
4180,119,49,117,16,301
4181,102,49,117,16,284
4183,117,32,101,17,267
4184,101,32,101,17,251
4185,116,29,123,16,284
4187,110,39,134,17,300
4190,117,16,118,17,268
4191,118,34,101,31,284
4192,101,34,101,31,267
4194,117,16,134,17,284
4195,117,34,117,32,300
4196,100,34,117,32,283
4197,117,17,132,18,284
4199,101,48,102,34,285
4200,101,31,102,34,268
4203,117,17,116,17,267
4204,117,50,132,17,316
4205,100,50,132,17,299
4206,115,18,132,17,282
4208,102,34,115,17,268
4209,117,32,117,16,282
4210,101,32,117,16,266
4211,116,17,133,17,283
4213,101,34,116,17,268
4214,117,49,116,18,300
4215,117,34,116,18,285
4217,116,33,116,17,282
4218,117,16,116,17,266
4219,116,34,133,18,301
4221,116,17,116,18,267
4222,101,17,116,18,252
4223,101,50,116,18,285
4225,117,32,102,16,267
4226,116,17,102,16,251
4227,116,34,118,16,284
4228,133,18,116,32,299
4229,116,18,116,32,282
4230,118,50,115,16,299
4231,118,34,115,16,283
4232,116,18,115,16,265
4236,118,48,118,16,300
4237,100,48,118,16,282
4239,116,33,117,17,283
4240,115,16,117,17,265
4243,115,34,116,18,283
4244,115,18,116,18,267
4245,117,33,101,33,284
4246,118,16,101,33,268
4247,117,33,116,18,284
4249,116,33,101,34,284
4250,133,35,116,33,317
4251,117,35,116,33,301
4252,116,18,116,33,283
4253,117,33,116,16,282
4254,101,33,116,16,266
4255,118,33,132,17,300
4256,101,33,132,17,283
4257,117,34,115,17,283
4259,118,16,116,17,267
4260,116,49,134,17,316
4262,116,16,134,17,283
4265,116,34,118,32,300
4267,116,33,117,17,283
4268,117,16,117,17,267
4269,116,34,117,33,300
4270,134,32,118,16,300
4271,117,32,118,16,283
4272,101,32,118,16,267
4274,118,49,132,17,316
4276,117,17,132,17,283
4278,117,49,118,18,302
4280,118,16,118,18,270
4281,115,33,103,30,281
4283,116,33,119,32,300
4284,132,35,116,16,299
4286,115,18,116,16,265
4287,117,35,131,19,302
4288,118,18,131,19,286
4289,101,18,131,19,269
4290,103,30,120,31,284
4293,102,48,118,16,284
4295,115,34,117,16,282
4296,131,19,114,17,281
4297,117,19,114,17,267
4298,101,19,114,17,251
4300,117,17,116,18,268
4301,117,33,118,17,285
4303,116,33,102,33,284
4308,116,18,117,16,267
4309,117,17,116,17,267
4311,101,50,132,17,300
4312,102,33,132,17,284
4315,101,34,132,16,283
4316,117,33,115,18,283
4317,116,17,115,18,266
4318,116,49,117,16,298
4320,132,33,117,17,299
4321,116,33,117,17,283
4323,115,33,101,17,266
4324,116,16,101,17,250
4326,116,17,116,16,265
4327,118,32,117,16,283
4328,101,32,117,16,266
4329,116,34,135,31,316
4331,117,34,115,17,283
4332,101,34,115,17,267
4336,100,33,117,17,267
4337,116,36,132,32,316
4338,135,31,117,16,299
4339,118,31,117,16,282
4340,101,31,117,16,265
4342,100,33,118,16,267
4343,116,34,117,16,283
4345,117,34,132,17,300
4347,118,32,117,17,284
4348,101,32,117,17,267
4349,116,34,117,16,283
4350,100,34,117,16,267
4351,117,33,117,17,284
4354,132,34,116,17,299
4357,116,33,133,18,300
4358,100,33,133,18,284
4360,100,34,117,34,285
4361,118,36,115,32,301
4362,101,36,115,32,284
4363,120,30,117,17,284
4364,103,30,117,17,267
4365,116,33,101,17,267
4366,133,18,117,15,283
4367,116,18,117,15,266
4368,117,34,115,16,282
4370,115,49,117,16,297
4371,102,49,117,16,284
4374,101,34,117,32,284
4376,102,32,117,17,268
4379,118,32,117,17,284
4380,117,16,117,17,267
4381,116,18,116,16,266
4382,117,49,117,16,299
4383,102,49,117,16,284
4385,101,17,117,16,251
4386,116,50,116,18,300
4387,100,50,116,18,284
4389,116,33,101,32,282
4390,116,17,101,32,266
4391,117,33,119,31,300
4392,117,16,119,31,283
4394,116,17,116,16,265
4397,118,32,116,19,285
4398,101,32,116,19,268
4400,119,47,101,17,284
4401,102,47,101,17,267
4404,133,34,116,17,300
4405,117,34,116,17,284
4406,101,34,116,17,268
4407,116,32,134,32,314
4408,102,32,134,32,300
4411,118,17,115,16,266
4412,117,33,115,18,283
4413,118,17,115,18,268
4414,116,33,117,33,299
4415,101,33,117,33,284
4417,117,32,117,18,284
4419,115,33,102,17,267
4420,99,33,102,17,251
4421,115,18,134,33,300
4422,116,50,117,32,315
4424,133,34,115,16,298
4425,117,34,115,16,282
4427,119,17,114,17,267
4428,102,17,114,17,250
4429,134,33,132,17,316
4430,117,33,132,17,299
4431,117,18,132,17,284
4432,117,48,101,18,284
4434,115,16,101,18,250
4435,114,33,134,17,298
4437,114,19,115,17,265
4438,118,49,117,16,300
4439,132,17,117,16,282
4442,101,18,115,17,251
4443,102,34,114,17,267
4444,120,48,118,16,302
4445,115,34,118,16,283
4446,116,17,118,16,267
4448,117,16,101,17,251
4449,115,33,136,31,315
4450,100,33,136,31,300
4451,114,35,116,16,281
4452,117,18,116,16,267
4453,118,17,115,17,267
4454,118,33,133,17,301
4455,101,33,133,17,284
4457,101,33,117,15,266
4458,118,49,117,18,302
4460,101,31,117,18,267
4461,115,34,135,31,315
4465,117,32,117,20,286
4467,116,35,102,31,284
4468,117,18,102,31,268
4469,118,34,131,17,300
4470,101,34,131,17,283
4471,118,31,117,17,283
4472,101,31,117,17,266
4473,117,37,115,31,300
4474,100,37,115,31,283
4475,120,31,115,17,283
4477,118,32,134,16,300
4480,117,17,133,17,284
4481,117,18,115,17,267
4482,115,48,133,18,314
4483,102,48,133,18,301
4484,115,17,133,18,283
4485,116,34,117,16,283
4486,134,33,118,32,317
4487,117,33,118,32,300
4488,116,17,118,32,283
4489,115,34,116,17,282
4490,117,17,116,17,267
4491,118,32,101,17,268
4492,133,34,133,17,317
4493,116,34,133,17,300
4495,117,18,132,16,283
4497,117,33,116,16,282
4498,116,17,116,16,265
4499,116,33,133,17,299
4500,101,33,133,17,284
4501,116,33,117,17,283
4502,133,33,101,17,284
4503,115,33,101,17,266
4504,116,16,101,17,250
4505,116,33,121,15,285
4506,116,16,121,15,268
4507,115,34,102,32,283
4508,133,34,117,17,301
4509,116,34,117,17,284
4510,117,17,117,17,268
4512,101,34,132,17,284
4513,101,17,132,17,267
4517,117,34,132,17,300
4518,117,17,132,17,283
4520,132,34,132,19,317
4521,113,34,132,19,298
4522,115,17,132,19,283
4523,118,33,118,16,285
4524,116,17,118,16,267
4525,116,33,116,18,283
4526,132,34,100,17,283
4527,116,34,100,17,267
4528,117,17,100,17,251
4530,132,19,117,31,299
4533,102,49,134,17,302
4536,100,33,118,16,267
4538,101,35,114,18,268
4540,101,31,101,17,250
4542,134,17,116,33,300
4543,117,17,116,33,283
4545,102,49,134,15,300
4546,114,18,134,15,281
4547,117,17,117,15,266
4548,101,17,117,15,250
4549,117,33,132,17,299
4550,133,33,116,17,299
4551,116,33,116,17,282
4552,100,33,116,17,266
4553,118,34,116,17,285
4554,134,33,117,16,300
4555,117,33,117,16,283
4556,115,18,117,16,266
4557,117,32,118,32,299
4559,116,34,116,17,283
4560,116,17,116,17,266
4561,116,34,134,32,316
4562,99,34,134,32,299
4565,117,17,116,17,267
4566,101,17,116,17,251
4567,101,49,116,18,284
4568,116,17,116,18,267
4569,116,35,132,17,300
4571,117,32,117,17,283
4572,117,16,117,17,267
4573,116,35,115,17,283
4574,116,18,115,17,266
4575,101,18,115,17,251
4576,102,32,133,17,284
4577,117,33,117,16,283
4578,132,34,116,16,298
4581,117,33,115,18,283
4582,115,17,115,18,265
4583,118,33,133,17,301
4584,100,33,133,17,283
4585,116,33,117,17,283
4587,116,33,117,17,283
4588,116,16,117,17,266
4589,116,34,133,18,301
4590,99,34,133,18,284
4591,117,19,114,18,268
4593,116,34,117,34,301
4594,117,17,117,34,285
4595,117,33,118,33,301
4596,101,33,118,33,285
4597,118,33,118,33,302
4599,114,18,115,18,265
4601,101,33,115,18,267
4603,101,34,133,17,285
4605,101,33,117,16,267
4606,118,48,118,17,301
4607,100,48,118,17,283
4608,118,15,118,17,268
4609,115,35,118,32,300
4610,118,17,118,32,285
4611,116,34,116,33,299
4612,118,17,116,33,284
4613,117,16,117,16,266
4614,102,16,117,16,251
4615,100,50,116,16,282
4616,118,17,116,16,267
4621,117,33,117,16,283
4623,117,32,101,17,267
4624,116,16,101,17,250
4625,114,34,134,32,314
4628,116,17,115,17,265
4629,117,33,116,16,282
4630,117,16,116,16,265
4631,117,33,133,16,299
4632,101,33,133,16,283
4633,103,16,133,16,268
4634,134,32,117,16,299
4635,117,32,117,16,282
4636,100,32,117,16,265
4638,116,16,135,17,284
4641,117,35,132,17,301
4642,115,19,132,17,283
4644,102,31,118,17,268
4645,116,35,117,16,284
4646,135,17,116,17,285
4647,118,17,116,17,268
4648,101,17,116,17,251
4649,102,49,118,31,300
4650,100,32,118,31,281
4652,118,17,115,17,267
4653,117,33,133,16,299
4654,117,16,133,16,282
4656,116,16,116,17,265
4657,102,16,116,17,251
4658,118,48,117,16,299
4659,101,48,117,16,282
4660,115,17,117,16,265
4662,116,17,134,16,283
4663,116,33,117,17,283
4664,116,17,117,17,267
4666,117,17,117,16,267
4667,101,17,117,16,251
4668,101,32,101,17,251
4669,116,35,133,17,301
4670,134,33,117,16,300
4671,118,33,117,16,284
4673,117,33,117,16,283
4674,117,16,117,16,266
4675,117,34,133,17,301
4676,101,34,133,17,285
4677,117,33,117,26,293
4678,133,33,110,12,288
4679,117,33,110,12,272
4680,117,16,110,12,255
4682,117,16,118,35,286
4683,116,34,119,31,300
4684,133,43,107,17,300
4686,100,43,107,17,267
4687,126,12,112,17,267
4688,110,12,112,17,251
4689,105,29,116,16,266
4690,118,35,114,16,283
4691,102,35,114,16,267
4692,119,48,134,17,318
4694,107,17,134,17,275
4695,112,17,117,17,263
4696,101,17,117,17,252
4697,116,33,133,16,298
4698,116,17,133,16,282
4701,116,35,115,16,282
4702,134,17,114,17,282
4703,117,17,114,17,265
4704,118,48,118,16,300
4705,102,48,118,16,284
4708,116,17,101,17,251
4710,115,16,117,17,265
4711,114,35,116,16,281
4714,118,16,116,18,268
4716,101,34,115,16,266
4718,102,32,134,17,285
4719,117,33,118,33,301
4721,115,35,116,17,283
4723,117,31,102,17,267
4724,115,16,102,17,250
4725,116,35,117,16,284
4726,134,17,116,17,284
4727,117,17,116,17,267
4728,118,50,132,17,317
4729,101,50,132,17,300
4731,118,17,115,17,267
4732,102,17,115,17,251
4733,102,49,116,16,283
4735,116,34,134,32,316
4737,117,32,118,16,283
4741,116,32,102,17,267
4742,116,16,102,17,251
4743,115,19,117,16,267
4745,118,32,117,17,284
4750,102,17,115,17,251
4753,117,33,117,17,284
4754,117,17,117,17,268
4759,114,34,118,16,282
4760,116,15,118,16,265
4761,115,19,115,17,266
4762,117,33,132,18,300
4763,100,33,132,18,283
4766,119,16,101,17,253
4768,101,33,118,16,268
4770,115,17,133,18,283
4771,116,34,117,33,300
4772,115,18,117,33,283
4773,117,17,115,18,267
4774,101,17,115,18,251
4775,101,49,118,32,300
4776,118,16,118,32,284
4777,117,33,117,17,284
4778,133,18,116,17,284
4779,117,18,116,17,268
4780,117,48,117,17,299
4783,100,15,117,17,249
4784,118,49,101,33,301
4785,102,49,101,33,285
4787,116,33,133,16,298
4788,101,33,133,16,283
4789,132,17,116,17,282
4791,115,35,133,17,300
4792,116,18,133,17,284
4793,118,33,117,16,284
4794,101,33,117,16,267
4795,117,32,118,34,301
4796,133,33,119,16,301
4797,117,33,119,16,285
4799,99,17,119,16,251
4804,101,17,133,32,283
4805,102,34,131,19,286
4806,119,33,117,32,301
4808,117,34,115,16,282
4810,118,32,134,17,301
4811,101,32,134,17,284
4814,115,19,114,19,267
4815,117,32,101,17,267
4816,132,34,117,16,299
4818,117,18,117,16,268
4820,118,50,115,18,301
4821,102,50,115,18,285
4823,119,17,116,32,284
4825,102,33,115,17,267
4826,117,48,135,33,333
4827,116,32,135,33,316
4828,99,32,135,33,299
4829,117,35,133,17,302
4831,116,32,118,17,283
4833,115,33,117,17,282
4834,116,16,117,17,266
4835,116,35,134,33,318
4836,100,35,134,33,302
4837,118,33,116,18,285
4838,133,17,117,16,283
4840,118,49,117,16,300
4841,101,49,117,16,283
4842,102,32,117,16,267
4845,118,33,99,16,266
4847,117,16,134,17,284
4849,101,49,135,17,302
4850,117,16,135,17,285
4853,117,35,116,17,285
4855,118,16,117,34,285
4856,118,50,101,33,302
4857,101,50,101,33,285
4859,118,17,117,31,283
4861,102,33,115,16,266
4862,116,51,132,32,331
4864,113,21,132,32,298
4867,117,31,133,19,300
4868,101,31,133,19,284
4870,114,17,119,33,283
4871,101,17,119,33,270
4872,116,48,118,17,299
4873,118,32,118,17,285
4874,115,16,118,17,266
4877,117,19,116,17,269
4881,101,33,100,34,268
4882,101,17,100,34,252
4883,118,33,133,16,300
4884,102,33,133,16,284
4885,116,17,116,16,265
4887,115,18,132,19,284
4888,117,34,117,16,284
4889,100,34,117,16,267
4890,117,49,135,16,317
4892,133,32,119,16,300
4893,116,32,119,16,283
4894,101,32,119,16,268
4895,115,36,133,16,300
4896,117,19,133,16,285
4898,101,16,117,16,250
4899,101,51,114,19,285
4900,135,16,117,17,285
4902,119,50,116,17,302
4903,102,50,116,17,285
4904,133,16,117,17,283
4906,104,16,117,17,254
4907,116,36,114,17,283
4909,117,17,114,18,266
4911,103,32,117,17,269
4912,116,34,100,33,283
4913,100,34,100,33,267
4914,102,17,100,33,252
4915,102,48,118,15,283
4917,114,35,118,30,297
4918,116,17,118,30,281
4919,117,17,115,16,265
4920,117,33,132,16,298
4921,100,33,132,16,281
4922,117,48,134,18,317
4923,102,48,134,18,302
4924,118,15,134,18,285
4925,115,20,114,18,267
4927,101,47,119,31,298
4930,115,16,117,17,265
4931,115,34,135,16,300
4932,100,34,135,16,285
4933,114,18,117,16,265
4934,118,34,132,32,316
4935,102,34,132,32,300
4937,102,48,116,17,283
4939,117,35,115,18,285
4940,100,35,115,18,268
4942,102,16,117,16,251
4943,132,49,102,16,299
4945,101,49,102,16,268
4946,116,17,102,16,251
4949,117,16,115,19,267
4951,132,19,116,33,300
4952,115,19,116,33,283
4954,102,16,116,17,251
4955,101,33,133,16,283
4956,116,34,115,17,282
4957,115,19,115,17,266
4958,118,33,116,16,283
4960,116,50,115,18,299
4962,117,17,115,18,267
4964,118,16,117,17,268
4965,115,34,116,18,283
4966,115,17,116,18,266
4967,116,31,103,17,267
4968,116,15,103,17,251
4969,114,36,117,16,283
4970,115,18,117,16,266
4972,101,33,100,16,250
4973,117,34,134,34,319
4974,116,18,134,34,302
4976,103,17,132,19,271
4977,102,49,102,33,286
4978,117,16,102,33,268
4980,100,33,102,31,266
4981,100,17,102,31,250
4982,134,34,116,32,316
4985,118,33,115,17,283
4987,119,31,101,17,268
4988,102,31,101,17,251
4989,117,35,115,18,285
4992,116,49,116,17,298
4996,101,17,116,16,250
4997,102,50,115,17,284
4998,115,18,115,17,265
4999,116,17,115,16,264
5000,102,17,115,16,250
5001,101,49,135,31,316
5002,116,17,135,31,299
5004,116,17,116,17,266
5006,115,17,117,18,267
5007,115,33,102,33,283
5010,135,31,117,18,301
5011,119,31,117,18,285
5013,117,35,132,17,301
5014,100,35,132,17,284
5018,114,18,116,18,266
5019,118,34,131,17,300
5020,101,34,131,17,283
5021,118,16,132,17,283
5022,116,50,132,17,315
5024,116,17,132,17,282
5025,101,17,132,17,267
5026,116,18,115,17,266
5027,118,31,101,17,267
5029,115,34,116,17,282
5032,132,34,134,17,317
5034,115,17,134,17,283
5035,116,34,117,32,299
5036,101,34,117,32,284
5038,101,32,117,16,266
5039,116,34,116,18,284
5040,100,34,116,18,268
5041,100,17,116,18,251
5042,134,17,116,17,284
5043,117,17,116,17,267
5044,117,48,117,18,300
5045,102,48,117,18,285
5048,116,18,134,32,300
5049,117,33,117,16,283
5050,100,33,117,16,266
5053,117,34,116,16,283
5054,117,18,116,16,267
5055,118,34,133,15,300
5056,134,32,116,17,299
5060,100,33,117,16,266
5061,117,33,117,18,285
5062,116,16,117,18,267
5064,133,32,133,17,315
5065,117,32,133,17,299
5066,116,17,133,17,283
5067,116,33,117,17,283
5068,117,16,117,17,267
5070,117,18,116,15,266
5073,117,33,118,16,284
5076,117,17,117,17,268
5077,117,32,102,17,268
5078,116,15,102,17,250
5079,115,36,115,19,285
5082,102,32,102,31,267
5083,117,34,133,16,300
5084,100,34,133,16,283
5085,117,33,116,17,283
5086,102,33,116,17,268
5087,102,16,116,17,251
5088,115,19,114,17,265
5095,117,33,117,18,285
5096,114,17,117,18,266
5098,100,35,100,31,266
5099,119,32,133,18,302
5102,100,33,118,17,268
5103,117,35,116,16,284
5104,100,35,116,16,267
5105,118,31,118,20,287
5108,99,19,119,29,266
5109,117,18,115,17,267
5110,118,49,134,15,316
5112,116,16,134,15,281
5114,101,37,112,17,267
5115,119,29,119,32,299
5116,104,29,119,32,284
5119,115,19,115,17,266
5120,118,48,117,18,301
5121,117,32,117,18,284
5122,112,17,117,18,264
5123,116,19,116,17,268
5124,119,48,119,31,317
5125,118,32,119,31,300
5126,118,16,119,31,284
5127,115,34,116,17,282
5128,116,17,116,17,266
5129,101,17,116,17,251
5131,116,17,115,18,266
5132,117,34,115,16,282
5137,117,33,116,17,283
5138,116,16,116,17,265
5139,115,18,115,17,265
5140,116,49,117,17,299
5141,115,33,117,17,282
5144,118,48,134,18,318
5145,132,17,134,18,301
5146,116,17,134,18,285
5148,116,17,118,33,284
5149,117,34,117,16,284
5150,100,34,117,16,267
5151,116,31,102,17,266
5152,101,31,102,17,251
5153,116,35,133,17,301
5154,134,18,115,17,284
5157,101,49,117,15,282
5158,117,16,117,15,265
5159,101,16,117,15,249
5160,102,17,115,17,251
5161,101,34,115,16,266
5162,118,49,135,16,318
5163,115,34,135,16,300
5164,117,17,135,16,285
5165,116,32,119,31,298
5167,115,34,116,17,282
5168,116,17,116,17,266
5169,115,33,135,33,316
5172,135,16,116,16,283
5176,116,17,135,15,283
5177,117,35,115,17,284
5178,100,35,115,17,267
5179,117,33,116,17,283
5181,116,32,118,15,281
5182,102,32,118,15,267
5183,101,16,118,15,250
5184,118,49,118,16,301
5185,118,32,118,16,284
5187,99,17,118,16,250
5188,116,17,133,16,282
5190,101,32,117,17,267
5191,115,35,116,17,283
5192,116,17,116,17,266
5193,135,16,116,16,283
5196,133,33,118,17,301
5197,116,33,118,17,284
5198,101,33,118,17,269
5199,116,34,116,18,284
5201,116,32,102,16,266
5202,116,16,102,16,250
5203,116,35,133,16,300
5205,118,17,116,16,267
5206,101,17,116,16,250
5207,101,50,116,16,283
5208,116,18,116,16,266
5209,118,33,134,16,301
5210,102,33,134,16,285
5211,101,17,134,16,268
5212,133,34,116,16,299
5215,118,32,129,12,291
5218,134,16,105,17,272
5219,117,16,105,17,255
5220,117,49,125,13,304
5221,101,49,125,13,288
5222,116,16,125,13,270
5223,116,29,109,20,274
5224,129,27,102,16,274
5225,113,27,102,16,258
5227,105,33,118,16,272
5230,125,33,115,17,290
5232,117,33,116,16,282
5233,102,33,116,16,267
5237,133,32,118,16,299
5239,115,17,118,16,266
5240,116,33,101,16,266
5241,116,16,101,16,249
5242,116,34,115,19,284
5244,117,33,117,16,283
5245,115,17,117,16,265
5246,117,34,116,16,283
5247,100,34,116,16,266
5248,117,34,133,16,300
5249,101,34,133,16,284
5251,101,33,133,17,284
5252,118,32,101,17,268
5253,101,32,101,17,251
5254,115,33,118,16,282
5256,116,35,132,17,300
5257,133,33,116,17,299
5258,119,33,116,17,285
5259,116,17,116,17,266
5260,117,33,117,16,283
5261,101,33,117,16,267
5262,101,16,117,16,250
5263,118,16,132,17,283
5266,116,34,116,16,282
5267,116,17,116,16,265
5268,116,33,134,16,299
5269,117,16,134,16,283
5271,132,36,133,16,317
5272,115,36,133,16,300
5273,116,19,133,16,284
5274,118,31,118,17,284
5275,101,31,118,17,267
5279,118,16,118,18,270
5280,101,16,118,18,253
5281,133,33,133,16,315
5285,132,36,132,17,317
5286,116,36,132,17,301
5287,118,18,132,17,285
5288,119,32,117,16,284
5289,115,18,117,16,266
5291,133,32,119,16,300
5292,117,32,119,16,284
5293,117,16,119,16,268
5295,132,33,116,17,298
5297,117,16,116,17,266
5298,116,32,136,13,297
5299,132,35,114,20,301
5302,118,32,102,15,267
5303,117,15,102,15,249
5304,115,34,116,18,283
5305,116,17,116,18,267
5306,117,35,132,16,300
5307,136,33,115,16,300
5308,117,33,115,16,281
5314,116,33,118,16,283
5315,132,32,102,16,282
5316,119,32,102,16,269
5317,115,16,102,16,249
5318,100,16,102,16,234
5319,116,19,132,17,284
5321,115,17,118,17,267
5322,115,35,116,17,283
5323,118,16,116,17,267
5324,118,31,102,17,268
5325,102,31,102,17,252
5327,132,34,116,16,298
5329,101,34,116,16,267
5331,116,17,117,17,267
5332,117,32,102,14,265
5333,102,32,102,14,250
5334,115,35,116,18,284
5338,116,35,133,16,300
5339,117,17,133,16,283
5340,117,31,118,17,283
5342,115,36,115,18,284
5343,116,18,115,18,267
5345,102,33,116,16,267
5346,117,33,132,19,301
5347,133,33,134,17,317
5349,102,33,134,17,286
5350,117,34,117,16,284
5351,115,18,117,16,266
5353,116,16,101,16,249
5354,116,33,117,16,282
5355,132,35,117,16,300
5356,116,35,117,16,284
5357,118,16,117,16,267
5358,118,33,132,19,302
5359,117,16,132,19,284
5360,101,16,132,19,268
5361,101,33,134,15,283
5362,101,17,134,15,267
5363,101,32,117,16,266
5365,117,16,117,15,265
5367,132,35,132,16,315
5368,116,35,132,16,299
5369,118,16,132,16,282
5370,118,31,117,16,282
5371,102,31,117,16,266
5373,117,15,134,17,283
5374,116,33,118,16,283
5375,100,33,118,16,267
5376,114,34,116,19,283
5378,117,32,103,15,267
5380,114,35,118,16,283
5381,134,33,101,17,285
5383,101,33,101,17,252
5384,116,35,114,18,283
5385,116,19,114,18,267
5387,103,33,115,16,267
5388,101,18,115,16,250
5390,117,32,118,16,283
5391,101,32,118,16,267
5394,117,32,102,17,268
5395,115,16,102,17,250
5397,133,33,118,16,300
5399,101,33,118,16,268
5401,117,17,100,17,251
5403,102,31,136,16,285
5406,117,33,132,19,301
5407,101,33,132,19,285
5408,117,31,120,14,282
5409,100,31,120,14,265
5412,118,32,116,16,282
5413,116,16,116,16,264
5414,115,33,116,19,283
5415,132,33,102,17,284
5416,115,33,102,17,267
5417,120,14,102,17,253
5418,114,33,117,16,280
5421,116,16,135,16,283
5422,115,36,115,17,283
5423,99,36,115,17,267
5424,116,32,100,17,265
5427,117,16,119,16,268
5428,116,35,133,18,302
5429,135,33,118,15,301
5432,115,33,116,19,283
5433,100,33,116,19,268
5434,117,34,118,15,284
5435,101,34,118,15,268
5437,133,33,118,16,300
5438,117,33,118,16,284
5439,118,15,118,16,267
5440,116,35,115,17,283
5441,116,19,115,17,267
5443,118,15,117,16,266
5444,116,34,134,17,301
5446,102,14,134,17,267
5447,101,33,118,16,268
5448,118,33,101,17,269
5449,115,17,101,17,250
5450,115,33,133,19,300
5451,117,16,133,19,285
5452,113,35,117,15,280
5453,134,33,132,17,316
5454,117,33,132,17,299
5455,101,33,132,17,283
5456,102,16,132,17,267
5457,101,32,117,17,267
5458,101,15,117,17,250
5459,133,34,116,17,300
5460,117,34,116,17,284
5461,117,15,116,17,265
5462,115,33,100,17,265
5463,132,34,132,17,315
5464,115,34,132,17,298
5465,117,17,132,17,283
5466,117,33,116,16,282
5468,115,33,117,16,281
5469,116,17,117,16,266
5470,117,34,133,17,301
5471,100,34,133,17,284
5472,117,32,118,17,284
5475,116,16,102,17,251
5476,116,34,135,16,301
5477,117,16,135,16,284
5478,100,16,135,16,267
5479,133,34,117,15,299
5480,117,34,117,15,283
5482,101,17,117,15,250
5483,102,32,100,17,251
5484,116,35,117,16,284
5485,135,33,100,16,284
5487,117,17,100,16,250
5489,117,15,117,17,266
5490,115,33,101,17,266
5491,100,33,101,17,251
5492,116,35,133,17,301
5493,117,16,133,17,283
5494,117,32,118,17,284
5495,100,32,118,17,267
5497,117,17,118,15,267
5498,117,33,100,18,268
5500,115,34,134,16,299
5502,117,34,116,16,283
5503,101,34,116,16,267
5504,101,17,116,16,250
5505,118,15,117,18,268
5506,116,33,102,16,267
5507,100,33,102,16,251
5508,116,35,115,18,284
5511,116,16,101,16,249
5512,115,35,131,17,298
5513,117,18,131,17,283
5514,117,31,117,18,283
5518,117,32,102,15,266
5519,101,32,102,15,250
5520,116,33,133,19,301
5522,115,35,117,15,282
5523,117,18,117,15,267
5524,118,34,133,16,301
5526,118,32,117,17,284
5531,117,15,135,16,283
5533,133,33,132,17,315
5534,118,33,132,17,300
5535,101,33,132,17,283
5536,118,32,117,17,284
5537,102,32,117,17,268
5538,115,35,116,16,282
5539,135,32,133,18,318
5540,118,32,133,18,301
5541,116,16,133,18,283
5543,132,34,134,16,316
5544,116,34,134,16,300
5547,116,16,117,17,266
5548,116,33,116,19,284
5551,118,16,118,15,267
5553,100,34,134,15,283
5555,117,17,116,17,267
5556,118,34,115,19,286
5557,116,19,115,19,269
5558,117,32,102,14,265
5559,101,32,102,14,249
5560,117,35,114,18,284
5561,134,32,100,16,282
5562,118,32,100,16,266
5563,116,17,100,16,249
5564,118,35,116,16,285
5567,102,33,132,16,283
5568,118,32,116,17,283
5570,117,34,116,18,285
5572,118,33,117,16,284
5573,116,16,117,16,265
5575,132,33,115,19,299
5576,118,33,115,19,285
5579,116,18,116,16,266
5580,117,32,116,16,281
5581,101,32,116,16,265
5582,117,33,134,17,301
5583,100,33,134,17,284
5584,117,34,117,16,284
5592,119,33,116,16,284
5594,116,33,134,17,300
5595,117,16,134,17,284
5596,117,34,134,17,302
5598,102,16,134,17,269
5599,133,32,102,16,283
5600,116,32,102,16,266
5601,116,16,102,16,250
5602,115,35,134,17,301
5603,134,34,117,16,301
5604,116,34,117,16,283
5605,117,17,117,16,267
5609,102,34,115,17,268
5610,117,33,135,13,298
5611,134,33,115,18,300
5613,117,16,115,18,266
5614,116,33,133,16,298
5615,117,16,133,16,282
5616,117,33,133,16,299
5617,115,17,133,16,281
5618,116,36,132,14,298
5619,135,31,115,19,300
5620,118,31,115,19,283
5621,115,18,115,19,267
5622,116,33,116,18,283
5623,116,17,116,18,267
5625,116,17,101,15,249
5626,116,35,116,16,283
5627,113,19,116,16,264
5628,119,33,132,17,301
5629,115,19,132,17,283
5630,118,33,116,17,284
5631,116,18,116,17,267
5632,118,32,118,16,284
5633,101,32,118,16,267
5634,117,34,100,18,269
5635,116,16,100,18,250
5637,132,34,115,18,299
5638,117,34,115,18,284
5639,116,17,115,18,266
5640,118,33,116,17,284
5641,118,16,116,17,267
5642,116,34,132,16,298
5643,100,34,132,16,282
5644,117,33,115,17,282
5645,101,33,115,17,266
5646,117,33,116,15,281
5647,100,33,116,15,264
5648,116,33,118,16,283
5650,115,33,101,17,266
5651,132,33,118,16,299
5652,117,33,118,16,284
5653,115,17,118,16,266
5654,117,32,102,17,268
5655,116,15,102,17,250
5656,115,36,133,17,301
5659,101,34,133,17,285
5661,102,32,118,17,269
5663,102,33,102,16,253
5664,115,34,134,16,299
5666,116,34,116,17,283
5667,116,17,116,17,266
5668,117,34,115,16,282
5669,101,34,115,16,266
5671,102,31,135,17,285
5673,134,33,133,17,317
5674,117,33,133,17,300
5675,116,17,133,17,283
5677,115,16,118,16,265
5678,115,35,131,19,300
5679,135,33,117,16,301
5680,119,33,117,16,285
5682,101,16,117,16,250
5684,117,33,101,16,267
5686,101,16,101,16,234
5687,131,35,116,18,300
5689,117,16,116,18,267
5690,116,34,117,17,284
5691,100,34,117,17,268
5692,117,33,116,17,283
5693,101,33,116,17,267
5695,118,16,101,17,252
5697,116,18,116,16,266
5698,116,34,133,16,299
5700,118,32,117,17,284
5701,116,17,117,17,267
5702,117,34,116,16,283
5703,101,34,116,16,267
5706,115,35,115,16,281
5707,133,33,134,19,319
5708,118,33,134,19,304
5710,117,32,121,13,283
5711,116,16,121,13,266
5712,116,35,132,17,300
5715,115,16,118,16,265
5716,115,36,115,16,282
5717,134,32,134,17,317
5718,118,32,134,17,301
5721,132,33,135,16,316
5723,118,16,135,16,285
5724,117,33,118,17,285
5726,112,35,133,16,296
5727,134,34,115,18,301
5728,116,34,115,18,283
5730,101,17,115,18,251
5731,102,33,116,16,267
5733,102,33,115,19,269
5734,101,17,115,19,252
5736,116,34,139,16,305
5737,115,18,139,16,288
5739,116,16,123,16,271
5741,115,19,104,17,255
5742,117,32,122,16,287
5743,101,32,122,16,271
5744,117,28,110,16,271
5745,127,44,118,16,305
5747,123,16,118,16,273
5748,107,16,118,16,257
5749,104,33,101,17,255
5750,105,16,101,17,239
5751,105,33,118,16,272
5752,110,35,116,16,277
5753,114,19,116,16,265
5754,117,33,132,19,301
5755,118,16,132,19,285
5758,101,17,117,14,249
5759,102,32,116,16,266
5760,118,33,134,18,303
5761,116,16,134,18,284
5762,115,33,119,14,281
5763,132,33,133,17,315
5765,117,14,133,17,281
5766,115,33,117,17,282
5767,116,16,117,17,266
5769,134,32,117,18,301
5770,117,32,117,18,284
5771,101,32,117,18,268
5772,100,14,117,18,249
5773,118,15,102,15,250
5774,116,34,117,17,284
5775,117,17,117,17,268
5776,117,35,134,16,302
5777,134,33,117,17,301
5778,116,33,117,17,283
5779,102,33,117,17,269
5781,102,33,101,16,252
5782,118,33,134,15,300
5783,101,33,134,15,283
5784,117,35,131,18,301
5785,134,33,116,16,299
5786,119,33,116,16,284
5788,102,17,116,16,251
5789,101,31,101,17,250
5790,101,15,101,17,234
5791,134,32,117,16,299
5793,114,17,117,16,264
5794,115,34,116,18,283
5795,116,16,116,18,266
5796,116,33,118,16,283
5797,101,33,118,16,268
5798,115,34,132,19,300
5799,133,32,119,16,300
5803,116,18,133,16,283
5804,117,33,116,17,283
5805,118,16,116,17,267
5806,117,32,101,17,267
5807,132,35,115,17,299
5809,119,16,115,17,267
5813,116,17,116,16,265
5814,116,33,116,17,282
5815,101,33,116,17,267
5816,131,17,116,17,281
5817,115,17,116,17,265
5819,116,16,134,18,284
5820,116,33,119,15,283
5821,116,16,119,15,266
5825,116,17,101,15,249
5826,116,34,133,16,299
5827,100,34,133,16,283
5828,117,33,116,17,283
5832,118,33,134,16,301
5833,101,33,134,16,284
5834,117,33,117,17,284
5835,100,33,117,17,267
5836,115,33,117,19,284
5838,116,34,102,16,268
5840,118,34,133,17,302
5841,116,18,133,17,284
5842,117,33,117,16,283
5844,101,17,117,16,251
5847,102,31,101,17,251
5848,102,15,101,17,235
5849,133,33,134,16,316
5850,117,33,134,16,300
5852,101,16,134,16,267
5853,115,17,116,17,265
5854,116,33,132,17,298
5855,101,33,132,17,283
5856,116,32,117,18,283
5857,116,16,117,18,267
5859,118,16,117,16,267
5860,117,33,100,16,266
5862,116,32,117,21,286
5863,132,35,103,9,279
5864,116,35,103,9,263
5865,117,18,103,9,247
5866,116,33,134,16,299
5867,117,16,134,16,283
5868,117,32,118,15,282
5869,100,32,118,15,265
5870,116,38,113,17,284
5871,117,21,113,17,268
5872,121,29,133,18,301
5873,103,29,133,18,283
5874,115,35,116,17,283
5875,134,31,102,15,282
5876,118,31,102,15,266
5877,102,31,102,15,250
5880,104,17,117,16,254
5881,133,35,115,18,301
5882,116,35,115,18,284
5884,100,17,115,18,250
5885,102,34,116,16,268
5887,101,32,133,16,282
5888,117,33,116,17,283
5890,116,34,116,18,284
5892,100,18,116,18,252
5895,100,33,119,17,269
5896,117,33,103,14,267
5897,100,33,103,14,250
5898,117,35,116,17,285
5899,116,18,116,17,267
5900,117,32,137,13,299
5901,101,32,137,13,283
5902,117,36,114,17,284
5903,119,17,114,17,267
5904,103,17,114,17,251
5906,118,33,133,16,300
5908,117,36,113,17,283
5909,101,36,113,17,267
5910,118,30,134,16,298
5911,114,17,134,16,281
5915,133,33,118,16,300
5916,117,33,118,16,284
5917,113,17,118,16,264
5918,117,34,117,16,284
5919,134,32,134,16,316
5920,117,32,134,16,299
5921,116,16,134,16,282
5922,115,33,117,16,281
5923,132,35,134,16,317
5924,116,35,134,16,301
5925,118,16,134,16,284
5927,117,16,117,15,265
5928,117,33,117,16,283
5930,117,32,134,17,300
5931,101,32,134,17,284
5932,114,36,115,17,282
5934,117,31,101,17,266
5935,117,15,101,17,250
5937,117,16,133,17,283
5939,101,33,117,17,268
5941,115,17,118,15,265
5942,116,34,133,16,299
5943,101,34,133,16,284
5944,117,32,117,17,283
5945,101,32,117,17,267
5946,116,34,118,14,282
5947,117,17,118,14,266
5948,117,33,133,18,301
5949,118,15,133,18,284
5950,116,34,134,16,300
5951,133,33,117,16,299
5953,101,33,117,16,267
5954,117,32,134,17,300
5955,118,14,134,17,283
5956,114,34,117,17,282
5958,115,35,133,16,299
5960,118,32,117,18,285
5962,115,33,102,16,266
5963,101,33,102,16,252
5965,117,17,133,16,283
5966,116,34,115,17,282
5967,133,34,115,17,299
5970,101,18,115,17,251
5971,102,31,101,17,251
5972,101,15,101,17,234
5973,133,33,117,17,300
5974,116,33,117,17,283
5975,115,17,117,17,266
5977,115,17,133,16,281
5978,116,34,115,19,284
5979,101,34,115,19,269
5980,117,32,102,16,267
5981,133,34,133,17,317
5982,117,34,133,17,301
5983,117,17,133,17,284
5984,117,33,117,17,284
5988,117,31,118,17,283
5990,101,15,118,17,251
5991,133,34,150,17,334
5992,117,34,150,17,318
5995,149,17,134,16,316
5998,117,33,134,15,299
