序号,发送->接收,接收->转发,转发->接收,接收->处理,总计
1,130,32,118,19,299
2,107,15,118,19,259
3,101,15,118,19,253
5,100,17,102,15,234
6,102,33,115,18,268
7,101,16,115,18,250
9,116,36,131,15,298
11,119,30,116,17,282
12,102,30,116,17,265
13,115,34,134,16,299
14,115,18,134,16,283
15,117,33,117,16,283
16,116,17,117,16,266
17,116,34,133,16,299
18,131,32,117,16,296
19,116,32,117,16,281
22,116,18,133,16,283
23,118,32,134,16,300
24,117,16,134,16,283
25,116,34,116,16,282
26,133,32,117,18,300
27,118,32,117,18,285
30,133,33,116,18,300
33,116,32,102,16,266
34,116,16,102,16,250
35,116,35,115,17,283
37,118,32,118,15,283
39,116,35,134,14,299
40,116,18,134,14,282
43,101,17,115,17,250
44,115,17,133,18,283
45,117,33,118,16,284
46,100,33,118,16,267
47,101,15,118,16,250
49,118,31,117,17,283
51,117,33,118,17,285
52,133,34,101,17,285
53,133,16,101,17,267
54,118,16,101,17,252
56,117,17,135,12,281
58,103,31,116,18,268
60,118,17,115,18,268
61,117,32,116,19,284
62,101,32,116,19,268
63,131,21,128,19,299
64,135,30,117,16,298
65,121,30,117,16,284
67,117,33,118,15,283
68,115,18,118,15,266
69,116,34,117,15,282
70,116,19,117,15,267
71,118,31,118,17,284
72,128,35,117,15,295
73,116,35,117,15,283
75,102,16,117,15,250
76,118,15,134,16,283
77,118,33,117,16,284
79,116,34,115,17,282
81,116,32,117,16,281
82,117,15,117,16,265
83,114,35,133,16,298
84,134,32,117,16,299
88,115,17,118,17,267
89,115,33,102,15,265
90,117,16,102,15,250
92,133,32,118,17,300
93,117,32,118,17,284
94,101,32,118,17,268
96,118,17,133,16,284
97,118,33,116,16,283
98,102,33,116,16,267
100,116,17,117,15,265
101,117,34,115,17,283
102,101,34,115,17,267
103,117,33,134,18,302
104,133,32,120,13,298
105,118,32,120,13,283
106,116,16,120,13,265
108,117,15,135,16,283
109,115,34,117,18,284
111,116,35,132,16,299
112,134,31,117,18,300
113,118,31,117,18,284
114,102,31,117,18,268
115,102,13,117,18,250
116,118,17,134,16,285
117,118,34,116,17,285
118,101,34,116,17,268
120,132,34,116,17,299
122,117,18,116,17,268
124,134,33,132,18,317
125,118,33,132,18,301
126,116,17,132,18,283
128,135,32,101,16,284
129,119,32,101,16,268
130,116,17,101,16,250
131,116,33,116,18,283
132,115,17,116,18,266
134,117,15,118,16,266
135,117,35,133,17,302
136,116,17,133,17,283
138,101,33,133,15,282
140,116,18,134,16,284
142,118,16,117,20,271
143,116,34,115,17,282
144,133,33,116,18,300
146,117,16,116,18,267
148,134,36,130,15,315
149,117,36,130,15,298
151,101,20,130,15,266
152,103,29,116,19,267
153,115,35,115,16,281
154,116,18,115,16,265
157,116,34,134,15,299
158,112,18,134,15,279
159,118,34,115,16,283
160,116,19,115,16,266
161,118,31,135,17,301
162,100,31,135,17,283
163,115,35,132,17,299
164,117,17,132,17,283
165,118,34,115,17,284
166,116,18,115,17,266
168,115,16,119,15,265
169,116,35,117,16,284
170,135,32,101,17,285
171,134,15,101,17,267
172,117,15,101,17,250
173,116,34,117,16,283
174,115,17,117,16,265
175,117,33,118,15,283
177,117,34,118,16,285
178,117,16,118,16,267
180,101,35,133,17,286
181,101,18,133,17,269
182,117,16,119,15,267
183,115,33,116,19,283
184,118,15,116,19,268
185,115,35,115,18,283
188,133,32,117,17,299
189,118,32,117,17,284
192,101,34,133,16,284
193,116,33,135,14,298
195,117,33,116,17,283
196,116,16,116,17,265
197,115,34,115,17,281
198,117,17,115,17,266
199,119,33,116,16,284
200,133,35,115,16,299
203,118,31,134,17,300
204,102,31,134,17,284
205,116,33,118,15,282
206,115,17,118,15,265
207,117,33,118,16,284
208,116,16,118,16,266
209,116,34,116,18,284
210,115,16,116,18,265
212,134,32,102,15,283
213,118,32,102,15,267
215,116,34,118,14,282
216,118,16,118,14,266
217,116,34,117,18,285
218,116,18,117,18,269
220,117,17,116,15,265
221,117,34,131,17,299
225,116,37,131,17,301
226,117,18,131,17,283
228,116,15,134,16,281
229,116,34,116,20,286
230,131,35,116,17,299
231,132,18,116,17,283
232,118,18,116,17,269
233,117,32,116,18,283
234,131,33,117,17,298
236,118,16,117,17,268
237,117,36,131,17,301
238,116,20,131,17,284
239,119,32,116,16,283
240,101,32,116,16,265
242,116,18,116,16,266
243,117,33,116,17,283
245,118,33,133,16,300
246,131,33,116,19,299
248,116,16,116,19,267
249,117,33,118,17,285
250,116,16,118,17,267
252,116,17,116,17,266
253,116,33,119,15,283
258,102,33,132,18,285
259,118,32,133,16,299
260,101,32,133,16,282
261,115,34,115,17,281
262,119,15,115,17,266
265,115,34,117,16,282
266,115,17,117,16,265
267,117,33,133,18,301
268,118,15,133,18,284
269,130,17,136,17,300
270,115,17,136,17,285
271,116,35,132,19,302
272,118,17,132,19,286
274,117,16,119,17,269
275,115,33,120,13,281
276,133,36,116,17,302
277,117,36,116,17,286
279,118,31,102,16,267
281,116,36,131,18,301
283,118,30,119,15,282
284,103,30,119,15,267
287,116,31,118,16,281
288,102,31,118,16,267
289,114,34,137,14,299
290,131,33,118,18,300
292,119,15,118,18,270
293,100,15,118,18,251
294,117,14,119,16,266
297,116,37,130,17,300
298,137,32,131,17,317
299,119,32,131,17,299
300,118,18,131,17,284
301,117,32,133,16,298
302,103,32,133,16,284
304,101,33,116,18,268
307,133,16,116,18,283
309,115,34,132,18,299
311,118,34,133,17,302
312,116,18,133,17,284
313,118,32,133,17,300
314,117,16,133,17,283
315,116,34,116,17,283
316,116,18,116,17,267
317,117,32,119,16,284
318,132,35,115,17,299
319,116,35,115,17,283
321,117,32,117,17,283
322,118,15,117,17,267
324,116,17,134,16,283
325,117,34,132,17,300
327,117,32,117,17,283
329,115,34,117,16,282
330,100,34,117,16,267
332,134,32,116,18,300
334,116,16,116,18,266
335,117,34,100,16,267
336,117,17,100,16,250
337,100,17,100,16,233
338,117,16,118,16,267
339,116,35,114,18,283
341,118,32,134,16,300
342,116,18,134,16,284
343,117,33,117,16,283
345,134,16,134,17,301
346,118,16,134,17,285
347,117,33,133,17,300
348,114,18,133,17,282
350,134,32,119,33,318
351,118,32,119,33,302
353,115,35,134,16,300
354,134,32,118,15,299
355,119,32,118,15,284
356,118,15,118,15,266
357,117,33,135,17,302
360,119,33,133,16,301
361,102,33,133,16,284
362,117,17,116,16,266
365,101,15,119,15,250
367,116,34,132,17,299
369,117,32,117,17,283
370,116,16,117,17,266
371,116,33,116,19,284
373,117,35,116,17,285
375,117,32,116,17,282
377,116,34,133,17,300
378,117,17,133,17,284
379,116,34,131,18,299
380,101,34,131,18,284
381,119,33,116,15,283
384,116,17,117,16,266
386,133,32,118,17,300
389,115,33,102,16,266
390,116,15,102,16,249
391,101,15,102,16,234
392,117,16,119,15,267
393,115,34,117,16,282
394,133,34,133,16,316
395,116,34,133,16,299
396,118,17,133,16,284
397,117,33,134,17,301
399,117,33,118,16,284
400,119,15,118,16,268
401,117,33,119,14,283
402,100,33,119,14,266
403,116,34,116,18,284
404,133,34,133,16,316
406,116,18,133,16,283
407,116,33,135,14,298
408,118,16,135,14,283
409,101,16,135,14,266
410,119,14,117,16,266
413,118,33,116,17,284
414,133,35,131,17,316
415,132,19,131,17,299
416,116,19,131,17,283
417,117,30,118,18,283
419,116,34,116,20,286
420,132,34,117,16,299
421,133,17,117,16,283
424,131,35,131,17,314
425,117,35,131,17,300
426,101,35,131,17,284
427,118,34,131,16,299
428,102,34,131,16,283
429,119,31,135,15,300
430,102,31,135,15,283
431,117,33,117,17,284
432,117,16,117,17,267
434,131,34,118,16,299
435,117,34,118,16,285
436,114,17,118,16,265
437,116,35,133,15,299
438,116,19,133,15,283
439,118,32,132,19,301
440,117,17,132,19,285
442,116,16,120,16,268
443,115,36,117,16,284
444,118,16,117,16,267
445,118,34,114,17,283
447,118,31,134,18,301
448,116,16,134,18,284
449,117,35,132,19,303
450,120,16,132,19,287
451,116,33,118,16,283
452,117,16,118,16,267
453,116,32,102,17,267
454,114,17,102,17,250
458,117,15,118,16,266
459,115,35,132,18,300
460,118,16,132,18,284
461,103,16,132,18,269
463,102,15,118,16,251
464,118,15,118,18,269
465,115,34,119,15,283
466,118,16,119,15,268
467,115,33,116,17,281
468,132,34,134,14,314
469,115,34,134,14,297
472,118,18,132,17,285
473,118,32,117,15,282
474,102,32,117,15,266
475,118,32,120,13,283
476,101,32,120,13,266
478,134,33,133,16,316
481,115,32,117,19,283
483,117,33,118,15,283
485,115,33,117,17,282
486,115,16,117,17,265
487,117,35,117,16,285
488,133,35,132,17,317
489,132,19,132,17,300
490,117,19,132,17,285
491,116,30,119,15,280
492,103,30,119,15,267
493,116,34,134,16,300
494,117,17,134,16,284
495,115,34,132,19,300
496,117,16,132,19,284
498,132,32,118,15,297
499,117,32,118,15,282
500,119,15,118,15,267
501,102,15,118,15,250
502,117,17,117,15,266
503,132,16,118,18,284
504,116,16,118,18,268
505,116,34,102,15,267
507,115,33,117,18,283
508,100,33,117,18,268
509,101,15,117,18,251
511,116,36,115,17,284
514,102,32,116,18,268
515,116,34,133,17,300
517,117,32,118,16,283
518,102,32,118,16,268
524,133,33,116,17,299
525,116,33,116,17,282
526,118,16,116,17,267
527,101,16,116,17,250
529,118,33,134,15,300
530,115,18,134,15,282
531,117,32,117,18,284
533,115,34,117,18,284
534,116,17,117,18,268
535,114,34,115,18,281
536,133,34,132,18,317
537,118,34,132,18,302
538,118,16,132,18,284
540,117,18,131,19,285
541,118,34,133,17,302
542,117,18,133,17,285
544,115,18,118,15,266
545,115,33,118,16,282
546,132,32,118,17,299
547,117,32,118,17,284
549,115,36,132,18,301
551,119,32,133,16,300
552,101,32,133,16,282
554,118,16,132,17,283
556,102,33,116,19,270
557,116,33,118,15,282
559,115,33,136,15,299
560,118,15,136,15,284
561,115,33,118,17,283
562,115,17,118,17,267
563,116,36,132,15,299
566,118,15,116,19,268
567,115,36,114,19,284
568,136,32,115,17,300
570,118,17,115,17,267
571,101,17,115,17,250
572,132,34,115,17,298
573,116,34,115,17,282
575,117,34,130,19,300
576,114,19,130,19,282
577,118,31,118,32,299
578,101,31,118,32,282
579,117,35,115,18,285
580,134,32,117,18,301
581,119,32,117,18,286
583,117,32,118,16,283
584,130,51,135,16,332
586,99,51,135,16,301
588,115,18,117,16,266
589,118,34,116,16,284
592,103,31,117,17,268
593,115,34,118,14,281
594,102,34,118,14,268
595,117,34,134,16,301
597,101,16,134,16,267
598,116,16,117,17,266
599,117,33,116,19,285
600,101,33,116,19,269
601,116,32,118,17,283
602,100,32,118,17,267
603,114,36,116,17,283
604,134,33,132,17,316
606,117,17,132,17,283
607,101,17,132,17,267
608,101,34,115,16,266
609,117,32,116,17,282
613,117,32,134,16,299
615,117,33,117,17,284
616,115,16,117,17,265
617,116,34,134,16,300
618,116,17,134,16,283
621,102,15,117,17,251
624,101,33,135,16,285
625,117,34,117,16,284
626,134,33,115,20,302
627,116,33,115,20,284
628,101,33,115,20,269
629,117,33,102,15,267
630,118,15,102,15,250
631,102,15,102,15,234
633,117,32,116,17,282
634,101,32,116,17,266
637,117,31,116,19,283
638,102,31,116,19,268
640,115,17,101,16,249
641,116,33,117,17,283
643,118,33,101,17,269
644,131,35,115,17,298
645,116,35,115,17,283
648,101,32,116,20,269
650,117,17,102,14,250
651,118,37,113,19,287
654,103,29,103,14,249
655,116,36,132,16,300
656,100,36,132,16,284
657,119,33,115,17,284
659,118,34,130,18,300
660,113,19,130,18,280
661,120,31,117,15,283
662,103,31,117,15,266
663,101,17,117,15,250
664,132,33,131,19,315
666,115,17,131,19,282
667,117,32,134,16,299
668,130,33,117,17,297
669,116,33,117,17,283
670,117,15,117,17,266
671,100,15,117,17,249
672,116,17,134,14,281
673,117,31,117,17,282
674,100,31,117,17,265
675,115,35,117,17,284
676,118,16,117,17,268
677,116,33,101,17,267
678,101,33,101,17,252
679,116,35,132,17,300
680,134,31,135,17,317
681,117,31,135,17,300
684,99,35,117,15,266
685,118,32,118,15,283
686,101,32,118,15,266
687,117,34,134,15,300
688,132,34,133,16,315
694,118,15,118,15,266
695,116,35,117,14,282
696,134,33,134,17,318
697,117,33,134,17,301
698,115,18,134,17,284
700,117,16,102,17,252
701,115,33,117,17,282
703,101,15,117,17,250
704,117,14,118,18,267
705,116,36,116,15,283
706,117,17,116,15,265
707,118,33,117,15,283
711,115,35,117,18,285
712,101,35,117,18,271
713,117,31,104,14,266
714,116,15,104,14,249
715,114,34,117,17,282
716,117,15,117,17,266
717,102,15,117,17,251
718,100,34,117,17,268
720,117,18,114,17,266
721,101,18,114,17,250
722,104,31,134,17,286
723,132,17,118,14,281
725,118,34,132,17,301
726,117,17,132,17,283
728,114,17,116,16,263
729,117,34,132,16,299
730,134,31,117,19,301
731,118,31,117,19,285
732,101,31,117,19,268
733,101,14,117,19,251
736,116,16,101,17,250
737,117,34,118,16,285
738,132,35,115,16,298
740,101,35,115,16,267
743,117,33,118,16,284
744,101,33,118,16,268
745,116,34,133,15,298
747,118,32,116,21,287
748,115,16,116,21,268
749,115,35,116,18,284
750,134,33,117,18,302
751,117,33,117,18,285
752,118,16,117,18,269
753,116,33,102,15,266
754,133,36,132,14,315
755,117,36,132,14,299
756,101,36,132,14,283
758,102,32,132,17,283
759,117,34,115,15,281
760,101,34,115,15,265
762,102,32,115,18,267
763,102,17,115,18,252
764,132,32,134,16,314
765,118,32,134,16,300
767,116,32,118,17,283
771,118,32,101,17,268
772,114,17,101,17,249
773,117,35,116,17,285
774,134,33,131,18,316
775,117,33,131,18,299
776,102,33,131,18,284
777,118,33,116,19,286
778,100,33,116,19,268
779,118,34,117,17,286
780,101,34,117,17,269
781,101,17,117,17,252
782,100,33,115,19,267
783,100,17,115,19,251
785,115,37,133,15,300
786,116,19,133,15,283
787,118,33,115,17,283
788,117,17,115,17,266
790,101,33,132,17,283
791,117,33,116,17,283
792,103,33,116,17,269
793,102,16,116,17,251
794,133,32,134,15,314
795,117,32,134,15,298
797,118,33,116,17,284
798,132,34,134,16,316
799,115,34,134,16,299
801,117,32,118,15,282
802,116,15,118,15,264
804,134,32,116,18,300
805,118,32,116,18,284
806,101,32,116,18,267
809,117,31,102,15,265
810,102,31,102,15,250
811,113,35,135,14,297
812,116,17,135,14,282
813,101,17,135,14,267
815,116,34,115,18,283
816,117,16,115,18,266
817,117,31,102,16,266
818,102,31,102,16,251
819,115,37,132,15,299
820,135,31,116,17,299
822,102,31,116,17,266
823,115,34,115,18,282
824,115,18,115,18,266
825,118,33,100,16,267
826,102,33,100,16,251
828,132,32,117,16,297
829,118,32,117,16,283
831,117,34,133,17,301
832,115,18,133,17,283
833,117,34,116,18,285
834,100,34,116,18,268
835,116,33,101,16,266
836,133,32,118,17,300
837,118,32,118,17,285
838,101,32,118,17,268
839,117,34,101,17,269
842,116,18,131,18,283
844,101,31,118,17,267
847,118,31,101,17,267
848,101,31,101,17,250
849,101,14,101,17,233
850,131,35,132,15,313
851,115,35,132,15,297
852,118,17,132,15,282
853,117,32,136,14,299
855,115,34,135,17,301
856,101,34,135,17,287
857,115,33,119,15,282
858,118,16,119,15,268
859,116,33,117,17,283
860,132,36,132,17,317
862,115,21,132,17,285
863,119,33,131,19,302
864,116,19,131,19,285
866,119,15,133,16,283
867,101,15,133,16,265
868,101,33,116,18,268
869,119,34,115,17,285
871,118,32,116,20,286
872,116,15,116,20,267
875,117,34,116,17,284
876,116,18,116,17,267
877,117,32,135,17,301
879,115,36,116,15,282
881,117,32,117,16,282
882,102,32,117,16,267
883,101,17,117,16,251
886,101,34,133,15,283
889,101,15,116,34,266
890,117,16,116,19,268
893,115,35,133,17,300
894,116,17,133,17,283
895,116,49,117,16,298
897,132,19,114,17,282
901,116,34,118,16,284
902,117,16,118,16,267
903,118,33,101,15,267
904,103,33,101,15,252
906,114,17,136,14,281
907,116,35,115,17,283
908,135,33,117,16,301
911,117,31,102,16,266
912,101,31,102,16,250
913,116,37,115,15,283
914,136,31,118,16,301
915,120,31,118,16,285
917,115,34,118,13,280
918,117,16,118,13,264
919,102,16,118,13,249
920,102,33,132,17,284
922,115,15,132,20,282
924,118,16,117,15,266
925,116,31,101,17,265
926,118,13,101,17,249
928,132,32,102,18,284
929,115,32,102,18,267
930,117,15,102,18,252
931,113,35,135,16,299
935,118,32,119,17,286
936,120,14,119,17,270
937,117,33,103,13,266
938,102,33,103,13,251
939,115,35,117,18,285
942,116,16,103,15,250
943,114,36,130,19,299
946,103,30,119,17,269
948,117,18,114,16,265
949,119,33,131,17,300
950,103,33,131,17,284
951,117,30,118,17,282
953,117,36,133,16,302
954,119,17,133,16,285
956,114,16,118,17,265
957,115,34,101,17,267
958,131,34,131,17,313
960,101,34,131,17,283
962,133,33,133,18,317
963,118,33,133,18,302
964,102,33,133,18,286
965,118,33,118,14,283
967,101,16,118,14,249
969,116,36,115,19,286
970,114,19,115,19,267
975,115,36,114,19,284
976,101,36,114,19,270
977,101,19,114,19,253
978,101,33,116,16,266
979,118,32,100,18,268
982,136,33,132,17,318
983,119,33,132,17,301
986,116,16,133,18,283
987,116,34,117,18,285
988,100,34,117,18,269
989,116,32,103,13,264
991,117,34,118,15,284
993,116,33,117,15,281
995,115,36,131,16,298
997,102,18,131,16,267
999,117,34,116,18,285
1000,118,15,116,18,267
1001,116,32,102,17,267
1002,100,32,102,17,251
1003,114,35,119,13,281
1004,115,16,119,13,263
1005,118,34,133,17,302
1006,101,34,133,17,285
1007,116,33,133,16,298
1008,116,18,133,16,283
1009,117,33,116,17,283
1011,116,32,117,18,283
1012,119,13,117,18,267
1013,116,35,117,17,285
1014,133,33,133,16,315
1017,116,33,133,17,299
1018,100,33,133,17,283
1019,114,34,116,16,280
1020,101,34,116,16,267
1021,118,34,115,16,283
1025,117,33,102,14,266
1026,116,17,102,14,249
1030,115,16,119,16,266
1031,117,36,132,17,302
1033,119,31,118,16,284
1034,102,31,118,16,267
1035,116,36,116,16,284
1036,136,32,117,15,300
1038,103,32,117,15,267
1039,117,33,117,17,284
1040,132,33,101,16,282
1042,101,33,101,16,251
1044,116,16,115,18,265
1046,117,15,118,18,268
1047,115,35,132,17,299
1048,117,17,132,17,283
1051,116,33,133,17,299
1052,115,18,133,17,283
1054,101,35,131,18,285
1055,118,31,118,15,282
1056,132,33,100,17,282
1057,116,33,100,17,266
1058,116,16,100,17,249
1059,117,34,117,17,285
1060,133,33,118,32,316
1061,133,16,118,32,299
1062,115,16,118,32,281
1063,117,33,117,18,285
1065,116,34,117,16,283
1066,100,34,117,16,267
1067,134,17,116,16,283
1069,117,49,116,19,301
1070,101,49,116,19,285
1071,113,19,116,19,267
1072,117,18,117,15,267
1073,118,32,134,17,301
1074,101,32,134,17,284
1075,116,33,118,15,282
1076,116,16,118,15,265
1077,115,33,118,17,283
1081,116,34,133,17,300
1082,134,32,118,15,299
1083,117,32,118,15,282
1084,101,32,118,15,266
1086,118,17,131,18,284
1087,116,32,117,18,283
1088,101,32,117,18,268
1089,116,34,101,16,267
1090,133,32,118,19,302
1095,116,36,116,16,284
1096,117,18,116,16,267
1097,118,32,118,15,283
1098,101,32,118,15,266
1100,118,19,113,17,267
1101,118,31,134,15,298
1102,104,31,134,15,284
1103,117,33,116,17,283
1105,116,33,117,18,284
1106,118,15,117,18,268
1109,117,35,116,18,286
1111,117,32,119,14,282
1112,116,17,119,14,266
1113,115,35,134,16,300
1114,100,35,134,16,285
1117,116,35,133,17,301
1118,116,18,133,17,284
1119,119,31,119,16,285
1120,102,31,119,16,268
1121,116,36,114,17,283
1122,134,32,118,16,300
1124,102,32,118,16,268
1125,101,16,118,16,251
1126,133,33,117,16,299
1129,102,16,117,16,251
1131,115,35,100,16,266
1132,99,35,100,16,250
1133,103,16,100,16,235
1134,134,32,117,17,300
1135,117,32,117,17,283
1136,101,32,117,17,267
1137,102,16,117,17,252
1138,117,18,131,18,284
1140,100,33,133,16,282
1141,118,33,116,19,286
1143,116,34,101,15,266
1144,100,34,101,15,250
1147,115,35,134,15,299
1148,116,17,134,15,282
1150,116,19,114,17,266
1151,118,32,133,15,298
1155,116,35,117,16,284
1156,134,32,132,19,317
1159,116,34,117,16,283
1160,99,34,117,16,266
1161,118,33,133,16,300
1162,116,18,133,16,283
1163,117,34,115,19,285
1166,119,13,119,16,267
1167,115,35,132,20,302
1168,117,16,132,20,285
1169,118,33,119,14,284
1170,100,33,119,14,266
1172,115,19,135,14,283
1173,116,32,117,16,281
1175,116,32,101,18,267
1176,132,34,134,16,316
1177,115,34,134,16,299
1178,119,14,134,16,283
1180,135,30,134,16,315
1182,103,30,134,16,283
1183,116,33,101,16,266
1186,134,33,101,18,286
1188,113,17,101,18,249
1189,116,34,133,16,299
1192,101,34,115,17,267
1193,118,33,132,17,300
1194,116,18,132,17,283
1196,101,32,117,17,267
1197,116,34,117,17,284
1198,133,33,136,15,317
1199,117,33,136,15,301
1200,115,17,136,15,283
1202,132,34,100,17,283
1204,117,17,100,17,251
1206,117,17,134,16,284
1207,118,35,115,15,283
1210,118,16,117,16,267
1212,100,34,117,16,267
1213,117,34,132,17,300
1214,134,31,118,18,301
1216,115,15,118,18,266
1218,117,16,102,15,250
1219,116,34,116,16,282
1220,99,34,116,16,265
1221,102,16,116,16,250
1222,132,35,131,18,316
1224,101,35,131,18,285
1225,118,33,116,15,282
1226,102,33,116,15,266
1227,117,31,118,17,283
1228,116,16,118,17,267
1229,117,34,101,16,268
1230,133,33,119,14,299
1233,116,33,118,16,283
1234,116,15,118,16,265
1236,100,35,132,18,285
1237,116,32,118,16,282
1238,101,32,118,16,267
1239,101,16,118,16,251
1241,115,34,117,17,283
1243,116,33,117,17,283
1245,116,34,133,17,300
1246,134,34,134,16,318
1247,115,34,134,16,299
1249,117,33,117,16,283
1250,101,33,117,16,267
1251,118,33,117,16,284
1254,133,35,131,19,318
1255,116,35,131,19,301
1256,116,18,131,19,284
1258,101,32,134,16,283
1260,117,16,101,16,250
1261,117,33,118,15,283
1263,116,33,118,16,283
1264,114,17,118,16,265
1266,118,16,133,17,284
1267,117,32,118,15,282
1269,115,33,117,18,283
1270,118,15,117,18,268
1273,115,34,116,17,282
1274,133,32,118,17,300
1275,117,32,118,17,284
1276,118,15,118,17,268
1277,115,35,116,17,283
1278,117,18,116,17,268
1279,117,33,133,18,301
1280,101,33,133,18,285
1282,100,33,118,16,267
1283,116,34,118,15,283
1284,101,34,118,15,268
1286,100,33,115,17,265
1289,117,34,117,16,284
1293,117,32,118,16,283
1294,100,32,118,16,266
1295,117,34,118,16,285
1296,133,34,117,16,300
1297,115,34,117,16,282
1298,117,16,117,16,266
1299,115,35,131,16,297
1301,120,31,116,17,284
1303,117,34,117,15,283
1305,116,33,132,20,301
1307,119,33,119,15,286
1308,131,33,117,17,298
1310,116,17,117,17,267
1313,115,33,119,15,282
1314,132,35,133,16,316
1315,116,35,133,16,300
1316,119,15,133,16,283
1317,103,15,133,16,267
1321,118,32,102,16,268
1322,102,32,102,16,252
1323,114,34,117,16,281
1324,133,33,117,16,299
1325,117,33,117,16,283
1327,100,17,117,16,250
1328,115,19,132,18,284
1329,117,33,117,14,281
1331,102,17,117,14,250
1332,117,16,117,16,266
1333,101,16,117,16,250
1334,100,33,134,16,283
1335,117,34,133,18,302
1336,132,32,119,15,298
1337,116,32,119,15,282
1338,117,14,119,15,265
1339,115,34,116,17,282
1340,117,16,116,17,266
1343,117,33,132,19,301
1344,116,17,132,19,284
1345,115,33,133,17,298
1346,119,15,133,17,284
1348,100,33,117,18,268
1349,116,33,102,18,269
1350,115,17,102,18,252
1351,116,33,119,17,285
1352,132,34,117,17,300
1353,114,34,117,17,282
1356,117,18,133,15,283
1357,119,33,133,17,302
1358,102,33,133,17,285
1359,101,15,133,17,266
1360,119,17,133,15,284
1361,117,32,116,18,283
1363,117,34,116,17,284
1364,115,18,116,17,266
1365,115,33,133,64,345
1366,115,18,133,64,330
1369,118,33,130,4,285
1370,101,33,130,4,268
1371,118,33,139,15,305
1372,100,33,139,15,287
1373,118,33,121,18,290
1375,116,64,122,18,320
1376,163,4,118,18,303
1379,114,4,118,18,254
1380,139,33,128,20,320
1381,121,33,128,20,302
1382,121,18,128,20,287
1384,118,18,117,17,270
1385,118,33,118,17,286
1386,116,15,118,17,266
1387,116,30,121,16,283
1388,128,37,133,17,315
1389,112,37,133,17,299
1390,116,17,133,17,283
1391,118,34,133,17,302
1392,117,17,133,17,284
1394,118,17,132,16,283
1395,118,32,116,17,283
1396,121,16,116,17,270
1397,117,33,116,17,283
1398,133,34,118,14,299
1400,116,17,118,14,265
1402,116,16,116,17,265
1404,116,17,133,17,283
1405,116,33,134,16,299
1406,100,33,134,16,283
1407,116,33,117,18,284
1409,115,34,101,17,267
1413,117,34,116,17,284
1414,117,17,116,17,267
1416,117,18,116,15,266
1417,118,33,117,15,283
1419,102,16,117,15,250
1420,118,17,115,16,266
1422,116,17,117,16,266
1423,117,32,119,16,284
1425,114,34,119,15,282
1426,117,15,119,15,266
1427,115,33,117,18,283
1430,117,16,118,15,266
1431,116,34,116,17,283
1434,101,33,116,18,268
1435,117,34,117,17,285
1436,117,18,117,17,269
1437,117,32,102,15,266
1438,118,15,102,15,250
1439,115,34,118,16,283
1440,116,17,118,16,267
1441,115,34,116,19,284
1442,116,18,116,19,269
1443,118,34,117,16,285
1446,102,31,102,15,250
1447,116,35,117,15,283
1448,118,16,117,15,266
1449,118,35,114,18,285
1451,118,32,116,17,283
1453,118,33,117,15,283
1456,117,15,117,18,267
1457,116,35,116,18,285
1458,114,18,116,18,266
1459,116,33,117,16,282
1460,116,17,117,16,266
1461,118,32,119,16,285
1462,117,15,119,16,267
1463,115,35,116,16,282
1465,118,34,115,16,283
1466,116,18,115,16,265
1467,118,32,118,16,284
1469,116,34,115,19,284
1471,118,32,117,18,285
1472,100,32,117,18,267
1476,118,16,117,16,267
1477,116,34,116,18,284
1479,118,33,101,14,266
1480,117,18,101,14,250
1481,118,32,119,15,284
1482,102,32,119,15,268
1483,115,34,118,16,283
1484,117,16,118,16,267
1486,116,18,116,16,266
1487,119,31,101,15,266
1488,101,31,101,15,248
1491,116,34,116,17,283
1492,118,16,116,17,267
1494,116,16,116,16,264
1495,118,31,118,17,284
1496,101,31,118,17,267
1498,116,18,117,15,266
1500,116,17,116,17,266
1501,116,32,116,18,282
1502,116,16,116,18,266
1504,101,34,117,17,269
1505,117,33,116,17,283
1508,116,17,116,18,267
1509,117,33,116,19,285
1510,101,33,116,19,269
1511,117,34,118,14,283
1512,117,17,118,14,266
1513,116,32,117,18,283
1514,116,17,117,18,268
1515,116,35,117,15,283
1516,116,18,117,15,266
1518,101,34,116,15,266
1519,118,31,117,18,284
1520,101,31,117,18,267
1521,103,14,117,18,252
1522,117,18,117,15,267
1525,117,33,118,15,283
1526,116,15,118,15,264
1527,114,35,115,17,281
1528,100,35,115,17,267
1529,118,32,117,16,283
1531,115,33,118,15,281
1532,116,17,118,15,266
1533,115,33,118,15,281
1535,116,34,118,15,283
1536,115,17,118,15,265
1538,117,16,117,18,268
1540,118,15,102,15,250
1541,115,33,118,16,282
1542,118,15,118,16,267
1543,116,34,116,19,285
1544,118,15,116,19,268
1545,116,35,114,19,284
1546,100,35,114,19,268
1547,117,33,114,19,283
1548,102,33,114,19,268
1549,117,32,101,15,265
1550,102,32,101,15,250
1552,116,19,114,17,266
1553,118,33,117,16,284
1554,114,19,117,16,266
1556,114,19,117,16,266
1557,117,33,116,17,283
1558,101,33,116,17,267
1559,100,18,116,17,251
1560,114,17,119,16,266
1561,117,35,117,16,285
1562,117,16,117,16,266
1564,117,16,121,14,268
1565,118,33,102,15,268
1567,118,34,133,18,303
1569,116,33,118,16,283
1570,117,16,118,16,267
1573,119,31,100,18,268
1574,102,31,100,18,251
1575,115,34,117,18,284
1576,133,34,117,16,300
1577,116,34,117,16,283
1578,118,16,117,16,267
1580,115,16,101,17,249
1581,116,34,117,16,283
1583,115,35,131,18,299
1586,117,16,117,15,265
1587,117,34,116,17,284
1588,101,34,116,17,268
1589,117,32,117,17,283
1590,101,32,117,17,267
1591,116,33,101,16,266
1592,131,33,118,17,299
1593,115,33,118,17,283
1594,117,15,118,17,267
1595,115,35,116,17,283
1596,116,17,116,17,266
1598,101,33,117,17,268
1599,117,34,117,15,283
1600,101,34,117,15,267
1602,102,33,117,15,267
1604,116,17,117,17,267
1607,118,32,119,16,285
1608,117,15,119,16,267
1609,116,33,117,17,283
1610,117,15,117,17,266
1611,116,35,116,16,283
1614,115,17,117,16,265
1616,100,35,131,17,283
1619,116,33,101,16,266
1621,117,33,117,17,284
1623,114,33,101,15,263
1624,131,35,132,16,314
1625,116,35,132,16,299
1626,116,18,132,16,282
1627,117,32,116,19,284
1629,116,34,116,18,284
1630,117,17,116,18,268
1632,101,33,118,16,268
1633,117,33,118,16,284
1634,115,17,118,16,266
1635,116,35,116,16,283
1636,116,19,116,16,267
1641,102,16,116,17,251
1642,101,33,119,14,267
1643,102,16,119,14,251
1644,116,16,118,16,266
1645,117,33,101,17,268
1646,115,17,101,17,250
1647,115,34,116,18,283
1648,116,17,116,18,267
1651,116,34,101,16,267
1652,100,34,101,16,251
1653,118,32,118,16,284
1654,101,32,118,16,267
1655,101,15,118,16,250
1657,115,34,101,15,265
1658,101,34,101,15,251
1659,117,31,118,18,284
1660,101,31,118,18,268
1661,115,34,102,15,266
1662,118,16,102,15,251
1664,115,20,115,17,267
1665,120,30,116,19,285
1667,115,36,114,19,284
1668,118,18,114,19,269
1670,102,32,115,19,268
1671,101,17,115,19,252
1672,115,17,115,17,264
1674,116,19,116,17,268
1675,117,34,116,17,284
1676,114,19,116,17,266
1677,118,33,115,16,282
1679,117,32,117,15,281
1680,115,17,117,15,264
1681,118,34,116,18,286
1682,116,17,116,18,267
1683,118,34,114,18,284
1684,116,17,114,18,265
1685,119,31,119,15,284
1686,115,16,119,15,265
1689,115,36,115,18,284
1691,117,32,117,17,283
1693,117,33,101,17,268
1694,101,33,101,17,252
1695,116,33,116,18,283
1696,101,33,116,18,268
1697,116,35,115,18,284
1698,115,18,115,18,266
1700,117,17,116,16,266
1701,116,34,117,15,282
1702,101,34,117,15,267
1703,101,17,117,15,250
1705,117,34,116,18,285
1707,117,32,117,17,283
1708,116,16,117,17,266
1709,115,34,117,16,282
1710,117,15,117,16,265
1711,118,33,116,19,286
1712,117,16,116,19,268
1713,117,35,117,14,283
1714,116,18,117,14,265
1715,118,32,117,16,283
1716,117,17,117,16,267
1718,100,33,119,15,267
1721,118,31,119,14,282
1722,117,14,119,14,264
1724,117,16,119,14,266
1727,103,15,118,16,252
1728,116,17,117,16,266
1729,116,31,118,17,282
1731,115,34,117,16,282
1732,119,14,117,16,266
1733,114,35,116,16,281
1734,118,16,116,16,266
1735,117,33,115,19,284
1736,117,16,115,19,267
1737,116,33,115,19,283
1738,102,33,115,19,269
1739,115,32,102,15,264
1740,101,32,102,15,250
1741,114,34,133,16,297
1742,116,16,133,16,281
1743,115,35,114,18,282
1744,115,19,114,18,266
1746,115,19,116,17,267
1748,102,32,117,19,270
1749,116,33,103,15,267
1751,117,34,118,17,286
1752,114,18,118,17,267
1753,118,34,116,18,286
1754,116,17,116,18,267
1756,101,35,115,17,268
1757,118,31,101,23,273
1758,103,31,101,23,258
1759,118,35,115,18,286
1760,118,17,115,18,268
1761,118,33,115,18,284
1764,115,17,116,16,264
1765,117,34,133,16,300
1766,101,34,133,16,284
1767,106,11,133,16,266
1768,100,33,116,16,265
1770,115,18,117,15,265
1771,117,32,119,15,283
1772,116,16,119,15,266
1774,133,32,100,16,281
1776,116,16,100,16,248
1777,117,33,133,18,301
1778,117,15,133,18,283
1779,116,34,117,17,284
1780,119,15,117,17,268
1781,116,33,119,15,283
1782,116,16,119,15,266
1783,116,34,117,17,284
1785,116,32,102,16,266
1788,117,17,116,17,267
1789,117,33,116,16,282
1790,101,33,116,16,266
1791,118,34,115,18,285
1794,102,31,118,17,268
1795,115,35,115,20,285
1796,116,17,115,20,268
1797,115,32,103,15,265
1798,116,16,103,15,250
1799,115,35,132,17,299
1800,115,18,132,17,282
1803,117,35,115,17,284
1804,100,35,115,17,267
1805,119,31,119,15,284
1807,101,16,119,15,251
1808,132,34,117,17,300
1810,116,17,117,17,267
1811,118,34,117,15,284
1812,115,17,117,15,264
1813,117,33,118,15,283
1814,119,15,118,15,267
1817,118,33,117,15,283
1819,117,32,119,15,283
1821,114,34,116,18,282
1822,118,15,116,18,267
1823,118,33,118,15,284
1825,116,33,115,19,283
1826,117,15,115,19,266
1827,115,34,116,16,281
1828,100,34,116,16,266
1829,115,34,115,18,282
1833,115,34,101,15,265
1834,115,19,101,15,250
1835,115,32,135,16,298
1837,116,35,116,18,285
1839,116,34,115,19,284
1840,101,34,115,19,269
1842,101,32,102,14,249
1845,118,34,116,17,285
1846,116,18,116,17,267
1847,118,34,117,16,285
1848,115,19,117,16,267
1849,119,31,102,16,268
1850,102,31,102,16,251
1851,115,35,116,17,283
1852,134,33,117,16,300
1853,118,33,117,16,284
1854,100,33,117,16,266
1857,103,16,115,16,250
1858,102,33,116,16,267
1860,116,17,116,17,266
1861,117,33,116,18,284
1862,117,16,116,18,267
1863,115,32,102,16,265
1864,115,16,102,16,249
1866,116,16,119,15,266
1867,116,34,117,15,282
1868,116,17,117,15,265
1869,116,34,116,17,283
1870,116,18,116,17,267
1873,117,33,101,15,266
1874,101,33,101,15,250
1876,117,15,117,16,265
1877,116,35,115,17,283
1878,116,17,115,17,265
1879,117,34,116,17,284
1880,116,18,116,17,267
1881,116,32,115,18,281
1882,101,32,115,18,266
1883,116,32,116,19,283
1885,115,34,116,19,284
1886,115,17,116,19,267
1887,116,35,117,14,282
1888,116,17,117,14,264
1891,117,34,115,19,285
1893,118,34,116,15,283
1894,116,19,116,15,266
1897,103,14,118,16,251
1898,116,19,116,16,267
1899,120,33,115,18,286
1900,101,33,115,18,267
1901,119,31,102,16,268
1902,116,15,102,16,249
1903,114,34,134,17,299
1904,118,16,134,17,285
1905,117,34,117,16,284
1906,116,16,117,16,265
1907,118,34,115,18,285
1911,116,34,116,18,284
1912,134,33,101,15,283
1913,116,33,101,15,265
1914,117,16,101,15,249
1915,117,34,118,17,286
1916,115,18,118,17,268
1919,116,34,116,17,283
1922,101,32,101,17,251
1923,117,36,132,17,302
1924,118,17,132,17,284
1925,119,28,104,17,268
1926,102,28,104,17,251
1927,104,10,104,17,235
1928,116,17,117,17,267
1929,118,35,114,19,286
1930,101,35,114,19,269
1932,132,33,101,16,282
1935,101,16,101,16,234
1936,117,17,133,16,283
1939,118,33,117,15,283
1940,118,16,117,15,266
1942,101,33,115,18,267
1943,117,33,116,16,282
1944,133,33,115,19,300
1946,115,17,115,19,266
1947,115,33,101,16,265
1948,117,15,101,16,249
1951,117,32,117,18,284
1954,115,19,115,17,266
1955,116,32,116,18,282
1956,101,32,116,18,267
1957,101,16,116,18,251
1958,115,18,117,18,268
1959,117,34,117,15,283
1960,101,34,117,15,267
1961,119,32,119,15,285
1963,116,34,117,15,282
1964,116,18,117,15,266
1966,117,18,115,17,267
1967,119,31,116,18,284
1968,117,15,116,18,266
1969,117,34,117,17,285
1973,115,35,133,17,300
1976,116,18,133,17,284
1978,117,17,133,18,285
1979,117,32,119,15,283
1980,102,32,119,15,268
1982,99,34,116,19,268
1983,118,33,117,16,284
1984,117,16,117,16,266
1985,116,34,117,17,284
1987,117,33,101,18,269
1989,117,35,132,17,301
1991,118,31,118,17,284
1992,102,31,118,17,268
1993,116,35,114,18,283
1994,117,17,114,18,266
1995,116,31,119,16,282
2000,101,34,116,15,266
2001,117,32,118,16,283
2002,100,32,118,16,266
2003,114,34,116,18,282
2005,118,33,117,17,285
2006,116,17,117,17,267
2007,116,32,117,18,283
2008,116,15,117,18,266
2013,118,33,116,17,284
2014,101,33,116,17,267
2015,117,33,115,17,282
2016,102,33,115,17,267
2018,100,33,117,16,266
2019,117,34,116,15,282
2020,117,16,116,15,264
2021,117,33,117,17,284
2022,116,17,117,17,267
2023,101,17,117,17,252
2025,116,34,116,17,283
2026,117,16,116,17,266
2027,115,32,119,15,281
2028,116,15,119,15,265
2029,115,36,115,16,282
2030,117,17,115,16,265
2031,119,35,130,18,302
2032,102,35,130,18,285
2033,119,30,118,15,282
2034,103,30,118,15,266
2035,116,33,119,15,283
2037,115,33,120,14,282
2039,115,34,117,16,282
2041,117,33,118,17,285
2042,118,15,118,17,268
2043,100,15,118,17,250
2044,119,15,101,17,252
2045,117,33,118,15,283
2046,120,14,118,15,267
2047,117,33,117,18,285
2048,100,33,117,18,268
2049,115,35,116,17,283
2050,118,17,116,17,268
2052,101,32,117,17,267
2054,118,15,101,14,248
2055,116,35,134,15,300
2056,117,18,134,15,284
2057,117,33,116,18,284
2058,116,17,116,18,267
2059,116,33,118,16,283
2060,101,33,118,16,268
2061,116,32,102,14,264
2062,101,32,102,14,249
2063,116,36,133,17,302
2065,118,33,132,18,301
2066,116,18,132,18,284
2068,118,16,117,16,267
2069,120,32,116,18,286
2070,102,32,116,18,268
2072,133,32,117,17,299
2074,117,15,117,17,266
2077,103,16,115,18,252
2079,116,34,117,17,284
2080,115,18,117,17,267
2081,116,33,118,16,283
2082,101,33,118,16,268
2083,116,33,101,14,264
2085,118,34,132,18,302
2086,117,17,132,18,284
2087,118,34,133,15,300
2088,117,17,133,15,282
2089,101,17,133,15,266
2091,103,16,115,17,251
2092,101,32,116,18,267
2093,116,33,116,19,284
2095,115,35,115,20,285
2098,115,17,103,14,249
2099,101,17,103,14,235
2100,116,18,115,18,267
2101,116,34,115,17,282
2102,101,34,115,17,267
2103,117,35,130,16,298
2104,115,20,130,16,281
2106,103,30,116,19,268
2108,115,18,116,17,266
2109,118,33,117,17,285
2110,115,17,117,17,266
2111,117,33,118,16,284
2112,130,35,116,16,297
2113,116,35,116,16,283
2114,116,19,116,16,267
2115,119,32,117,17,285
2116,116,17,117,17,267
2119,118,33,115,19,285
2120,101,33,115,19,268
2121,118,33,101,15,267
2122,99,33,101,15,248
2124,117,17,117,17,268
2125,117,34,115,17,283
2126,100,34,115,17,266
2127,117,33,115,18,283
2128,101,33,115,18,267
2129,117,32,118,15,282
2130,101,32,118,15,266
2131,116,35,116,17,284
2132,117,17,116,17,267
2133,117,32,117,18,284
2134,115,17,117,18,267
2136,115,18,101,17,251
2137,118,32,117,18,285
2138,118,15,117,18,268
2139,115,35,117,17,284
2140,116,17,117,17,267
2141,118,34,114,18,284
2142,117,18,114,18,267
2144,101,33,115,18,267
2145,101,16,115,18,250
2146,102,33,116,15,266
2147,117,34,133,14,298
2148,117,17,133,14,281
2150,114,18,133,17,282
2151,115,34,116,16,281
2153,118,31,101,16,266
2155,114,36,115,17,282
2157,119,32,118,16,285
2158,115,18,118,16,267
2159,117,33,118,16,284
2160,116,16,118,16,266
2162,101,35,115,16,267
2165,118,34,117,16,285
2166,100,34,117,16,267
2169,118,32,118,15,283
2171,116,36,132,17,301
2172,117,18,132,17,284
2173,117,32,132,19,300
2174,101,32,132,19,284
2175,116,33,118,16,283
2178,118,15,102,17,252
2179,115,35,117,15,282
2180,132,32,118,17,299
2181,116,32,118,17,283
2182,117,15,118,17,267
2183,114,35,115,19,283
2185,101,16,115,19,251
2186,102,32,102,16,252
2187,115,33,118,17,283
2188,117,15,118,17,267
2189,115,35,117,15,282
2190,118,17,117,15,267
2191,116,34,114,20,284
2192,100,34,114,20,268
2195,116,34,133,16,299
2196,118,17,133,16,284
2198,100,32,117,16,265
2199,117,36,115,16,284
2201,118,32,118,14,282
2203,117,33,117,17,284
2205,116,32,118,15,281
2206,101,32,118,15,266
2207,101,16,118,15,250
2211,116,35,116,15,282
2212,117,17,116,15,265
2213,118,31,118,16,283
2214,102,31,118,16,267
2215,115,34,118,17,284
2216,117,16,118,17,268
2217,114,34,117,16,281
2218,116,18,117,16,267
2219,116,32,117,17,282
2221,115,34,116,17,282
2222,118,16,116,17,267
2223,116,35,115,17,283
2224,118,17,115,17,267
2225,119,32,117,16,284
2228,101,33,117,16,267
2229,116,33,118,16,283
2230,116,17,118,16,267
2233,116,33,116,17,282
2234,117,16,116,17,266
2236,100,33,100,18,251
2237,117,34,116,17,284
2238,118,16,116,17,267
2240,119,16,116,16,267
2241,102,16,116,16,250
2243,116,35,116,18,285
2245,117,32,117,18,284
2246,101,32,117,18,268
2247,114,34,101,16,265
2248,116,16,101,16,249
2249,118,35,131,17,301
2250,101,35,131,17,284
2251,118,33,131,17,299
2252,116,18,131,17,282
2253,119,33,115,18,285
2255,117,31,119,15,282
2256,101,31,119,15,266
2257,115,34,118,16,283
2259,116,33,101,16,266
2261,116,35,135,15,301
2265,101,15,118,15,249
2266,100,34,116,18,268
2268,101,35,116,17,269
2270,135,30,118,16,299
2273,115,35,116,16,282
2274,116,18,116,16,266
2275,118,34,116,18,286
2276,116,17,116,18,267
2277,119,31,117,19,286
2278,115,15,117,19,266
2279,115,34,102,17,268
2280,118,16,102,17,253
2281,117,33,133,19,302
2282,116,16,133,19,284
2283,115,36,130,20,301
2284,116,18,130,20,284
2285,118,33,117,16,284
2286,103,33,117,16,269
2287,118,33,117,17,285
2289,102,16,117,17,252
2290,102,31,103,16,252
2291,115,33,118,17,283
2292,116,14,118,17,265
2293,116,36,115,18,285
2294,117,16,115,18,266
2296,100,34,115,15,264
2298,103,32,115,18,268
2299,116,33,116,17,282
2300,102,33,116,17,268
2302,115,18,115,19,267
2303,116,31,117,19,283
2305,114,35,117,15,281
2306,115,18,117,15,265
2307,117,33,117,15,282
2308,100,33,117,15,265
2309,117,35,132,17,301
2311,118,33,116,17,284
2314,117,15,102,17,251
2315,116,33,135,15,299
2316,117,15,135,15,282
2317,116,35,115,19,285
2318,116,16,115,19,266
2319,118,34,117,17,286
2320,116,17,117,17,267
2321,117,33,115,18,283
2322,102,33,115,18,268
2323,117,33,117,15,282
2324,102,33,117,15,267
2325,116,34,114,18,282
2326,100,34,114,18,266
2327,117,34,116,16,283
2330,101,32,117,15,265
2331,116,32,117,18,283
2333,117,34,101,17,269
2335,115,34,134,15,298
2336,116,16,134,15,281
2337,118,32,117,18,285
2338,117,15,117,18,267
2340,100,35,115,19,269
2341,119,32,118,16,285
2342,101,32,118,16,267
2343,115,35,115,17,282
2344,134,33,116,17,300
2345,117,33,116,17,283
2347,118,34,117,15,284
2348,115,19,117,15,266
2349,117,32,116,20,285
2350,102,32,116,20,270
2353,117,34,118,16,285
2356,117,15,101,16,249
2357,116,36,114,16,282
2358,116,20,114,16,266
2360,103,30,118,17,268
2362,118,16,115,17,266
2364,101,32,118,15,266
2365,117,33,118,16,284
2366,114,16,118,16,264
2367,115,35,116,17,283
2368,118,17,116,17,268
2369,116,32,119,15,282
2371,116,33,118,15,282
2372,100,33,118,15,266
2373,116,34,118,16,284
2374,118,16,118,16,268
2375,116,34,118,16,284
2377,118,33,101,14,266
2378,101,33,101,14,249
2379,116,32,135,18,301
2381,115,35,134,17,301
2382,118,16,134,17,285
2383,117,34,117,15,283
2384,100,34,117,15,266
2385,116,31,101,18,266
2388,135,34,117,16,302
2389,116,34,117,16,283
2390,118,16,117,16,267
2391,116,32,116,16,280
2393,103,15,116,16,250
2394,101,33,116,20,270
2395,116,34,118,16,284
2397,115,34,116,18,283
2398,117,16,116,18,267
2399,116,31,103,14,264
2400,116,16,103,14,249
2401,114,37,132,16,299
2402,116,20,132,16,284
2403,118,32,116,18,284
2404,102,32,116,18,268
2405,116,34,115,19,284
2407,119,33,115,17,284
2408,103,33,115,17,268
2409,100,19,115,17,251
2410,132,34,116,17,299
2412,116,18,116,17,267
2414,100,34,131,17,282
2415,120,31,117,17,285
2416,101,31,117,17,266
2417,117,35,116,17,285
2418,116,18,116,17,267
2419,118,33,117,14,282
2420,116,17,117,14,264
2422,116,15,117,16,264
2425,117,34,117,17,285
2426,116,17,117,17,267
2427,117,31,117,18,283
2428,100,31,117,18,266
2429,114,34,117,18,283
2430,117,16,117,18,268
2431,116,33,118,15,282
2432,118,14,118,15,265
2434,117,17,114,17,265
2435,117,32,117,15,281
2439,116,31,117,17,281
2440,102,31,117,17,267
2441,114,34,117,17,282
2442,114,17,117,17,265
2444,117,15,101,16,249
2445,116,35,132,16,299
2446,116,17,132,16,281
2450,117,17,101,15,250
2451,116,34,134,15,299
2452,101,34,134,15,284
2453,117,32,117,17,283
2454,132,35,116,16,299
2456,100,35,116,16,267
2457,118,32,116,16,282
2458,101,32,116,16,265
2460,134,32,118,16,300
2461,119,32,118,16,285
2462,102,32,118,16,268
2463,118,33,118,15,284
2465,117,32,120,14,283
2469,116,35,115,19,285
2470,118,16,115,19,268
2473,102,15,102,16,235
2474,120,14,135,15,284
2477,116,34,114,18,282
2478,115,19,114,18,266
2479,117,31,119,17,284
2480,102,31,119,17,269
2481,114,35,115,19,283
2482,100,35,115,19,269
2483,117,34,115,17,283
2484,115,19,115,17,266
2485,119,32,116,16,283
2486,114,18,116,16,264
2487,116,35,115,17,283
2488,101,35,115,17,268
2489,119,33,115,17,284
2491,119,32,116,17,284
2492,115,17,116,17,265
2493,118,32,119,16,285
2495,114,35,115,18,282
2496,115,17,115,18,265
2497,118,33,115,18,284
2502,101,34,117,16,268
2503,117,33,117,18,285
2505,117,33,102,13,265
2508,118,14,118,16,266
2510,117,16,116,17,266
2511,118,35,114,18,285
2512,117,18,114,18,267
2514,102,32,115,17,266
2515,116,32,116,19,283
2516,118,16,116,19,269
2518,116,17,116,17,266
2519,116,34,115,17,282
2520,114,18,115,17,264
2523,116,35,117,16,284
2524,116,19,117,16,268
2525,118,32,101,16,267
2526,116,17,101,16,250
2527,117,33,119,14,283
2531,118,34,115,19,286
2532,117,16,115,19,267
2534,101,32,102,16,251
2536,119,14,118,16,267
2537,115,34,116,17,282
2538,118,15,116,17,266
2540,115,19,115,16,265
2541,118,32,117,16,283
2542,102,32,117,16,267
2543,115,33,116,19,283
2544,101,33,116,19,269
2547,117,33,118,16,284
2549,115,34,118,15,282
2550,117,16,118,15,266
2552,116,19,116,15,266
2553,119,32,117,17,285
2554,102,32,117,17,268
2555,117,33,101,16,267
2556,118,16,101,16,251
2557,116,33,116,18,283
2559,117,33,118,16,284
2560,116,15,118,16,265
2561,116,35,115,17,283
2562,117,17,115,17,266
2563,117,32,117,17,283
2564,101,32,117,17,267
2566,116,18,118,16,268
2567,116,33,118,15,282
2572,100,34,117,15,266
2573,118,34,115,18,285
2574,118,16,115,18,267
2575,117,32,101,16,266
2577,102,15,101,16,234
2578,119,15,118,15,267
2579,102,15,118,15,250
2581,114,35,117,17,283
2583,116,33,116,18,283
2584,101,33,116,18,268
2586,118,15,117,17,267
2587,101,15,117,17,250
2588,119,15,117,18,269
2590,117,17,117,14,265
2591,118,33,116,17,284
2592,101,33,116,17,267
2593,116,33,117,17,283
2594,101,33,117,17,268
2595,116,34,114,21,285
2596,117,18,114,21,270
2597,117,31,104,15,267
2600,116,17,116,18,267
2602,100,34,116,17,267
2603,101,17,116,17,251
2605,118,31,118,17,284
2606,104,31,118,17,270
2607,101,16,118,17,252
2608,116,18,116,17,267
2609,117,33,119,13,282
2611,102,17,119,13,251
2612,113,19,115,16,263
2614,118,17,132,15,282
2615,102,17,132,15,266
2617,117,32,117,15,281
2618,100,32,117,15,264
2620,115,16,117,18,266
2621,114,35,115,17,281
2624,115,18,116,16,265
2625,114,31,118,18,281
2626,117,15,118,18,268
2627,115,36,116,17,284
2629,118,32,117,18,285
2630,100,32,117,18,267
2631,117,33,119,16,285
2633,116,35,115,18,284
2634,118,18,115,18,269
2635,118,33,117,18,286
2636,116,17,117,18,268
2637,101,17,117,18,253
2638,101,34,115,18,268
2639,118,33,117,17,285
2642,100,33,117,18,268
2644,117,18,115,16,266
2645,119,32,113,20,284
2646,115,18,113,20,266
2648,117,17,115,17,266
2649,119,34,117,15,285
2650,117,18,117,15,267
2652,115,16,116,18,265
2653,117,34,117,17,285
2654,113,20,117,17,267
2655,116,33,116,17,282
2656,115,17,116,17,265
2657,116,34,117,15,282
2658,117,15,117,15,264
2660,101,33,118,15,267
2661,102,18,118,15,253
2662,117,17,115,17,266
2663,118,32,118,15,283
2664,116,17,118,15,266
2666,117,15,117,17,266
2667,117,34,116,18,285
2669,116,33,101,15,265
2670,115,17,101,15,248
2673,115,34,117,16,282
2674,117,17,117,16,267
2675,115,34,114,18,281
2676,100,34,114,18,266
2677,118,32,117,16,283
2680,118,17,117,15,267
2681,118,32,117,17,284
2682,101,32,117,17,267
2683,117,33,118,16,284
2685,117,33,119,15,284
2686,100,33,119,15,267
2687,115,34,118,16,283
2688,117,15,118,16,266
2691,119,33,117,17,286
2692,101,33,117,17,268
2693,117,33,101,15,266
2694,101,33,101,15,250
2696,118,16,118,15,267
2697,117,32,118,16,283
2698,116,16,118,16,266
2699,115,35,116,16,282
2700,117,17,116,16,266
2701,116,33,117,15,281
2702,101,33,117,15,266
2703,116,33,116,18,283
2704,118,15,116,18,267
2705,117,33,116,18,284
2706,118,16,116,18,268
2709,117,33,118,16,284
2710,117,15,118,16,266
2712,116,18,115,19,268
2713,117,33,117,17,284
2714,116,18,117,17,268
2715,117,32,102,16,267
2717,115,34,118,15,282
2718,100,34,118,15,267
2719,117,35,116,15,283
2720,115,19,116,15,265
2722,101,33,116,16,266
2724,102,33,116,16,267
2725,117,32,118,15,282
2727,117,33,119,15,284
2728,116,15,119,15,265
2730,116,16,118,15,265
2735,115,34,116,17,282
2737,116,33,118,15,282
2738,100,33,118,15,266
2739,101,15,118,15,249
2740,100,34,117,18,269
2742,101,34,116,16,267
2743,116,32,118,16,282
2744,116,17,118,16,267
2745,115,33,101,18,267
2747,115,36,135,13,299
2748,117,18,135,13,283
2750,101,31,117,19,268
2752,100,34,102,15,251
2753,116,33,118,16,283
2754,101,33,118,16,268
2755,116,37,115,14,282
2757,133,19,116,16,284
2758,117,19,116,16,268
2759,118,31,116,18,283
2760,102,31,116,18,267
2761,115,34,116,17,282
2763,117,32,117,18,284
2764,115,14,117,18,264
2766,116,16,116,17,265
2767,117,33,117,16,283
2771,115,34,116,16,281
2774,100,33,117,15,265
2775,101,17,117,15,250
2776,117,16,117,16,266
2777,117,33,118,16,284
2778,116,17,118,16,267
2779,117,33,119,16,285
2780,116,16,119,16,267
2781,116,33,118,18,285
2782,117,15,118,18,268
2783,115,34,102,14,265
2784,99,34,102,14,249
2785,117,34,118,17,286
2786,118,16,118,17,269
2787,117,34,101,14,266
2788,101,34,101,14,250
2789,117,34,131,18,300
2793,115,36,115,18,284
2794,99,36,115,18,268
2795,117,31,102,15,265
2797,116,33,118,18,285
2798,131,35,117,16,299
2799,117,35,117,16,285
2800,118,17,117,16,268
2802,115,18,115,17,265
2803,119,32,116,16,283
2804,102,32,116,16,266
2805,116,35,114,17,282
2806,118,18,114,17,267
2809,101,16,116,17,250
2810,115,17,116,18,266
2811,117,32,102,16,267
2812,116,16,102,16,250
2814,114,17,134,16,281
2815,115,34,116,19,284
2816,116,17,116,19,268
2817,117,34,115,16,282
2818,116,18,115,16,265
2821,118,33,116,16,283
2822,118,16,116,16,266
2823,117,35,114,18,284
2825,119,30,119,16,284
2827,115,35,116,16,282
2828,116,17,116,16,265
2831,116,35,117,16,284
2832,114,18,117,16,265
2833,118,33,116,16,283
2834,102,33,116,16,267
2836,116,16,119,16,267
2837,116,35,117,16,284
2838,119,16,117,16,268
2839,118,33,117,17,285
2841,116,32,102,15,265
2842,116,16,102,15,249
2843,116,35,117,18,286
2844,100,35,117,18,270
2845,116,33,117,16,282
2846,117,16,117,16,266
2847,116,34,117,16,283
2848,100,34,117,16,267
2849,118,33,116,17,284
2850,102,33,116,17,268
2851,116,35,114,18,283
2852,117,18,114,18,267
2853,118,31,118,16,283
2855,116,34,116,17,283
2856,117,16,116,17,266
2857,102,16,116,17,251
2859,116,34,117,15,282
2860,114,18,117,15,264
2862,101,33,115,17,266
2863,116,33,117,18,284
2865,117,33,116,17,283
2866,117,16,116,17,266
2867,117,33,118,14,282
2869,115,33,117,19,284
2870,115,17,117,19,268
2871,116,36,115,16,283
2873,118,31,117,17,283
2874,102,31,117,17,267
2876,118,14,118,19,269
2877,116,37,116,15,284
2878,117,19,116,15,267
2879,118,31,100,18,267
2880,115,16,100,18,249
2882,117,17,134,16,284
2883,116,35,133,16,300
2886,100,31,118,17,266
2887,116,33,102,16,267
2888,100,33,102,16,251
2890,134,34,114,19,301
2892,115,18,114,19,266
2896,102,33,115,17,267
2900,114,19,115,16,264
2901,117,31,117,19,284
2903,115,34,102,15,266
2904,115,17,102,15,249
2906,116,17,116,16,265
2907,101,17,116,16,250
2909,117,36,115,17,285
2910,117,19,115,17,268
2911,119,31,117,16,283
2912,102,31,117,16,266
2913,116,33,117,16,282
2914,99,33,117,16,265
2915,116,35,116,17,284
2917,118,33,118,15,284
2918,115,17,118,15,265
2920,117,16,101,17,251
2922,117,16,119,15,267
2923,114,35,117,15,281
2924,116,17,117,15,265
2925,117,33,118,15,283
2927,117,34,117,16,284
2928,101,34,117,16,268
2929,118,32,117,18,285
2930,102,32,117,18,269
2931,116,33,118,15,282
2932,117,15,118,15,265
2933,114,34,117,17,282
2934,118,15,117,17,267
2935,101,15,117,17,250
2936,117,16,115,18,266
2938,101,34,117,15,267
2941,114,35,133,16,298
2942,117,17,133,16,283
2943,116,33,135,17,301
2944,115,18,135,17,285
2946,117,15,119,15,266
2947,116,34,117,15,282
2948,101,34,117,15,267
2949,117,33,116,19,285
2952,116,19,114,17,266
2955,101,15,117,16,249
2957,116,36,114,17,283
2958,116,19,114,17,266
2959,119,31,118,16,284
2960,100,31,118,16,265
2961,114,34,117,17,282
2962,117,16,117,17,267
2963,116,34,116,19,285
2964,101,34,116,19,270
2965,118,32,103,16,269
2966,114,17,103,16,250
2968,100,34,116,18,268
2969,116,34,117,15,282
2972,116,19,114,17,266
2974,103,34,114,16,267
2975,101,18,114,16,249
2976,116,18,117,15,266
2977,117,32,100,16,265
2978,117,15,100,16,248
2980,114,17,116,19,266
2981,115,33,118,15,281
2982,114,16,118,15,263
2983,117,33,117,16,283
2984,99,33,117,16,265
2985,115,36,132,16,299
2987,119,33,115,17,284
2989,118,31,101,17,267
2990,102,31,101,17,251
2991,115,33,118,18,284
2994,114,18,116,18,266
2995,118,33,118,15,284
2996,115,17,118,15,265
2997,116,34,115,17,282
2998,101,34,115,17,267
3000,102,34,115,15,266
3001,119,33,116,16,284
3003,118,32,116,17,283
3006,115,17,100,18,250
3007,116,32,119,15,282
3009,115,35,117,16,283
3010,116,16,117,16,265
3011,115,33,117,16,281
3012,116,17,117,16,266
3014,100,33,118,16,267
3015,101,15,118,16,250
3016,101,33,117,19,270
3019,117,33,117,17,284
3020,117,16,117,17,267
3022,118,16,116,18,268
3023,116,35,117,15,283
3024,117,19,117,15,268
3026,102,31,101,16,250
3027,116,34,117,16,283
3028,117,17,117,16,267
3029,116,34,117,15,282
3031,118,33,117,17,285
3032,117,15,117,17,266
3033,117,35,115,16,283
3035,119,31,118,17,285
3036,102,31,118,17,268
3037,117,33,116,18,284
3038,117,15,116,18,266
3040,117,17,116,16,266
3041,118,32,119,15,284
3043,116,35,115,17,283
3044,100,35,115,17,267
3045,117,32,116,17,282
3047,116,33,117,16,282
3048,116,16,117,16,265
3050,100,34,116,17,267
3051,101,15,116,17,249
3052,115,17,117,17,266
3053,118,33,117,18,286
3054,116,17,117,18,268
3056,117,16,102,16,251
3058,116,17,105,16,254
3061,118,34,116,15,283
3062,101,34,116,15,266
3063,118,37,129,16,300
3064,102,37,129,16,284
3065,101,21,129,16,267
3066,105,29,116,17,267
3068,116,17,116,17,266
3071,115,35,115,18,283
3072,129,33,116,17,295
3073,113,33,116,17,279
3074,116,17,116,17,266
3075,117,33,116,17,283
3076,100,33,116,17,266
3078,101,35,133,16,285
3079,118,32,117,15,282
3082,100,33,119,13,265
3083,117,33,118,15,283
3084,100,33,118,15,266
3085,115,35,115,17,282
3086,133,31,101,16,281
3088,101,31,101,16,249
3089,101,15,101,16,233
3090,119,13,119,15,266
3093,116,34,116,18,284
3094,115,17,116,18,266
3095,116,34,100,16,266
3097,115,32,117,16,280
3098,102,32,117,16,267
3099,115,34,117,17,283
3100,117,17,117,17,268
3101,117,34,116,16,283
3103,118,34,117,15,284
3104,100,34,117,15,266
3105,117,31,117,18,283
3106,102,31,117,18,268
3107,116,35,117,15,283
3108,117,17,117,15,266
3109,118,32,118,15,283
3110,116,16,118,15,265
3111,116,34,116,17,283
3112,117,15,116,17,265
3113,117,34,115,19,285
3114,117,18,115,19,269
3116,117,15,118,16,266
3117,116,33,118,16,283
3118,118,15,118,16,267
3119,114,34,119,15,282
3121,117,35,116,16,284
3122,115,19,116,16,266
3123,117,32,118,15,282
3125,116,33,116,19,284
3126,101,33,116,19,269
3127,117,34,116,18,285
3128,100,34,116,18,268
3129,103,15,116,18,252
3130,116,16,101,15,248
3132,118,15,118,18,269
3133,116,35,117,16,284
3134,116,19,117,16,268
3136,116,18,116,15,265
3138,101,34,114,19,268
3139,117,34,115,18,284
3140,102,34,115,18,269
3142,101,32,118,15,266
3146,114,19,116,15,264
3147,117,34,132,17,300
3149,117,32,117,17,283
3150,101,32,117,17,267
3151,117,32,102,15,266
3152,102,32,102,15,251
3153,117,33,118,17,285
3155,115,35,117,17,284
3157,115,34,115,16,280
3158,117,17,115,16,265
3159,118,33,116,18,285
3161,117,33,101,15,266
3164,117,17,115,18,267
3165,117,31,118,17,283
3167,116,36,115,18,285
3168,116,18,115,18,267
3169,118,33,116,17,284
3170,101,33,116,17,267
3172,115,18,116,17,266
3175,117,34,118,14,283
3176,115,18,118,14,265
3177,118,33,116,17,284
3178,116,17,116,17,266
3180,116,17,115,18,266
3182,115,18,118,15,266
3183,117,33,116,18,284
3184,118,14,116,18,266
3185,116,34,116,18,284
3187,117,33,117,17,284
3188,115,18,117,17,267
3189,118,33,101,16,268
3192,116,18,116,17,267
3193,117,34,116,16,283
3196,101,33,116,16,266
3199,119,32,118,14,283
3201,117,33,118,14,282
3202,116,16,118,14,264
3203,116,33,118,15,282
3204,116,16,118,15,265
3206,116,16,118,16,266
3207,117,32,102,14,265
3208,100,32,102,14,248
3211,115,34,101,15,265
3212,99,34,101,15,249
3214,118,16,133,16,283
3216,102,33,116,16,267
3217,116,33,116,18,283
3218,119,16,116,18,269
3219,116,33,101,16,266
3220,101,33,101,16,251
3221,115,34,116,17,282
3222,133,32,135,16,316
3224,116,16,135,16,283
3225,115,35,132,18,300
3226,99,35,132,18,284
3227,119,32,118,17,286
3228,101,32,118,17,268
3229,116,34,116,17,283
3231,117,34,115,17,283
3232,101,34,115,17,267
3233,118,32,117,18,285
3234,116,16,117,18,267
3235,116,35,116,17,284
3236,100,35,116,17,268
3238,116,17,117,17,267
3239,117,33,117,17,284
3241,116,35,115,17,283
3242,117,18,115,17,267
3243,117,33,115,18,283
3244,100,33,115,18,266
3245,118,33,100,15,266
3247,101,17,100,15,233
3249,117,33,118,17,285
3250,115,17,118,17,267
3252,115,18,101,16,250
3256,133,35,115,16,299
3258,118,17,115,16,266
3259,102,17,115,16,250
3262,116,20,115,15,266
3263,119,32,117,15,283
3265,116,32,117,17,282
3267,115,35,117,16,283
3269,119,31,102,16,268
3270,115,15,102,16,248
3271,114,34,134,18,300
3272,117,15,134,18,284
3273,116,34,118,15,283
3274,100,34,118,15,267
3275,117,34,117,16,284
3277,117,32,116,19,284
3278,102,32,116,19,269
3279,115,34,117,17,283
3280,116,18,117,17,268
3281,117,33,101,13,264
3282,118,15,101,13,247
3283,115,34,117,18,284
3284,117,16,117,18,268
3286,101,34,101,15,251
3287,119,33,133,16,301
3288,117,17,133,16,283
3289,116,34,115,16,281
3290,101,34,115,16,266
3291,117,34,115,17,283
3293,102,18,115,17,252
3294,101,30,117,17,265
3295,100,15,117,17,249
3296,133,32,119,16,300
3297,120,32,119,16,287
3298,115,16,119,16,266
3299,115,35,118,14,282
3300,115,17,118,14,264
3301,117,32,118,15,282
3304,118,14,118,17,267
3306,119,16,117,16,268
3307,117,32,120,15,284
3309,117,33,102,16,268
3310,118,15,102,16,251
3311,114,35,134,15,298
3312,118,17,134,15,284
3314,100,33,116,17,266
3315,115,34,116,17,282
3316,101,34,116,17,268
3317,117,34,113,19,283
3318,102,34,113,19,268
3319,118,33,115,18,284
3321,117,32,117,16,282
3322,101,32,117,16,266
3324,116,17,116,17,266
3326,113,19,118,17,267
3327,117,34,114,19,284
3328,115,18,114,19,266
3330,117,16,117,17,267
3331,116,34,117,17,284
3332,116,17,117,17,267
3333,119,35,114,19,287
3334,118,17,114,19,268
3335,119,32,117,17,285
3336,101,32,117,17,267
3342,114,19,115,17,265
3343,120,33,116,16,285
3344,101,33,116,16,266
3345,118,32,116,18,284
3346,101,32,116,18,267
3348,116,16,117,18,267
3349,117,34,116,17,284
3350,115,17,116,17,265
3352,116,16,116,17,265
3353,116,34,115,18,283
3354,116,18,115,18,267
3355,117,34,118,16,285
3356,101,34,118,16,269
3357,118,32,102,15,267
3358,101,32,102,15,250
3360,116,17,116,18,267
3362,115,18,117,17,267
3364,118,16,114,20,268
3366,102,31,103,14,250
3367,101,16,103,14,234
3368,116,18,116,16,266
3369,118,34,117,16,285
3370,117,17,117,16,267
3371,115,35,113,16,279
3372,114,20,113,16,263
3373,119,31,116,16,282
3374,103,31,116,16,266
3376,100,32,120,13,265
3377,115,35,115,18,283
3378,117,16,115,18,266
3379,118,31,118,17,284
3381,115,34,118,16,283
3383,116,33,118,17,284
3384,120,13,118,17,268
3385,114,35,115,18,282
3386,115,18,115,18,266
3387,118,33,118,15,284
3388,102,33,118,15,268
3393,118,33,117,15,283
3396,118,15,118,15,266
3397,116,34,134,17,301
3398,116,18,134,17,285
3399,117,34,117,15,283
3400,100,34,117,15,266
3401,119,31,117,19,286
3402,101,31,117,19,268
3403,114,34,117,18,283
3404,118,15,117,18,268
3406,134,32,117,16,299
3407,120,32,117,16,285
3408,100,32,117,16,265
3409,101,15,117,16,249
3410,101,35,116,17,269
3411,117,33,115,16,281
3413,118,33,117,17,285
3415,116,32,102,15,265
3417,117,35,134,16,302
3419,118,31,119,16,284
3420,100,31,119,16,266
3421,115,36,118,13,282
3422,117,17,118,13,265
3423,118,31,118,16,283
3424,102,31,118,16,267
3425,115,36,117,16,284
3427,119,32,117,20,288
3428,103,32,117,20,272
3430,118,13,105,13,249
3431,116,34,133,18,301
3432,118,16,133,18,285
3434,117,16,116,16,265
3435,117,36,114,15,282
3436,101,36,114,15,266
3438,105,29,119,16,269
3439,116,33,102,15,266
3441,132,16,134,15,297
3442,116,16,134,15,281
3443,100,16,134,15,265
3444,114,15,116,18,263
3445,116,35,114,18,283
3447,118,31,117,18,284
3448,102,31,117,18,268
3450,134,33,100,17,284
3451,116,33,100,17,266
3452,101,33,100,17,251
3453,115,33,133,18,299
3454,114,18,133,18,283
3455,117,34,117,15,283
3456,101,34,117,15,267
3458,117,16,115,18,266
3459,118,33,116,17,284
3460,100,33,116,17,266
3461,102,16,116,17,251
3462,133,33,118,16,300
3463,117,33,118,16,284
3464,117,15,118,16,266
3465,115,34,116,18,283
3466,115,18,116,18,267
3467,116,33,101,15,265
3468,116,17,101,15,249
3469,116,34,115,19,284
3470,119,15,115,19,268
3473,118,34,118,14,284
3474,116,18,118,14,266
3475,118,33,118,14,283
3477,130,19,115,17,281
3478,115,19,115,17,266
3479,117,33,115,20,285
3480,101,33,115,20,269
3484,118,14,102,16,250
3485,117,34,118,18,287
3489,117,32,117,17,283
3490,103,32,117,17,269
3491,116,34,117,15,282
3492,102,34,117,15,268
3493,101,18,117,15,251
3494,102,34,114,18,268
3495,120,32,115,17,284
3496,115,17,115,17,264
3498,117,17,114,18,266
3500,117,15,118,15,265
3502,114,18,117,16,265
3505,115,34,133,16,298
3506,114,18,133,16,281
3508,118,15,116,18,267
3509,117,34,115,18,284
3510,117,16,115,18,266
3511,102,16,115,18,251
3513,102,16,116,19,253
3515,115,34,117,15,281
3520,100,35,115,17,267
3524,117,15,118,17,267
3527,100,17,116,17,250
3529,118,33,117,16,284
3530,100,33,117,16,266
3532,101,34,117,17,269
3533,118,32,102,15,267
3534,101,32,102,15,250
3537,116,34,102,17,269
3538,117,16,102,17,252
3541,102,17,133,15,267
3542,102,31,117,16,266
3543,116,36,116,16,284
3545,118,32,115,17,282
3546,102,32,115,17,266
3547,101,15,115,17,248
3550,117,16,102,17,252
3551,116,35,116,16,283
3553,115,32,118,17,282
3554,115,17,118,17,267
3555,115,35,116,16,282
3556,114,19,116,16,265
3557,118,32,117,17,284
3558,102,32,117,17,268
3559,115,33,101,15,264
3560,116,16,101,15,248
3561,117,35,115,18,285
3563,119,32,118,16,285
3564,116,16,118,16,266
3565,115,34,116,16,281
3566,100,34,116,16,266
3567,117,32,119,17,285
3568,101,32,119,17,269
3569,115,35,101,16,267
3570,115,18,101,16,250
3571,117,33,117,17,284
3572,118,16,117,17,268
3573,117,32,117,16,282
3574,116,16,117,16,265
3575,117,36,133,15,301
3576,119,17,133,15,284
3577,119,31,117,17,284
3578,101,31,117,17,266
3579,115,35,134,16,300
3582,117,16,119,16,268
3583,114,36,115,18,283
3584,133,32,117,17,299
3586,102,32,117,17,268
3587,116,35,116,16,283
3588,134,32,118,15,299
3589,119,32,118,15,284
3590,103,32,118,15,268
3594,101,33,115,18,267
3595,118,33,118,17,286
3596,116,16,118,17,267
3597,116,33,102,15,266
3598,118,15,102,15,250
3599,117,34,118,14,283
3600,116,17,118,14,265
3601,117,33,116,17,283
3602,115,18,116,17,266
3603,116,35,114,19,284
3607,116,33,119,16,284
3608,118,14,119,16,267
3609,103,14,119,16,252
3610,116,17,117,18,268
3612,114,19,115,16,264
3613,118,32,115,18,283
3615,115,34,115,17,281
3619,101,18,114,17,250
3620,100,31,117,18,266
3621,115,34,101,15,265
3622,115,18,101,15,249
3624,115,17,119,14,265
3625,116,33,118,17,284
3627,116,35,116,17,284
3629,101,18,116,17,252
3630,101,32,116,18,267
3632,100,33,118,15,266
3633,103,14,118,15,250
3635,118,33,119,13,283
3636,116,17,119,13,265
3637,118,33,116,19,286
3638,116,18,116,19,269
3640,118,15,103,16,252
3641,115,35,118,16,284
3643,117,32,117,19,285
3644,119,13,117,19,268
3645,117,36,114,18,285
3647,118,33,116,15,282
3649,117,33,117,15,282
3650,101,33,117,15,266
3651,115,34,114,19,282
3652,102,34,114,19,269
3655,116,32,135,17,300
3657,114,34,133,19,300
3658,117,15,133,19,284
3660,114,19,117,15,265
3661,119,32,100,18,269
3663,116,34,116,17,283
3664,101,34,116,17,268
3665,116,32,116,19,283
3666,118,15,116,19,268
3667,117,34,116,16,283
3668,117,15,116,16,264
3669,118,34,117,16,285
3670,100,34,117,16,267
3671,103,16,117,16,252
3672,116,17,118,15,266
3676,116,16,118,16,266
3678,117,16,117,17,267
3679,117,33,101,16,267
3680,118,15,101,16,250
3681,118,34,116,15,283
3682,115,18,116,15,264
3683,118,32,116,20,286
3684,102,32,116,20,270
3686,117,17,101,15,250
3688,101,33,118,14,266
3689,118,31,117,17,283
3690,100,31,117,17,265
3691,115,37,114,19,285
3692,116,20,114,19,269
3693,118,30,103,15,266
3696,118,14,117,18,267
3701,118,32,135,15,300
3702,103,32,135,15,285
3703,115,34,101,15,265
3704,101,34,101,15,251
3705,119,33,117,16,285
3707,118,34,116,17,285
3708,115,18,116,17,266
3713,101,16,119,16,252
3714,117,16,118,15,266
3715,117,34,115,17,283
3716,116,17,115,17,265
3717,115,32,116,17,280
3718,116,15,116,17,264
3722,118,15,116,17,266
3723,116,33,117,16,282
3724,115,17,117,16,265
3726,116,17,100,16,249
3727,114,33,119,15,281
3729,114,34,118,16,282
3731,117,33,119,15,284
3733,117,35,116,15,283
3735,118,32,118,16,284
3737,117,34,117,16,284
3739,117,33,116,18,284
3740,101,33,116,18,268
3742,116,15,102,20,253
3743,114,35,117,16,282
3744,118,16,117,16,267
3745,116,33,117,16,282
3746,117,16,117,16,266
3749,117,34,115,17,283
3752,101,32,116,16,265
3756,115,17,116,17,265
3758,115,17,118,15,265
3759,116,32,118,17,283
3760,116,16,118,17,267
3761,115,36,115,16,282
3762,117,18,115,16,266
3763,119,31,119,16,285
3764,102,31,119,16,268
3765,116,34,101,15,266
3766,118,15,101,15,249
3767,117,34,134,17,302
3768,118,17,134,17,286
3769,117,32,119,15,283
3773,116,32,117,16,281
3774,101,32,117,16,266
3778,102,32,117,17,268
3780,115,17,101,18,251
3782,117,16,135,16,284
3783,115,36,115,17,283
3784,115,19,115,17,266
3786,102,32,116,18,268
3788,101,32,117,17,267
3789,102,14,117,17,250
3790,100,35,116,16,267
3792,115,17,117,17,266
3793,117,34,100,14,265
3794,116,18,100,14,248
3795,116,32,116,17,281
3796,102,32,116,17,267
3798,116,16,118,16,266
3799,116,35,117,15,283
3800,117,17,117,15,266
3801,118,33,117,16,284
3802,100,33,117,16,266
3803,118,32,117,17,284
3804,116,17,117,17,267
3805,116,34,118,14,282
3806,100,34,118,14,266
3807,116,33,118,15,282
3808,117,15,118,15,265
3809,118,34,117,15,284
3810,117,16,117,15,265
3812,101,33,117,17,268
3813,116,32,102,18,268
3814,118,14,102,18,252
3815,114,34,116,17,281
3816,118,15,116,17,266
3817,115,33,119,17,284
3821,116,35,132,17,300
3822,102,35,132,17,286
3823,101,17,132,17,267
3825,115,36,133,16,300
3827,118,33,116,15,282
3828,101,33,116,15,265
3830,132,32,117,17,298
3832,102,32,117,17,268
3833,115,35,116,16,282
3834,114,19,116,16,265
3836,116,15,118,15,264
3837,114,33,120,14,281
3838,116,15,120,14,265
3839,114,35,118,15,282
3841,118,33,116,18,285
3843,116,32,102,16,266
3844,101,32,102,16,251
3846,120,14,117,16,267
3847,116,34,118,14,282
3849,101,15,118,14,248
3853,116,31,102,17,266
3854,102,31,102,17,252
3855,114,33,118,18,283
3856,118,14,118,18,268
3857,116,35,115,17,283
3859,117,34,116,15,282
3860,117,16,116,15,264
3861,118,31,118,16,283
3865,119,31,101,17,268
3867,114,33,136,16,299
3868,116,15,136,16,283
3869,114,34,118,15,281
3870,118,16,118,15,267
3871,116,34,119,13,282
3873,118,33,116,18,285
3875,116,35,116,17,284
3876,136,31,102,15,284
3877,118,31,102,15,266
3879,101,15,102,15,233
3880,119,13,117,16,265
3881,102,13,117,16,248
3882,116,18,117,15,266
3884,116,17,116,17,266
3885,117,32,101,16,266
3887,114,32,118,18,282
3888,117,16,118,18,269
3889,116,34,102,14,266
3890,117,15,102,14,248
3891,115,35,117,15,282
3892,116,17,117,15,265
3894,101,33,115,19,268
3895,118,34,115,19,286
3897,117,31,103,14,265
3898,102,31,103,14,250
3899,115,34,117,17,283
3900,117,15,117,17,266
3901,116,35,116,15,282
3902,115,19,116,15,265
3903,118,34,114,19,285
3904,115,19,114,19,267
3905,120,31,119,13,283
3907,115,34,118,16,283
3911,116,36,116,16,284
3912,114,19,116,16,265
3913,119,30,118,18,285
3914,102,30,118,18,268
3915,115,36,116,16,283
3916,118,16,116,16,266
3918,102,34,116,17,269
3919,119,32,117,16,284
3921,115,34,115,17,281
3924,116,16,117,18,267
3925,117,35,117,16,285
3927,117,32,118,16,283
3928,101,32,118,16,267
3929,117,33,101,15,266
3930,115,17,101,15,248
3931,116,35,115,18,284
3932,117,18,115,18,268
3933,117,33,115,18,283
3934,117,16,115,18,266
3935,117,33,117,15,282
3936,101,33,117,15,266
3937,118,33,117,18,286
3939,117,34,115,19,285
3940,115,18,115,19,267
3941,116,33,117,18,284
3942,115,18,117,18,268
3943,116,32,103,14,265
3945,102,15,103,14,234
3946,117,18,116,15,266
3947,119,33,115,16,283
3949,119,34,132,16,301
3950,101,34,132,16,283
3951,118,33,115,17,283
3952,103,33,115,17,268
3953,118,31,101,16,266
3955,102,15,101,16,234
3956,115,16,118,17,266
3957,115,35,116,17,283
3959,118,33,115,18,284
3961,116,33,119,13,281
3962,101,33,119,13,266
3963,100,17,119,13,249
3964,101,34,132,17,284
3965,118,33,116,16,283
3966,116,17,116,16,265
3967,117,33,116,16,282
3969,117,32,119,15,283
3972,115,17,117,17,266
3974,116,16,101,18,251
3976,116,16,118,15,265
3977,113,34,117,18,282
3978,119,15,117,18,269
3979,102,15,117,18,252
3980,117,17,117,17,268
3981,117,34,117,15,283
3982,101,34,117,15,267
3984,102,31,119,16,268
3986,99,36,116,15,266
3987,118,33,117,15,283
3990,117,15,117,17,266
3991,101,15,117,17,250
3994,116,15,118,16,265
3995,115,34,116,18,283
3997,115,34,116,17,282
3999,116,33,118,17,284
4000,116,17,118,17,268
4001,116,33,117,17,283
4002,101,33,117,17,268
4003,115,34,116,18,283
4004,116,18,116,18,268
4005,117,33,117,16,283
4006,100,33,117,16,266
4008,118,17,117,14,266
4009,118,32,116,17,283
4010,102,32,116,17,267
4011,118,34,117,14,283
4013,118,32,116,18,284
4015,115,33,120,15,283
4020,117,14,134,17,282
4021,115,35,116,18,284
4022,116,18,116,18,268
4024,101,34,117,16,268
4026,117,17,117,17,268
4027,116,32,118,16,282
4029,117,35,117,16,285
4031,115,33,116,17,281
4032,117,16,116,17,266
4033,117,34,117,14,282
4035,119,32,116,18,285
4036,102,32,116,18,268
4038,117,16,115,17,265
4040,116,17,117,16,266
4041,116,32,118,17,283
4042,117,14,118,17,266
4043,115,35,116,16,282
4045,116,32,117,20,285
4046,100,32,117,20,269
4047,116,34,103,15,268
4048,117,16,103,15,251
4049,115,34,134,15,298
4050,118,17,134,15,284
4051,118,32,117,18,285
4052,116,16,117,18,267
4053,101,16,117,18,252
4054,117,20,114,17,268
4055,119,31,116,16,282
4056,103,31,116,16,266
4058,134,33,131,18,316
4060,102,33,131,18,284
4061,118,33,132,18,301
4062,114,17,132,18,281
4063,116,32,118,16,282
4064,116,16,118,16,266
4065,116,33,118,17,284
4066,115,16,118,17,266
4068,131,34,117,17,299
4071,116,34,117,16,283
4072,118,16,117,16,267
4076,102,32,117,19,270
4077,116,34,116,19,285
4079,116,33,102,15,266
4081,116,35,133,15,299
4083,117,34,114,18,283
4085,119,33,116,16,284
4086,102,33,116,16,267
4087,118,32,116,18,284
4089,116,34,133,15,298
4093,100,18,115,18,251
4095,117,34,116,18,285
4096,116,18,116,18,268
4097,118,33,116,18,285
4099,118,33,115,19,285
4100,115,18,115,19,267
4101,116,33,118,17,284
4103,117,35,115,16,283
4104,116,18,115,16,265
4105,119,33,116,16,284
4106,101,33,116,16,266
4107,101,18,116,16,251
4108,101,33,115,19,268
4109,116,34,116,16,282
4110,118,17,116,16,267
4111,118,31,118,16,283
4112,115,16,118,16,265
4113,116,34,117,17,284
4115,118,35,114,18,285
4116,115,19,114,18,266
4117,117,32,116,17,282
4118,116,16,116,17,265
4120,101,33,118,15,267
4122,117,17,116,18,268
4123,118,33,117,16,284
4124,99,33,117,16,265
4126,100,33,118,14,265
4127,116,33,134,16,299
4128,100,33,134,16,283
4129,116,35,115,18,284
4130,116,18,115,18,267
4131,101,18,115,18,252
4132,101,32,117,17,267
4133,117,32,102,16,267
4134,118,14,102,16,250
4135,149,34,115,17,315
4136,134,34,115,17,300
4137,117,34,115,17,283
4138,115,18,115,17,265
4141,116,32,101,16,265
4143,116,36,116,15,283
4145,119,31,117,16,283
4147,116,34,117,17,284
4148,117,16,117,17,267
4149,117,33,101,16,267
4150,101,33,101,16,251
4151,116,33,119,17,285
4154,117,16,117,17,267
4155,115,35,132,18,300
4157,118,34,132,16,300
4159,117,34,132,16,299
4160,119,17,132,16,284
4162,103,31,117,17,268
4163,116,33,117,18,284
4164,132,34,118,16,300
4165,116,34,118,16,284
4166,116,16,118,16,266
4167,115,34,115,18,282
4168,114,18,115,18,265
4169,118,33,115,19,285
4170,117,17,115,19,268
4171,115,34,114,17,280
4174,101,33,116,17,267
4175,102,16,116,17,251
4177,117,34,115,16,282
4179,118,31,120,17,286
4180,114,17,120,17,268
4181,114,35,102,16,267
4183,118,34,117,15,284
4184,100,34,117,15,266
4185,119,31,101,16,267
4187,117,37,132,16,302
4190,102,32,116,17,267
4191,103,16,116,17,252
4192,100,32,118,16,266
4194,101,34,117,15,267
4195,115,34,114,17,280
4196,132,33,115,17,297
4197,116,33,115,17,281
4199,116,33,115,19,283
4200,101,33,115,19,268
4203,116,33,117,17,283
4204,114,17,117,17,265
4205,115,34,117,18,284
4206,115,17,117,18,267
4208,115,19,116,17,267
4209,117,31,117,17,282
4210,102,31,117,17,267
4211,102,15,117,17,251
4213,117,35,115,18,285
4214,117,18,115,18,268
4215,119,33,115,18,285
4217,117,32,116,19,284
4218,102,32,116,19,269
4219,117,34,116,18,285
4221,117,34,117,16,284
4222,115,18,117,16,266
4223,117,33,116,17,283
4225,118,34,116,16,284
4226,101,34,116,16,267
4227,119,33,116,18,286
4228,101,33,116,18,268
4229,100,18,116,18,252
4230,117,16,115,17,265
4231,118,33,119,16,286
4232,116,17,119,16,268
4236,116,18,133,17,284
4237,117,31,119,17,284
4239,116,36,115,17,284
4240,119,16,115,17,267
4243,116,35,116,16,283
4244,133,34,131,16,314
4245,119,34,131,16,300
4246,102,34,131,16,283
4247,116,32,115,19,282
4249,101,17,115,19,252
4250,117,17,116,17,267
4251,117,33,116,17,283
4252,116,16,116,17,265
4253,115,33,118,15,281
4254,115,16,118,15,264
4255,116,35,116,15,282
4256,115,19,116,15,265
4257,118,32,118,15,283
4259,116,33,117,18,284
4260,100,33,117,18,268
4262,100,33,118,15,266
4265,116,34,117,17,284
4267,117,35,116,16,284
4268,117,18,116,16,267
4269,117,31,117,18,283
4270,102,31,117,18,268
4271,115,34,116,17,282
4272,118,16,116,17,267
4274,117,17,117,19,270
4276,116,16,103,15,250
4278,101,34,133,18,286
4280,101,32,119,14,266
4281,116,37,114,18,285
4283,119,31,116,17,283
4284,103,31,116,17,267
4286,133,32,118,17,300
4287,118,32,118,17,285
4288,119,14,118,17,268
4289,115,36,116,16,283
4290,114,18,116,16,264
4293,117,32,118,17,284
4295,114,35,115,17,281
4296,118,17,115,17,267
4297,117,33,116,18,284
4298,116,16,116,18,266
4300,117,15,102,17,251
4301,115,35,117,16,283
4303,117,32,117,18,284
4308,102,33,116,16,267
4309,101,16,116,16,249
4311,118,34,117,15,284
4312,101,34,117,15,267
4315,115,33,117,16,281
4316,116,16,117,16,265
4317,115,35,116,18,284
4318,115,19,116,18,268
4320,100,32,102,15,249
4321,103,15,102,15,235
4323,101,16,117,17,251
4324,101,32,119,15,267
4326,116,18,115,16,265
4327,117,33,114,17,281
4328,102,33,114,17,266
4329,117,33,115,19,284
4331,101,17,115,19,252
4332,102,32,102,15,251
4336,114,17,102,17,250
4337,115,36,132,17,300
4338,115,19,132,17,283
4339,117,31,118,17,283
4340,102,31,118,17,268
4342,116,19,117,14,266
4343,119,31,120,16,286
4345,102,14,120,16,252
4347,117,34,115,18,284
4348,118,17,115,18,268
4349,102,17,115,18,252
4350,117,14,117,19,267
4351,114,36,116,17,283
4354,101,33,116,16,266
4357,116,34,114,19,283
4358,102,34,114,19,269
4360,116,17,115,16,264
4361,116,32,117,17,282
4362,116,16,117,17,266
4363,117,33,116,17,283
4364,115,17,116,17,265
4365,117,35,133,15,300
4366,114,19,133,15,281
4367,117,31,117,19,284
4368,115,16,117,19,267
4370,117,17,116,17,267
4371,118,32,118,16,284
4374,133,34,117,15,299
4376,102,34,117,15,268
4379,118,33,118,17,286
4380,101,33,118,17,269
4381,116,33,116,19,284
4382,116,16,116,19,267
4383,117,34,116,18,285
4385,117,33,116,17,283
4386,118,15,116,17,266
4387,116,35,133,15,299
4389,101,17,133,15,266
4390,102,33,115,16,266
4391,116,33,117,17,283
4392,101,33,117,17,268
4394,116,17,102,16,251
4397,119,31,118,18,286
4398,115,16,118,18,267
4400,117,17,117,16,267
4401,119,31,118,16,284
4404,131,36,116,18,301
4405,116,36,116,18,286
4406,100,36,116,18,270
4407,117,33,116,15,281
4408,100,33,116,15,264
4411,116,34,116,17,283
4412,101,34,116,17,268
4413,117,35,115,17,284
4414,116,18,115,17,266
4415,117,30,118,16,281
4417,115,35,116,16,282
4419,116,33,116,17,282
4420,116,17,116,17,266
4421,116,34,116,17,283
4422,115,17,116,17,265
4424,102,32,101,16,251
4425,116,33,118,18,285
4427,116,34,102,16,268
4428,116,17,102,16,251
4429,116,34,135,15,300
4430,116,17,135,15,283
4431,117,33,117,15,282
4432,101,33,117,15,266
4434,101,35,116,17,269
4435,119,32,117,16,284
4437,117,35,114,16,282
4438,135,30,117,17,299
4439,119,30,117,17,283
4442,116,17,116,17,266
4443,117,32,117,15,281
4444,101,32,117,15,265
4445,102,16,117,15,250
4446,114,16,118,16,264
4448,117,17,117,17,268
4449,115,35,134,15,299
4450,116,17,134,15,282
4451,117,31,118,18,284
4452,101,31,118,18,268
4453,101,15,118,18,252
4454,100,34,102,17,253
4455,117,34,117,18,286
4457,116,35,114,17,282
4458,115,19,114,17,265
4460,103,33,117,16,269
4461,118,33,116,17,284
4465,119,31,118,16,284
4467,116,35,115,18,284
4468,117,16,115,18,266
4469,116,33,116,18,283
4470,100,33,116,18,267
4471,117,33,118,16,284
4472,116,16,118,16,266
4473,118,33,116,19,286
4474,101,33,116,19,269
4475,115,34,101,16,266
4477,117,34,116,16,283
4480,118,16,117,15,266
4481,117,34,132,16,299
4482,116,19,132,16,283
4483,119,33,132,18,302
4484,101,33,132,18,284
4485,101,17,132,18,268
4486,116,16,118,16,266
4487,115,33,101,16,265
4488,117,15,101,16,249
4489,117,34,115,18,284
4490,132,33,118,17,300
4491,116,33,118,17,284
4492,115,17,118,17,267
4493,116,34,101,15,266
4495,116,34,134,15,299
4497,101,18,134,15,268
4498,115,18,117,18,268
4499,117,35,115,16,283
4500,100,35,115,16,266
4501,117,33,115,16,281
4502,101,33,115,16,265
4503,118,34,116,14,282
4504,134,33,131,18,316
4505,120,33,131,18,302
4506,117,18,131,18,284
4507,117,31,118,16,282
4508,100,31,118,16,265
4509,116,33,117,18,284
4510,115,16,117,18,266
4512,116,14,117,18,265
4513,115,34,101,16,266
4517,117,34,117,15,283
4518,101,34,117,15,267
4520,102,33,116,17,268
4521,118,35,115,20,288
4522,101,35,115,20,271
4523,118,32,103,14,267
4524,102,32,103,14,251
4525,118,32,117,18,285
4526,117,15,117,18,267
4527,102,15,117,18,252
4528,116,17,116,17,266
4530,115,20,112,18,265
4533,116,34,101,14,265
4536,101,32,135,15,283
4538,112,18,116,19,265
4540,100,35,115,17,267
4542,101,31,118,17,267
4543,117,35,115,16,283
4545,119,34,131,17,301
4546,101,34,131,17,283
4547,120,32,116,18,286
4548,115,17,116,18,266
4549,101,17,116,18,252
4550,101,34,115,16,266
4551,119,31,119,17,286
4552,115,16,119,17,267
4553,116,34,102,16,268
4554,115,16,102,16,249
4555,116,35,133,16,300
4556,116,18,133,16,283
4557,117,31,118,17,283
4559,116,36,115,17,284
4560,100,36,115,17,268
4561,118,33,115,18,284
4562,102,33,115,18,268
4565,118,33,117,16,284
4566,102,33,117,16,268
4567,116,33,117,17,283
4568,115,17,117,17,266
4569,116,34,117,17,284
4571,116,30,118,20,284
4572,118,12,118,20,268
4573,102,12,118,20,252
4574,117,16,117,16,266
4575,117,34,115,17,283
4576,117,17,115,17,266
4577,118,34,116,16,284
4578,117,17,116,16,266
4581,118,31,118,16,283
4582,102,31,118,16,267
4583,100,16,118,16,250
4584,115,17,118,17,267
4585,115,34,117,16,282
4587,118,33,118,15,284
4588,114,17,118,15,264
4589,116,34,117,17,284
4590,118,16,117,17,268
4591,118,34,115,18,285
4593,117,32,116,17,282
4594,101,32,116,17,266
4595,117,33,118,15,283
4596,100,33,118,15,266
4597,115,35,114,17,281
4599,117,33,115,18,283
4601,117,32,117,17,283
4603,115,33,101,17,266
4605,115,33,119,14,281
4606,114,17,119,14,264
4607,116,35,115,18,284
4608,115,18,115,18,266
4609,118,33,116,18,285
4610,117,17,116,18,268
4611,116,33,101,17,267
4612,101,33,101,17,252
4613,102,16,101,17,236
4614,119,14,119,17,269
4615,116,35,117,16,284
4616,115,18,117,16,266
4621,115,35,114,19,283
4623,119,32,101,18,270
4624,101,32,101,18,252
4625,117,34,133,16,300
4628,116,17,117,20,270
4629,115,35,102,12,264
4630,114,19,102,12,247
4631,117,32,117,16,282
4632,101,32,117,16,266
4633,103,14,117,16,250
4634,133,36,115,16,300
4635,118,36,115,16,285
4636,117,20,115,16,268
4638,102,30,101,17,250
4641,115,34,101,17,267
4642,116,17,101,17,251
4644,115,16,134,16,281
4645,119,31,119,16,285
4646,101,31,119,16,267
4647,101,14,119,16,250
4648,116,19,116,16,267
4649,118,34,115,17,284
4650,101,34,115,17,267
4652,115,19,116,15,265
4653,117,32,115,19,283
4654,103,32,115,19,269
4656,116,16,116,17,265
4657,115,34,115,18,282
4658,115,17,115,18,265
4659,118,32,117,18,285
4660,116,15,117,18,266
4662,115,19,117,15,266
4663,117,32,119,13,281
4664,101,32,119,13,265
4666,115,18,117,17,267
4667,116,34,117,16,283
4668,101,34,117,16,268
4669,101,18,117,16,252
4670,117,15,118,15,265
4671,117,32,121,15,285
4673,103,13,121,15,252
4674,117,17,115,18,267
4675,118,33,117,17,285
4676,117,16,117,17,267
4677,116,32,102,16,266
4678,101,32,102,16,251
4679,114,35,132,18,299
4680,121,15,132,18,286
4682,115,18,117,17,267
4683,116,34,116,18,284
4684,117,17,116,18,268
4686,102,32,118,15,267
4687,114,33,118,18,283
4688,132,35,134,14,315
4689,117,35,134,14,300
4690,117,17,134,14,282
4691,117,34,131,18,300
4692,116,18,131,18,283
4694,102,31,118,17,268
4695,102,15,118,17,252
4696,100,36,132,15,283
4697,118,33,114,17,282
4698,101,33,114,17,265
4701,115,35,116,17,283
4702,118,17,116,17,268
4703,117,33,115,19,284
4704,99,33,115,19,266
4705,118,32,117,16,283
4708,117,18,115,18,268
4710,100,33,115,19,267
4711,118,34,114,17,283
4714,102,31,118,19,270
4716,115,18,102,14,249
4718,100,34,133,18,285
4719,119,31,120,15,285
4721,116,37,116,15,284
4723,120,31,100,17,268
4724,102,31,100,17,250
4725,101,17,100,17,235
4726,133,33,117,15,298
4727,119,33,117,15,284
4728,120,15,117,15,267
4729,102,15,117,15,249
4731,117,33,101,16,267
4732,100,33,101,16,250
4733,101,16,101,16,234
4735,116,31,118,15,280
4737,114,35,116,17,282
4741,116,33,118,16,283
4742,131,33,101,18,283
4743,115,33,101,18,267
4745,101,15,101,18,235
4750,101,33,117,18,269
4753,101,15,117,17,250
4754,134,32,116,17,299
4759,117,32,118,14,281
4760,117,17,118,14,266
4761,117,35,115,18,285
4762,117,17,115,18,267
4763,118,31,117,18,284
4766,114,18,116,18,266
4768,118,14,102,17,251
4770,115,18,133,15,281
4771,119,33,115,17,284
4772,102,33,115,17,267
4773,101,18,115,17,251
4774,116,18,116,16,266
4775,116,33,117,16,282
4776,102,33,117,16,268
4777,117,34,115,16,282
4778,133,32,118,17,300
4779,118,32,118,17,285
4780,115,17,118,17,267
4783,115,34,117,16,282
4784,117,16,117,16,266
4785,118,32,117,16,283
4787,116,36,133,17,302
4788,118,17,133,17,285
4789,118,33,117,15,283
4791,117,32,118,15,282
4792,101,32,118,15,266
4793,117,32,119,17,285
4794,101,32,119,17,269
4795,114,36,118,13,281
4796,133,32,119,13,297
4797,118,32,119,13,282
4799,116,33,117,18,284
4804,118,13,118,17,266
4805,114,33,102,16,265
4806,119,13,102,16,250
4808,117,18,116,15,266
4810,100,32,116,16,264
4811,114,34,117,16,281
4814,102,32,119,16,269
4815,116,33,118,17,284
4816,116,15,118,17,266
4818,116,16,119,15,266
4820,117,16,118,15,266
4821,117,34,117,16,284
4823,117,33,116,17,283
4825,118,32,119,16,285
4826,102,32,119,16,269
4827,115,34,118,16,283
4828,118,15,118,16,267
4829,115,34,118,14,281
4831,117,33,118,14,282
4833,116,34,117,14,281
4834,101,34,117,14,266
4835,116,33,118,16,283
4836,118,16,118,16,268
4837,116,32,102,15,265
4838,100,32,102,15,249
4840,118,14,120,15,267
4841,114,33,118,17,282
4842,117,14,118,17,266
4845,116,33,116,16,281
4847,116,33,116,17,282
4849,116,33,117,17,283
4850,102,33,117,17,269
4853,119,31,119,14,283
4855,114,34,116,17,281
4856,116,17,116,17,266
4857,117,34,116,17,284
4859,117,32,101,17,267
4861,116,33,116,18,283
4862,100,33,116,18,267
4864,116,17,119,14,266
4867,118,34,133,16,301
4868,101,34,133,16,284
4870,102,32,117,16,267
4871,117,33,118,15,283
4872,119,14,118,15,266
4873,116,33,118,17,284
4874,117,15,118,17,267
4877,119,32,101,15,267
4881,115,35,115,15,280
4882,118,17,115,15,265
4883,118,33,116,18,285
4884,100,33,116,18,267
4885,117,33,117,17,284
4887,116,33,118,15,282
4888,117,17,118,15,267
4889,116,31,120,17,284
4890,115,15,120,17,267
4892,116,18,115,16,265
4893,119,33,116,18,286
4894,101,33,116,18,268
4895,101,17,116,18,252
4896,101,32,120,13,266
4898,102,35,115,17,269
4899,118,31,118,17,284
4900,115,16,118,17,266
4902,116,18,115,17,266
4903,117,31,119,14,281
4904,102,31,119,14,266
4906,115,17,116,18,266
4907,117,34,118,14,283
4909,117,33,117,16,283
4911,114,32,117,19,282
4912,101,32,117,19,269
4913,102,14,117,19,252
4914,116,18,101,15,250
4915,117,32,117,16,282
4917,116,34,116,19,285
4918,117,16,116,19,268
4919,115,35,114,20,284
4920,101,35,114,20,270
4921,119,31,103,17,270
4922,101,31,103,17,252
4923,114,33,118,16,281
4924,117,16,118,16,267
4925,115,36,116,17,284
4927,119,34,114,16,283
4930,103,31,117,17,268
4931,103,14,117,17,251
4932,118,16,116,19,269
4933,117,35,117,16,285
4934,116,17,117,16,266
4935,119,31,118,17,285
4937,113,35,117,16,281
4939,117,34,115,18,284
4940,101,34,115,18,268
4942,117,16,115,17,265
4943,118,33,115,19,285
4945,100,17,115,19,251
4946,100,33,115,18,266
4949,116,32,116,17,281
4951,116,35,115,18,284
4952,115,19,115,18,267
4954,101,32,116,19,268
4955,117,33,117,18,285
4956,115,17,117,18,267
4957,117,33,119,15,284
4958,116,17,119,15,267
4960,115,18,116,18,267
4962,116,19,114,18,267
4964,102,33,116,19,270
4965,119,32,103,15,269
4966,102,32,103,15,252
4967,102,15,103,15,235
4968,116,18,115,17,266
4969,119,32,117,16,284
4970,114,18,117,16,265
4972,116,19,129,17,281
4973,118,31,115,18,282
4974,103,31,115,18,267
4976,115,17,118,16,266
4977,118,33,117,15,283
4978,117,16,117,15,265
4980,129,35,116,18,298
4981,114,35,116,18,283
4982,115,18,116,18,267
4985,117,31,101,17,266
4987,116,36,133,15,300
4988,100,36,133,15,284
4989,101,18,133,15,267
4992,100,32,117,17,266
4996,133,33,117,16,299
4997,118,33,117,16,284
4998,115,18,117,16,266
4999,117,33,117,18,285
5000,101,33,117,18,269
5001,117,34,117,14,282
5002,100,34,117,14,265
5004,100,32,118,17,267
5006,117,16,101,15,249
5007,117,35,116,16,284
5010,101,30,102,17,250
5011,115,36,115,17,283
5013,117,33,116,17,283
5014,101,33,116,17,267
5018,102,33,116,18,269
5019,116,33,101,16,266
5020,115,17,101,16,249
5021,117,34,117,15,283
5022,116,17,117,15,265
5024,118,14,117,17,266
5025,115,35,115,16,281
5026,116,18,115,16,265
5027,118,35,115,17,285
5029,119,30,102,14,265
5032,117,17,118,16,268
5034,115,16,102,16,249
5035,115,36,133,15,299
5036,115,17,133,15,280
5038,102,31,117,21,271
5039,116,35,103,12,266
5040,118,16,103,12,249
5041,118,33,117,17,285
5042,102,33,117,17,269
5043,116,34,115,16,281
5044,133,36,115,15,299
5045,119,36,115,15,285
5048,103,29,117,16,265
5049,116,35,116,18,285
5050,117,17,116,18,268
5053,116,35,116,18,285
5054,115,15,116,18,264
5055,103,15,116,18,252
5056,101,32,117,18,268
5060,103,33,116,17,269
5061,116,33,116,17,282
5062,101,33,116,17,267
5064,102,33,116,17,268
5065,117,34,115,17,283
5066,115,18,115,17,265
5067,118,33,117,17,285
5068,116,17,117,17,267
5070,116,17,117,15,265
5073,117,33,116,17,283
5076,117,17,115,16,265
5077,118,31,100,16,265
5078,117,15,100,16,248
5079,116,34,119,15,284
5082,100,33,117,16,266
5083,115,33,134,18,300
5084,115,16,134,18,283
5085,115,33,119,16,283
5086,100,33,119,16,268
5087,115,35,116,17,283
5088,119,15,116,17,267
5095,115,33,117,16,281
5096,116,17,117,16,266
5098,101,32,119,16,268
5099,102,14,119,16,251
5102,117,15,119,14,265
5103,101,15,119,14,249
5104,117,16,118,15,266
5105,115,34,116,16,281
5108,101,33,115,19,268
5109,116,32,117,17,282
5110,101,32,117,17,267
5112,118,15,118,16,267
5114,116,16,117,17,266
5115,116,35,116,16,283
5116,115,19,116,16,266
5119,115,34,117,16,282
5120,100,34,117,16,267
5121,117,33,117,17,284
5122,117,17,117,17,268
5123,118,33,117,16,284
5124,116,16,117,16,265
5125,117,31,121,15,284
5126,116,15,121,15,267
5127,113,36,117,17,283
5128,117,16,117,17,267
5129,117,34,116,16,283
5131,117,32,117,16,282
5132,101,32,117,16,266
5137,117,32,102,17,268
5138,100,32,102,17,251
5139,116,33,117,18,284
5140,117,16,117,18,268
5141,114,35,117,17,283
5144,115,19,116,16,266
5145,118,31,117,18,284
5146,102,31,117,18,268
5148,117,18,132,17,284
5149,117,34,115,17,283
5150,100,34,115,17,266
5151,102,17,115,17,251
5152,116,16,117,17,266
5153,115,34,117,15,281
5154,101,34,117,15,267
5157,115,34,116,16,281
5158,115,17,116,16,264
5159,116,34,114,19,283
5160,117,17,114,19,267
5161,118,32,118,17,285
5162,100,32,118,17,267
5163,116,34,117,17,284
5164,119,15,117,17,268
5165,117,32,117,18,284
5167,115,35,116,17,283
5168,114,19,116,17,266
5169,116,34,117,15,282
5172,101,33,117,16,267
5176,100,33,118,16,267
5177,116,33,118,15,282
5178,117,15,118,15,265
5179,116,34,117,16,283
5181,118,34,116,17,285
5182,100,34,116,17,267
5183,118,33,115,17,283
5184,118,16,115,17,266
5185,116,32,117,17,282
5187,115,34,118,15,282
5188,117,16,118,15,266
5190,116,17,116,19,268
5191,116,32,103,13,264
5192,100,32,103,13,248
5193,115,34,116,17,282
5196,100,33,119,15,267
5197,116,36,116,15,283
5198,116,19,116,15,266
5199,120,33,132,18,303
5201,119,31,119,15,284
5202,102,31,119,15,267
5203,115,34,118,14,281
5205,117,33,116,17,283
5206,116,15,116,17,264
5207,103,15,116,17,251
5208,132,33,116,16,297
5209,118,33,116,16,283
5210,101,33,116,16,266
5211,115,32,119,15,281
5212,118,14,119,15,266
5215,113,34,116,18,281
5218,116,16,117,19,268
5219,114,34,102,15,265
5220,119,15,102,15,251
5221,117,35,115,16,283
5222,117,18,115,16,266
5223,119,33,115,16,283
5224,101,33,115,16,265
5225,118,34,114,19,285
5227,117,32,101,17,267
5230,115,16,117,18,266
5232,115,16,119,16,266
5233,116,36,116,16,284
5237,118,33,116,17,284
5239,118,33,117,17,285
5240,102,33,117,17,269
5241,118,33,118,15,284
5242,116,16,118,15,265
5244,114,18,116,18,266
5245,117,34,100,16,267
5246,116,17,100,16,249
5247,116,34,134,16,300
5248,100,34,134,16,284
5249,117,32,118,15,282
5251,118,34,118,15,285
5252,116,18,118,15,267
5253,117,35,115,17,284
5254,100,35,115,17,267
5256,116,18,116,15,265
5257,117,31,117,16,281
5258,102,31,117,16,266
5259,102,15,117,16,250
5260,118,15,117,17,267
5261,117,34,117,15,283
5262,115,17,117,15,264
5263,117,32,117,17,283
5266,117,16,119,16,268
5267,114,35,116,18,283
5268,117,17,116,18,268
5269,117,32,117,18,284
5271,115,34,117,17,283
5272,100,34,117,17,268
5273,100,17,117,17,251
5274,119,16,115,19,269
5275,117,34,114,18,283
5279,118,33,117,16,284
5280,101,33,117,16,267
5281,116,34,116,16,282
5285,117,34,117,15,283
5286,117,16,117,15,265
5287,117,33,115,17,282
5288,100,33,115,17,265
5289,118,33,116,18,285
5291,102,16,116,18,252
5292,100,34,117,16,267
5293,116,32,117,17,282
5295,115,33,118,16,282
5297,115,35,116,17,283
5298,116,18,116,17,267
5299,116,33,118,15,282
5302,117,17,119,16,269
5303,118,33,102,15,268
5304,101,33,102,15,251
5305,117,34,116,19,286
5306,116,17,116,19,268
5307,116,33,102,16,267
5308,118,15,102,16,251
5314,116,19,115,16,266
5315,117,31,118,17,283
5316,102,31,118,17,268
5317,114,33,119,15,281
5318,131,35,117,17,300
5319,116,35,117,17,285
5321,118,32,118,17,285
5322,115,16,118,17,266
5323,115,35,114,18,282
5324,100,35,114,18,267
5325,118,32,120,14,284
5327,115,35,116,15,281
5329,118,33,116,17,284
5331,117,32,117,16,282
5332,114,18,117,16,265
5333,115,34,117,18,284
5334,100,34,117,18,269
5338,116,17,117,14,264
5339,119,32,118,16,285
5340,101,32,118,16,267
5342,117,18,131,16,282
5343,118,30,117,18,283
5345,115,33,102,15,265
5346,117,14,102,15,248
5347,115,35,117,16,283
5349,116,33,116,19,284
5350,131,34,117,16,298
5351,115,34,117,16,282
5353,116,34,116,16,282
5354,102,34,116,16,268
5355,133,16,117,17,283
5356,117,16,117,17,267
5357,116,35,114,19,284
5358,116,19,114,19,268
5359,119,32,117,18,286
5360,101,32,117,18,268
5361,118,33,102,15,268
5362,116,16,102,15,249
5363,116,34,133,17,300
5365,118,34,134,15,301
5367,117,34,115,17,283
5368,101,34,115,17,267
5369,118,31,101,16,266
5370,102,31,101,16,250
5371,116,34,116,17,283
5373,118,35,116,15,284
5374,116,18,116,15,265
5375,118,32,116,17,283
5376,115,17,116,17,265
5378,101,33,116,17,267
5380,116,17,117,15,265
5381,116,33,116,17,282
5383,116,34,117,16,283
5384,116,17,117,16,266
5385,117,33,118,15,283
5387,117,32,118,17,284
5388,117,15,118,17,267
5390,116,17,101,16,250
5391,116,34,116,16,282
5394,100,33,118,16,267
5395,116,34,117,16,283
5397,118,34,116,17,285
5399,117,31,119,15,282
5401,114,35,116,18,283
5403,117,33,117,17,284
5406,116,17,116,17,266
5407,118,32,120,13,283
5408,102,32,120,13,267
5409,115,35,117,18,285
5412,101,33,102,15,251
5413,117,33,118,16,284
5414,116,17,118,16,267
5415,116,32,102,16,266
5416,101,32,102,16,251
5417,103,13,102,16,234
5418,117,18,115,17,267
5421,117,34,117,16,284
5422,100,34,117,16,267
5423,115,31,102,16,264
5424,102,31,102,16,251
5427,117,31,117,17,282
5428,101,31,117,17,266
5429,114,35,117,15,281
5432,102,33,116,17,268
5433,116,35,116,16,283
5434,134,31,118,16,299
5435,118,31,118,16,283
5437,115,33,116,19,283
5438,117,15,116,19,267
5439,116,34,116,19,285
5440,116,17,116,19,268
5441,117,34,115,19,285
5443,118,33,116,17,284
5444,101,33,116,17,267
5446,116,19,116,18,269
5447,118,34,115,17,284
5448,116,19,115,17,267
5449,117,33,115,17,282
5450,115,19,115,17,266
5451,117,32,117,18,284
5452,101,32,117,18,268
5453,101,17,117,18,253
5454,116,18,100,14,248
5455,119,32,132,19,302
5456,115,17,132,19,283
5457,118,33,118,15,284
5458,115,17,118,15,265
5459,117,35,115,17,284
5460,100,35,115,17,267
5461,118,32,118,15,283
5462,100,32,118,15,265
5463,99,18,118,15,250
5464,132,34,117,18,301
5465,116,34,117,18,285
5466,118,15,117,18,268
5468,115,17,116,16,264
5469,118,33,117,15,283
5470,100,33,117,15,265
5471,117,34,116,16,283
5472,101,34,116,16,267
5475,118,31,103,15,267
5476,116,16,103,15,250
5477,114,33,118,17,282
5478,117,15,118,17,267
5479,115,34,116,18,283
5480,116,16,116,18,266
5482,115,19,131,18,283
5483,100,19,131,18,268
5484,103,32,117,16,268
5485,117,33,116,18,284
5487,117,33,116,18,284
5489,117,33,117,17,284
5490,115,16,117,17,265
5491,116,34,116,18,284
5492,117,16,116,18,267
5493,117,34,115,19,285
5494,100,34,115,19,268
5495,119,33,115,17,284
5497,117,33,116,19,285
5498,101,33,116,19,269
5500,116,18,101,18,253
5502,115,19,131,19,284
5503,119,31,119,15,284
5504,101,31,119,15,266
5505,116,36,114,18,284
5506,116,19,114,18,267
5507,119,33,114,17,283
5508,101,33,114,17,265
5511,117,34,116,17,284
5512,119,15,116,17,267
5513,102,15,116,17,250
5514,114,18,133,17,282
5518,100,35,115,19,269
5519,116,32,116,18,282
5520,101,32,116,18,267
5522,116,17,115,19,267
5523,118,35,114,16,283
5524,118,18,114,16,266
5526,101,33,116,16,266
5531,117,31,119,15,282
5533,116,35,115,19,285
5534,116,16,115,19,266
5535,118,35,116,16,285
5536,100,35,116,16,267
5537,103,17,116,16,252
5538,101,32,100,17,250
5539,118,32,121,14,285
5540,102,32,121,14,269
5541,115,35,117,15,282
5543,116,33,117,15,281
5544,116,16,117,15,264
5547,117,33,133,15,298
5548,102,33,133,15,283
5551,115,33,118,16,282
5553,115,33,118,17,283
5555,112,35,117,16,280
5556,117,16,117,16,266
5557,116,33,117,16,282
5558,101,33,117,16,267
5559,116,33,116,18,283
5560,101,33,116,18,268
5561,116,34,100,17,267
5562,118,17,100,17,252
5563,116,33,116,18,283
5564,117,16,116,18,267
5567,116,34,134,15,299
5568,100,34,134,15,283
5570,100,33,116,18,267
5572,116,18,116,16,266
5573,117,31,119,15,282
5575,116,36,115,16,283
5576,134,33,114,19,300
5579,100,18,114,19,251
5580,116,16,116,20,268
5581,116,33,117,16,282
5582,101,33,117,16,267
5583,116,33,134,18,301
5584,115,16,134,18,283
5592,119,15,101,17,252
5594,117,15,117,17,266
5595,102,15,117,17,251
5596,114,16,117,19,266
5598,100,35,116,17,268
5599,116,33,115,19,283
5600,101,33,115,19,268
5601,116,33,117,18,284
5602,101,33,117,18,269
5603,117,35,115,16,283
5604,101,35,115,16,267
5605,119,32,118,16,285
5609,118,34,115,17,284
5610,117,18,115,17,267
5611,101,18,115,17,251
5613,116,35,116,19,286
5614,118,16,116,19,269
5615,119,32,103,15,269
5616,117,15,103,15,250
5617,101,15,103,15,234
5618,115,17,116,17,265
5619,117,32,101,19,269
5620,101,32,101,19,253
5621,114,37,130,17,298
5622,116,19,130,17,282
5623,118,31,116,17,282
5625,117,33,116,18,284
5626,116,17,116,18,267
5627,116,35,114,18,283
5628,101,35,114,18,268
5629,118,31,119,15,283
5630,130,34,117,15,296
5631,115,34,117,15,281
5632,116,17,117,15,265
5633,117,34,115,17,283
5634,116,18,115,17,266
5635,115,33,116,18,282
5637,117,33,117,17,284
5638,101,33,117,17,268
5639,117,32,119,16,284
5640,100,32,119,16,267
5641,116,34,119,14,283
5642,115,17,119,14,265
5643,117,35,117,15,284
5644,116,18,117,15,266
5645,116,33,115,19,283
5646,117,17,115,19,268
5647,117,33,101,15,266
5648,102,33,101,15,251
5650,101,32,117,17,267
5651,116,34,117,17,284
5652,117,15,117,17,266
5653,116,35,119,13,283
5654,115,19,119,13,266
5655,117,33,115,19,284
5656,101,33,115,19,268
5659,115,34,134,16,299
5661,118,33,117,17,285
5663,104,13,117,17,251
5664,115,19,115,18,267
5666,102,31,117,18,268
5667,101,15,117,18,251
5668,117,17,116,17,267
5669,130,17,115,18,280
5671,101,17,115,18,251
5673,117,33,116,16,282
5674,102,33,116,16,267
5675,117,33,117,16,283
5677,117,33,117,15,282
5678,115,18,117,15,265
5679,117,33,117,19,286
5680,115,17,117,19,268
5682,116,16,103,13,248
5684,117,16,117,15,265
5686,100,32,100,16,248
5687,116,37,115,17,285
5689,119,31,101,17,268
5690,103,31,101,17,252
5691,116,32,136,14,298
5692,117,15,136,14,282
5693,115,34,116,17,282
5695,116,35,116,16,283
5697,119,31,117,18,285
5698,101,31,117,18,267
5700,136,31,117,18,302
5701,120,31,117,18,286
5702,116,17,117,18,268
5703,115,34,118,17,284
5706,101,34,115,18,268
5707,118,33,117,16,284
5708,114,18,117,16,265
5710,101,34,116,17,268
5711,117,34,117,15,283
5712,118,17,117,15,267
5715,118,33,118,16,285
5716,100,33,118,16,267
5717,117,34,115,18,284
5718,116,17,115,18,266
5721,118,33,116,18,285
5723,116,34,115,18,283
5724,100,34,115,18,267
5726,115,18,118,17,268
5727,115,32,103,14,264
5728,100,32,103,14,249
5730,116,18,133,17,284
5731,116,33,117,17,283
5733,118,35,115,16,284
5734,118,17,115,16,266
5736,103,31,117,17,268
5737,117,34,116,18,285
5739,118,34,116,17,285
5741,116,32,116,18,282
5742,115,16,116,18,265
5743,117,34,117,16,284
5744,117,17,117,16,267
5745,118,34,116,15,283
5747,117,33,117,15,282
5748,116,17,117,15,265
5749,117,33,118,14,282
5750,101,33,118,14,266
5751,117,33,116,18,284
5752,117,16,116,18,267
5753,117,32,117,17,283
5754,116,15,117,17,265
5755,115,34,117,18,284
5758,118,14,118,16,266
5759,115,35,115,18,283
5760,116,18,115,18,267
5761,117,32,101,16,266
5762,102,32,101,16,251
5763,115,35,134,16,300
5765,116,32,118,16,282
5766,102,32,118,16,268
5767,117,34,117,17,285
5769,118,33,117,17,285
5770,101,33,117,17,268
5771,100,17,117,17,251
5772,134,32,117,17,300
5773,118,32,117,17,284
5774,118,16,117,17,268
5775,118,34,115,17,284
5776,117,17,115,17,266
5777,118,33,116,18,285
5778,101,33,116,18,268
5779,116,34,116,15,281
5781,117,33,117,16,283
5782,117,17,117,16,267
5783,117,32,101,16,266
5784,115,17,101,16,249
5785,116,35,115,17,283
5786,116,18,115,17,266
5788,116,15,117,18,266
5789,115,35,116,18,284
5790,117,16,116,18,267
5791,118,32,102,15,267
5793,116,34,134,15,299
5794,115,17,134,15,281
5795,116,34,115,19,284
5796,101,34,115,19,269
5797,116,34,117,15,282
5798,116,18,117,15,266
5799,118,33,117,14,282
5803,118,34,117,16,285
5804,115,19,117,16,267
5805,118,32,101,18,269
5806,117,15,101,18,251
5807,117,32,117,18,284
5809,117,37,114,16,284
5813,116,33,117,16,282
5814,101,33,117,16,267
5815,101,15,117,16,249
5816,102,33,116,20,271
5817,115,32,104,14,265
5819,114,35,132,18,299
5820,116,17,132,18,283
5821,115,33,117,17,282
5825,120,30,118,17,285
5826,104,30,118,17,269
5827,116,33,119,16,284
5828,132,35,117,16,300
5832,115,15,118,15,263
5833,116,35,115,16,282
5834,100,35,115,16,266
5835,118,33,115,19,285
5836,119,16,115,19,269
5838,117,16,117,16,266
5840,101,32,118,16,267
5841,115,33,119,15,282
5842,115,16,119,15,265
5844,115,19,116,16,266
5847,116,33,118,16,283
5848,101,33,118,16,268
5849,117,33,116,19,285
5850,119,15,116,19,269
5852,116,16,101,15,248
5853,116,35,133,16,300
5854,115,20,133,16,284
5855,118,32,117,17,284
5856,102,32,117,17,268
5857,116,34,116,17,283
5859,117,31,102,16,266
5860,101,31,102,16,250
5862,133,33,115,17,298
5863,117,33,115,17,282
5864,101,33,115,17,266
5865,102,17,115,17,251
5866,116,17,117,14,264
5867,118,34,115,17,284
5868,102,34,115,17,268
5869,118,31,118,15,282
5870,116,15,118,15,264
5871,115,34,117,18,284
5872,115,17,117,18,267
5873,116,32,118,16,282
5874,117,14,118,16,265
5875,115,35,116,18,284
5876,115,17,116,18,266
5877,116,32,118,16,282
5880,117,18,115,17,267
5881,117,31,116,19,283
5882,103,31,116,19,269
5884,116,18,115,17,266
5885,117,32,100,16,265
5887,116,34,133,18,301
5888,115,17,133,18,283
5890,101,34,117,16,268
5892,115,17,118,15,265
5895,117,33,118,17,285
5896,133,34,115,18,300
5897,118,34,115,18,285
5898,117,16,115,18,266
5899,102,16,115,18,251
5900,101,32,118,16,267
5901,117,33,117,17,284
5902,118,14,117,17,266
5903,112,36,114,17,279
5904,118,17,114,17,266
5906,101,32,116,19,268
5908,118,16,102,16,252
5909,115,33,133,18,299
5910,117,17,133,18,285
5911,115,33,118,17,283
5915,118,31,116,18,283
5916,102,31,116,18,267
5917,102,15,116,18,251
5918,133,35,115,17,300
5919,117,35,115,17,284
5920,118,17,115,17,267
5921,101,17,115,17,250
5922,114,19,131,17,281
5923,117,32,116,17,282
5924,116,18,116,17,267
5925,117,34,115,16,282
5927,117,32,116,19,284
5928,115,17,116,19,267
5930,116,15,102,17,250
5931,117,34,117,15,283
5932,116,17,117,15,265
5934,115,16,119,16,266
5935,116,36,116,16,284
5937,117,33,115,19,284
5939,102,16,115,19,252
5941,116,35,118,15,284
5942,100,35,118,15,268
5943,118,33,116,18,285
5944,116,16,116,18,266
5945,115,35,116,15,281
5946,115,19,116,15,265
5947,118,32,117,16,283
5948,103,32,117,16,268
5949,100,16,117,16,249
5950,118,15,116,18,267
5951,116,34,116,19,285
5953,118,32,103,16,269
5954,116,15,103,16,250
5955,115,34,116,16,281
5956,117,16,116,16,265
5958,116,18,116,17,267
5960,100,35,114,18,267
5962,103,31,116,17,267
5963,101,15,116,17,249
5965,116,35,116,18,285
5966,116,17,116,18,267
5967,117,34,117,16,284
5970,101,32,101,17,251
5971,117,35,132,16,300
5972,101,35,132,16,284
5973,118,33,134,16,301
5974,101,33,134,16,284
5975,118,33,117,18,286
5977,102,16,117,18,253
5978,101,33,102,14,250
5979,116,33,117,18,284
5980,132,35,100,14,281
5981,117,35,100,14,266
5982,115,19,100,14,248
5983,117,34,131,17,299
5984,117,18,131,17,283
5988,117,18,117,16,268
5990,100,32,116,17,265
5991,116,33,117,18,284
5992,131,35,115,16,297
5995,118,33,117,14,282
5998,101,32,117,16,266
