序号,发送->接收,接收->转发,转发->接收,接收->处理,总计
1,109,33,103,30,275
2,107,32,101,20,260
3,102,32,101,20,255
5,116,18,134,16,284
6,118,36,114,18,286
7,116,20,114,18,268
9,103,30,102,16,251
11,101,20,114,16,251
12,104,48,123,26,301
13,134,34,130,18,316
14,118,34,130,18,300
15,114,18,130,18,280
16,117,32,116,16,281
17,102,32,116,16,266
18,114,32,118,17,281
19,116,16,118,17,267
22,107,41,111,23,282
23,115,15,111,23,264
24,114,34,118,16,282
25,116,16,118,16,266
26,116,35,351,10,512
27,118,17,351,10,496
30,126,23,286,10,445
33,118,16,252,10,396
34,116,252,125,16,509
35,351,10,115,16,492
37,309,10,115,16,450
39,286,10,115,16,427
40,268,10,115,16,409
43,109,32,117,16,274
44,115,16,117,16,264
45,113,32,119,17,281
46,116,16,119,17,268
47,114,34,116,18,282
49,116,33,117,17,283
51,133,16,115,17,281
52,117,16,115,17,265
53,117,35,134,14,300
54,101,35,134,14,284
56,102,32,116,17,267
58,117,17,115,19,268
60,115,17,117,17,266
61,114,37,114,17,282
62,134,31,117,15,297
63,120,31,117,15,283
64,116,17,117,15,265
65,117,34,116,17,284
67,119,32,116,17,284
68,102,32,116,17,267
69,117,34,116,16,283
70,114,17,116,16,263
71,117,32,117,18,284
72,117,15,117,18,267
73,117,35,115,17,284
75,118,32,116,18,284
76,101,32,116,18,267
77,116,33,117,17,283
79,115,35,115,18,283
81,117,32,101,16,266
82,115,17,101,16,249
83,117,34,132,17,300
84,116,18,132,17,283
88,115,18,115,19,267
89,118,33,101,17,269
90,101,33,101,17,252
92,132,34,101,16,283
93,116,34,101,16,267
94,116,17,101,16,250
96,115,19,131,17,282
97,118,33,133,15,299
98,101,33,133,15,282
100,119,16,115,19,269
101,118,32,117,17,284
102,101,32,117,17,267
103,117,33,117,16,283
104,131,35,117,16,299
105,114,35,117,16,282
106,115,18,117,16,266
108,115,19,116,15,265
109,118,32,118,14,282
111,116,32,117,16,281
112,117,16,117,16,266
113,116,35,116,16,283
114,117,16,116,16,265
115,118,32,117,18,285
116,116,15,117,18,266
117,116,33,117,17,283
118,118,14,117,17,266
120,117,16,118,17,268
122,116,16,119,15,266
124,117,18,115,17,267
125,116,32,117,18,283
126,102,32,117,18,269
128,101,34,116,18,269
129,117,33,117,17,284
130,119,15,117,17,268
131,117,33,117,18,285
132,115,17,117,18,267
134,117,18,117,16,268
135,118,33,116,17,284
136,116,18,116,17,267
138,101,33,115,18,267
140,101,34,116,15,266
142,100,33,115,18,266
143,102,16,115,18,251
144,116,17,116,16,265
146,115,18,116,17,266
148,116,15,119,16,266
149,114,35,117,17,283
151,117,32,117,16,282
152,116,16,117,16,265
153,117,34,117,17,285
154,116,17,117,17,267
157,118,34,115,17,284
158,100,34,115,17,266
159,118,31,117,18,284
160,117,16,117,18,268
161,116,35,117,15,283
162,117,17,117,15,266
163,116,33,118,15,282
164,117,16,118,15,266
165,116,33,118,16,283
166,115,17,118,16,266
168,117,18,116,16,267
169,117,32,119,16,284
170,117,15,119,16,267
171,115,34,116,17,282
172,118,15,116,17,266
173,117,34,117,16,284
174,118,16,117,16,267
175,118,32,118,16,284
177,115,35,117,15,282
178,119,16,117,15,267
180,101,32,117,17,267
181,115,34,116,16,281
182,117,16,116,16,265
183,117,33,118,15,283
184,101,33,118,15,267
185,115,33,117,16,281
188,117,17,116,18,268
189,116,32,119,15,282
192,118,15,117,18,268
193,115,33,117,16,281
195,116,35,116,17,284
196,99,35,116,17,267
197,118,32,101,17,268
198,102,32,101,17,252
199,115,35,131,18,299
200,117,18,131,18,284
203,116,35,133,16,300
204,116,17,133,16,282
205,116,33,116,18,283
206,101,33,116,18,268
207,101,16,116,18,251
208,131,35,117,17,300
209,116,35,117,17,285
210,118,17,117,17,269
212,116,17,117,16,266
213,116,34,115,17,282
215,117,33,116,18,284
216,102,33,116,18,269
217,117,34,117,16,284
218,117,17,117,16,267
220,117,16,116,17,266
221,117,33,118,16,284
225,117,33,115,18,283
226,117,16,115,18,266
228,101,32,117,16,266
229,117,34,116,18,285
230,118,16,116,18,268
231,117,33,118,17,285
232,116,16,118,17,267
233,115,34,116,16,281
234,115,18,116,16,265
236,117,16,117,17,267
237,115,35,133,15,298
238,116,18,133,15,282
239,117,34,114,19,284
240,118,17,114,19,268
242,116,16,102,16,250
243,116,34,116,17,283
245,117,34,116,16,283
246,133,34,115,17,299
248,114,19,115,17,265
249,118,32,117,17,284
250,102,32,117,17,268
252,116,17,101,16,250
253,115,33,118,17,283
258,117,17,117,17,268
259,118,33,116,18,285
260,101,33,116,18,268
261,117,34,115,18,284
262,118,17,115,18,268
265,116,35,116,17,284
266,117,17,116,17,267
267,118,33,117,16,284
268,101,33,117,16,267
269,117,33,116,17,283
270,115,18,116,17,266
271,118,33,116,18,285
272,101,33,116,18,268
274,116,17,117,16,266
275,118,33,117,17,285
276,117,16,117,17,267
277,118,33,116,17,284
279,117,34,115,18,284
281,117,33,116,17,283
283,133,17,116,17,283
284,117,17,116,17,267
287,117,34,120,14,285
288,115,18,120,14,267
289,116,33,101,15,265
290,116,17,101,15,249
292,116,17,133,17,283
293,118,33,117,17,285
294,116,18,117,17,268
297,118,32,117,17,284
298,101,32,117,17,267
299,116,34,118,15,283
300,133,34,116,16,299
301,118,34,116,16,284
302,117,17,116,16,266
304,116,16,117,16,265
307,116,33,116,17,282
309,116,33,118,16,283
311,116,33,118,17,284
312,117,16,118,17,268
313,116,33,102,17,268
314,115,17,102,17,251
315,114,34,118,12,278
316,116,17,118,12,263
317,116,34,134,16,300
318,118,16,134,16,284
319,117,34,132,17,300
321,119,31,118,17,285
322,102,31,118,17,268
324,118,12,104,15,249
325,112,38,116,17,283
327,117,32,116,18,283
329,115,34,117,16,282
330,101,34,117,16,268
332,104,33,117,15,269
334,116,17,115,17,265
335,117,33,117,16,283
336,116,18,117,16,267
337,117,33,116,17,283
338,117,16,116,17,266
339,118,32,119,15,284
341,115,34,118,16,283
342,115,17,118,16,266
343,117,34,115,19,285
345,116,33,117,16,282
346,116,17,117,16,266
347,116,33,117,18,284
348,119,15,117,18,269
350,118,16,116,18,268
351,116,34,116,17,283
353,118,32,101,17,268
354,117,16,101,17,251
355,115,35,133,15,298
356,117,18,133,15,283
357,117,33,115,19,284
360,116,17,117,16,266
361,117,33,116,18,284
362,101,33,116,18,268
365,118,34,114,18,284
367,118,32,117,16,283
369,116,34,116,16,282
370,116,18,116,16,266
371,118,33,116,16,283
373,118,33,116,17,284
375,116,33,117,18,284
377,117,33,116,18,284
378,116,16,116,18,266
379,115,33,118,16,282
380,116,16,118,16,266
381,101,16,118,16,251
384,117,18,114,18,267
386,116,18,117,18,269
389,117,33,118,17,285
390,117,16,118,17,268
391,116,34,117,15,282
392,114,18,117,15,264
393,118,35,115,18,286
394,117,18,115,18,268
395,118,31,117,17,283
396,102,31,117,17,267
397,116,35,116,17,284
399,119,31,118,16,284
400,117,15,118,16,266
401,115,36,115,17,283
402,115,18,115,17,265
403,119,32,117,17,285
404,102,32,117,17,268
406,116,17,115,18,266
407,117,32,118,16,283
408,102,32,118,16,268
409,116,34,116,17,283
410,115,17,116,17,265
413,117,33,116,16,282
414,115,18,116,16,265
415,117,33,117,17,284
416,118,16,117,17,268
417,117,33,118,17,285
419,116,33,119,16,284
420,116,16,119,16,267
421,117,33,118,16,284
424,117,17,116,16,266
425,118,34,129,19,300
426,101,34,129,19,283
427,118,33,115,17,283
428,102,33,115,17,267
429,118,32,118,15,283
430,118,16,118,15,267
431,116,33,117,17,283
432,116,16,117,17,266
434,129,36,117,17,299
435,131,17,117,17,282
436,115,17,117,17,266
437,116,33,116,19,284
438,118,15,116,19,268
439,116,34,116,17,283
440,100,34,116,17,267
442,119,17,117,16,269
443,117,34,117,17,285
444,100,34,117,17,268
445,116,34,115,17,282
447,118,32,117,17,284
448,116,17,117,17,267
449,117,33,117,17,284
450,117,16,117,17,267
451,116,35,115,17,283
452,117,17,115,17,266
453,119,32,118,17,286
454,115,17,118,17,267
458,101,33,116,18,268
459,116,33,116,18,283
460,115,17,116,18,266
461,117,35,115,16,283
463,118,32,116,17,283
464,116,17,116,17,266
465,117,34,116,16,283
466,116,18,116,16,266
467,118,33,117,17,285
468,116,18,117,17,268
469,116,32,117,17,282
472,116,17,118,16,267
473,117,33,117,16,283
474,116,16,117,16,265
475,117,35,115,16,283
476,117,17,115,16,265
478,102,32,116,18,268
481,117,32,118,16,283
483,115,33,118,17,283
485,116,35,115,18,284
486,116,18,115,18,267
487,116,32,118,17,283
488,117,15,118,17,267
489,116,34,117,17,284
490,118,16,117,17,268
491,117,34,117,17,285
492,101,34,117,17,269
493,118,33,118,14,283
494,115,18,118,14,265
495,116,34,116,18,284
496,118,17,116,18,269
498,117,17,116,17,267
499,117,34,115,18,284
500,117,17,115,18,267
501,119,31,118,17,285
502,118,14,118,17,267
503,115,36,115,17,283
504,116,18,115,17,266
505,118,32,117,16,283
507,116,34,117,15,282
508,115,18,117,15,265
509,116,33,117,16,282
511,117,33,117,16,283
514,117,16,100,18,251
515,117,33,117,16,283
517,116,34,116,17,283
518,117,16,116,17,266
524,117,16,101,16,250
525,115,34,133,17,299
526,116,17,133,17,283
527,116,34,116,17,283
529,116,33,116,17,282
530,117,16,116,17,266
531,117,33,117,16,283
533,117,33,117,17,284
534,117,16,117,17,267
535,132,17,117,16,282
536,116,17,117,16,266
537,116,33,118,17,284
538,116,17,118,17,268
540,117,16,117,17,267
541,116,34,116,17,283
542,117,17,116,17,267
544,117,16,117,17,267
545,117,35,132,16,300
546,118,17,132,16,283
547,118,32,116,18,284
549,117,33,116,17,283
551,116,34,116,17,283
552,117,17,116,17,267
554,132,34,116,16,298
556,116,18,116,16,266
557,118,32,117,17,284
559,116,34,117,16,283
560,116,17,117,16,266
561,116,33,117,17,283
562,117,16,117,17,267
563,117,33,118,16,284
566,117,17,116,17,267
567,117,33,118,16,284
568,117,16,118,16,267
570,117,17,117,16,267
571,117,33,117,17,284
572,118,16,117,17,268
573,117,33,118,17,285
575,116,34,117,17,284
576,118,16,117,17,268
577,117,33,116,18,284
578,117,16,116,18,267
579,116,34,115,17,282
580,117,17,115,17,266
581,118,34,116,16,284
583,117,33,116,17,283
584,101,33,116,17,267
586,116,18,116,16,266
588,115,17,117,16,265
589,115,34,116,18,283
592,116,17,115,18,266
593,118,32,117,16,283
594,116,16,117,16,265
595,117,33,118,16,284
597,115,35,116,17,283
598,116,18,116,17,267
599,117,33,118,14,282
600,100,33,118,14,265
601,117,32,117,17,283
602,117,16,117,17,267
603,116,34,117,16,283
604,118,16,117,16,267
606,116,17,115,19,267
607,118,32,119,15,284
608,118,14,119,15,266
609,116,34,117,16,283
613,116,35,115,18,284
615,116,32,116,17,281
616,119,15,116,17,267
617,117,33,116,18,284
618,117,16,116,18,267
621,117,35,132,17,301
624,116,17,117,17,267
625,116,34,116,16,282
626,116,18,116,16,266
627,117,33,117,17,284
628,101,33,117,17,268
629,117,33,101,17,268
630,132,34,117,16,299
631,117,34,117,16,284
633,118,32,118,17,285
634,116,16,118,17,267
637,117,33,116,16,282
638,101,33,116,16,266
640,117,16,116,18,267
641,117,34,117,17,285
643,117,32,118,17,284
644,116,16,118,17,267
645,115,33,119,16,283
648,116,18,115,18,267
650,100,34,133,16,283
651,118,33,133,16,300
654,102,33,132,17,284
655,118,33,116,19,286
656,100,33,116,19,268
657,116,34,116,15,281
659,117,33,119,14,283
660,116,17,119,14,266
661,116,32,101,17,266
662,116,16,101,17,250
663,117,36,131,16,300
664,116,19,131,16,282
666,116,15,117,17,265
667,115,35,116,17,283
668,119,14,116,17,266
669,117,34,116,17,284
670,101,34,116,17,268
671,118,32,117,16,283
672,131,33,118,18,300
673,116,33,118,18,285
674,117,17,118,18,270
675,113,34,118,17,282
676,116,17,118,17,268
677,116,34,115,19,284
678,116,17,115,19,267
679,117,32,116,17,282
680,101,32,116,17,266
681,117,36,115,16,284
684,118,17,114,17,266
685,118,33,116,15,282
686,101,33,116,15,265
687,118,31,118,18,285
688,116,17,118,18,269
694,116,15,118,17,266
695,117,36,116,16,285
696,118,18,116,16,268
697,133,20,115,16,284
698,117,20,115,16,268
700,104,30,117,17,268
701,116,34,116,17,283
703,117,33,116,17,283
704,116,16,116,17,265
705,117,34,115,17,283
706,115,16,115,17,263
707,117,33,117,16,283
711,116,33,116,18,283
712,116,17,116,18,267
713,115,33,117,18,283
714,115,17,117,18,267
715,116,34,116,19,285
716,117,16,116,19,268
717,117,32,118,17,284
718,117,15,118,17,267
720,116,18,116,17,267
721,118,34,114,18,284
722,101,34,114,18,267
723,117,34,115,16,282
725,118,32,115,19,284
726,103,32,115,19,269
728,116,17,116,17,266
729,117,33,117,16,283
730,114,18,117,16,265
731,117,33,118,16,284
732,115,16,118,16,265
733,116,35,116,16,283
736,101,32,117,17,267
737,118,33,118,16,285
738,117,16,118,16,267
740,118,16,117,16,267
743,117,34,116,16,283
744,117,17,116,16,266
745,117,33,116,16,282
747,116,33,118,15,282
748,117,16,118,15,266
749,116,33,117,17,283
750,117,16,117,17,267
751,116,33,101,16,266
752,116,16,101,16,249
753,115,33,119,17,284
754,116,16,119,17,268
755,115,34,117,16,282
756,118,15,117,16,266
758,117,17,115,17,266
759,117,34,115,17,283
760,101,34,115,17,267
762,119,17,116,16,268
763,117,31,117,17,282
764,117,16,117,17,267
765,132,17,118,16,283
767,116,34,118,16,284
771,117,33,118,15,283
772,117,17,118,15,267
773,118,33,117,17,285
774,101,33,117,17,268
775,117,34,117,16,284
776,118,16,117,16,267
777,116,34,117,16,283
778,116,18,117,16,267
779,118,32,118,15,283
780,101,32,118,15,266
781,116,34,116,18,284
782,117,17,116,18,268
783,116,33,117,18,284
785,117,34,116,16,283
786,117,16,116,16,265
787,116,32,117,18,283
788,101,32,117,18,268
790,116,18,116,16,266
791,117,34,116,16,283
792,101,34,116,16,267
793,117,31,117,17,282
794,116,16,117,17,266
795,115,35,117,16,283
797,118,32,117,18,285
798,116,16,117,18,267
799,116,34,117,16,283
801,117,33,116,19,285
802,117,17,116,19,269
804,117,16,116,18,267
805,133,18,115,17,283
806,117,18,115,17,267
809,117,35,115,17,284
810,116,19,115,17,267
811,117,33,115,17,282
812,116,18,115,17,266
813,118,32,117,16,283
815,116,35,116,17,284
816,117,18,116,17,268
817,119,32,117,17,285
818,115,17,117,17,266
819,117,33,116,19,285
820,115,17,116,19,267
822,117,16,117,17,267
823,116,35,116,16,283
824,116,17,116,16,265
825,118,33,115,17,283
826,117,17,115,17,266
828,116,19,115,16,266
829,118,32,116,16,282
831,116,33,116,18,283
832,116,16,116,18,266
833,116,33,116,18,283
834,115,17,116,18,266
835,117,33,118,16,284
836,115,16,118,16,265
837,116,33,118,17,284
838,116,16,118,17,267
839,115,35,115,18,283
842,116,18,117,17,268
844,118,16,118,16,268
847,118,33,116,16,283
848,115,18,116,16,265
849,118,34,115,18,285
850,117,17,115,18,267
851,117,33,117,17,284
852,118,16,117,17,268
853,117,32,117,17,283
855,117,33,118,16,284
856,116,16,118,16,266
857,115,35,116,16,282
858,115,18,116,16,265
859,116,34,117,16,283
860,117,17,117,16,267
862,117,17,118,16,268
863,117,33,118,16,284
864,101,33,118,16,268
866,116,16,119,15,266
867,115,35,115,18,283
868,117,16,115,18,266
869,118,33,117,16,284
871,117,33,116,19,285
872,118,16,116,19,269
875,115,34,115,18,282
876,115,18,115,18,266
877,133,16,116,18,283
879,116,35,115,16,282
881,117,33,115,16,281
882,102,33,115,16,266
883,119,32,116,18,285
886,116,18,116,16,266
889,115,33,118,17,283
890,115,16,118,17,266
893,118,32,101,17,268
894,116,16,101,17,250
895,116,34,133,17,300
897,117,34,116,17,284
901,117,34,117,16,284
902,101,34,117,16,268
903,118,32,101,15,266
904,133,34,133,16,316
906,116,17,133,16,282
907,117,32,117,17,283
908,118,14,117,17,266
911,118,32,118,16,284
912,101,32,118,16,267
913,116,34,117,16,283
914,133,33,117,16,299
915,131,17,117,16,281
917,115,34,116,18,283
918,116,17,116,18,267
919,118,33,118,14,283
920,101,33,118,14,266
922,117,16,117,16,266
924,117,16,116,17,266
925,116,35,116,17,284
926,116,18,116,17,267
928,118,14,118,17,267
929,115,34,120,14,283
930,117,16,120,14,267
931,116,33,117,18,284
935,116,33,116,18,283
936,102,33,116,18,269
937,117,33,117,16,283
938,101,33,117,16,267
939,118,34,116,16,284
942,116,16,117,17,266
943,116,35,116,18,285
946,117,16,116,18,267
948,116,16,118,17,267
949,116,34,116,18,284
950,100,34,116,18,268
951,117,35,114,18,284
953,118,32,118,15,283
954,102,32,118,15,267
956,118,17,114,19,268
957,118,33,133,16,300
958,116,18,133,16,283
960,114,18,133,16,281
962,118,15,116,17,266
963,116,34,116,17,283
964,114,19,116,17,266
965,118,33,116,16,283
967,118,33,117,17,285
969,115,33,118,17,283
970,116,17,118,17,268
975,116,35,116,15,282
976,117,17,116,15,265
977,118,34,132,17,301
978,101,34,132,17,284
979,118,32,117,15,282
982,101,34,116,17,268
983,117,31,117,18,283
986,116,16,117,16,265
987,116,32,117,18,283
988,117,15,117,18,267
989,115,35,116,17,283
991,117,33,117,17,284
993,116,33,117,16,282
995,116,34,116,17,283
997,117,33,116,17,283
999,118,34,115,18,285
1000,117,17,115,18,267
1001,117,32,117,17,283
1002,117,16,117,17,267
1003,117,34,117,16,284
1004,116,17,117,16,266
1005,117,33,118,16,284
1006,116,17,118,16,267
1007,116,34,116,17,283
1008,115,18,116,17,266
1009,117,33,115,18,283
1011,117,33,118,13,281
1012,100,33,118,13,264
1013,117,34,132,17,300
1014,118,16,132,17,283
1017,117,33,118,15,283
1018,115,18,118,15,266
1019,116,31,119,17,283
1020,118,13,119,17,267
1021,113,35,117,16,281
1025,119,32,117,16,284
1026,101,32,117,16,266
1030,117,16,117,17,267
1031,116,34,118,15,283
1033,115,33,117,17,282
1034,100,33,117,17,267
1035,116,34,116,19,285
1036,115,18,116,19,268
1038,117,17,102,15,251
1039,116,33,134,16,299
1040,118,15,134,16,283
1042,117,17,116,18,268
1044,116,19,115,16,266
1046,102,31,118,16,267
1047,115,34,100,16,265
1048,134,34,132,19,319
1051,118,32,119,14,283
1052,115,16,119,14,264
1054,118,16,116,17,267
1055,114,33,118,16,281
1056,100,33,118,16,267
1057,117,33,118,16,284
1058,132,33,118,16,299
1059,116,33,118,16,283
1060,119,14,118,16,267
1061,101,14,118,16,249
1062,116,17,135,16,284
1063,117,34,117,17,285
1065,118,33,118,16,285
1066,101,33,118,16,268
1067,115,33,119,15,282
1069,117,35,115,17,284
1070,135,33,132,17,317
1071,133,17,132,17,299
1072,117,17,132,17,283
1073,117,33,116,16,282
1074,101,33,116,16,266
1075,117,33,117,16,283
1076,101,33,117,16,267
1077,117,33,117,16,283
1081,132,16,118,16,282
1082,116,16,118,16,266
1083,114,34,117,16,281
1084,117,16,117,16,266
1086,117,16,118,16,267
1087,117,33,117,17,284
1088,117,16,117,17,267
1089,116,34,116,17,283
1090,118,16,116,17,267
1095,117,33,115,18,283
1096,117,17,115,18,267
1097,116,33,100,16,265
1098,116,17,100,16,249
1100,116,18,116,17,267
1101,116,34,115,18,283
1102,100,34,115,18,267
1103,118,32,117,18,285
1105,117,34,117,17,285
1106,100,34,117,17,268
1109,116,34,133,16,299
1111,119,34,115,18,286
1112,117,18,115,18,268
1113,119,33,116,18,286
1114,101,33,116,18,268
1117,116,35,116,18,285
1118,133,34,115,17,299
1119,133,18,115,17,283
1120,115,18,115,17,265
1121,117,34,115,17,283
1122,116,18,115,17,266
1124,103,31,117,17,268
1125,116,35,118,15,284
1126,116,18,118,15,267
1129,116,34,116,16,282
1131,116,33,117,17,283
1132,117,17,117,17,268
1133,117,34,117,15,283
1134,118,15,117,15,265
1135,118,32,117,18,285
1136,101,32,117,18,268
1137,116,33,118,17,284
1138,116,16,118,17,267
1140,99,35,116,17,267
1141,132,15,118,16,281
1143,116,35,115,17,283
1144,117,18,115,17,267
1147,117,33,117,15,282
1148,116,17,117,15,265
1150,101,33,116,18,268
1151,117,33,119,14,283
1155,117,32,118,16,283
1156,100,32,118,16,266
1159,118,32,117,18,285
1160,119,14,117,18,268
1161,117,32,119,16,284
1162,121,10,119,16,266
1163,104,10,119,16,249
1166,116,16,118,15,265
1167,114,35,115,19,283
1168,117,18,115,19,269
1169,113,32,102,16,263
1170,103,32,102,16,253
1172,116,18,117,16,267
1173,117,32,118,16,283
1175,116,36,116,16,284
1176,115,19,116,16,266
1177,118,32,117,17,284
1178,102,32,117,17,268
1180,117,16,116,17,266
1182,101,33,118,17,269
1183,117,34,101,15,267
1186,100,34,117,16,267
1188,116,17,118,17,268
1189,116,35,115,16,282
1192,101,33,116,18,268
1193,117,33,115,18,283
1194,117,16,115,18,266
1196,101,34,115,18,268
1197,117,31,119,14,281
1198,115,16,119,14,264
1199,116,36,132,16,300
1200,116,18,132,16,282
1202,115,18,133,16,282
1204,115,18,115,18,266
1206,119,14,118,16,267
1207,115,35,118,16,284
1210,116,17,118,17,268
1212,115,18,118,12,263
1213,116,32,118,17,283
1214,102,32,118,17,269
1216,118,16,115,19,268
1218,101,34,115,17,267
1219,119,29,103,16,267
1220,118,12,103,16,249
1221,114,37,133,17,301
1222,118,17,133,17,285
1224,115,19,116,17,267
1225,117,32,118,16,283
1226,115,17,118,16,266
1227,115,34,117,16,282
1228,103,34,117,16,270
1229,117,33,117,16,283
1230,133,34,116,17,300
1233,101,17,116,17,251
1234,118,16,117,16,267
1236,117,16,117,17,267
1237,116,33,116,16,281
1238,117,16,116,16,265
1239,116,34,117,15,282
1241,116,33,116,17,282
1243,116,34,116,17,283
1245,117,31,119,16,283
1246,116,16,119,16,267
1247,115,34,118,16,283
1249,115,34,117,16,282
1250,116,17,117,16,266
1251,116,34,115,18,283
1254,102,33,117,16,268
1255,116,33,116,16,281
1256,101,33,116,16,266
1258,117,16,116,18,267
1260,115,18,117,16,266
1261,116,33,117,17,283
1263,116,32,117,18,283
1264,116,16,117,18,267
1266,99,35,115,18,267
1267,118,33,117,16,284
1269,116,34,116,17,283
1270,100,34,116,17,267
1273,118,33,117,16,284
1274,115,18,117,16,266
1275,116,33,117,16,282
1276,117,16,117,16,266
1277,116,34,134,17,301
1278,116,17,134,17,284
1279,118,33,118,14,283
1280,100,33,118,14,265
1282,117,16,117,16,266
1283,116,33,116,17,282
1284,117,16,116,17,266
1286,134,31,118,17,300
1289,101,14,118,17,250
1293,116,33,117,18,284
1294,115,16,117,18,266
1295,114,35,117,16,282
1296,118,17,117,16,268
1297,117,34,117,15,283
1298,118,17,117,15,267
1299,119,31,117,19,286
1301,116,35,117,17,285
1303,117,33,116,18,284
1305,116,33,101,15,265
1307,117,35,132,17,301
1308,117,19,132,17,285
1310,117,17,132,18,284
1313,116,34,116,17,283
1314,101,34,116,17,268
1315,119,32,117,16,284
1316,132,33,116,17,298
1317,116,33,116,17,282
1321,102,16,118,15,251
1322,116,17,117,17,267
1323,117,32,117,16,282
1324,117,16,117,16,266
1325,116,33,119,16,284
1327,115,34,117,17,283
1328,118,15,117,17,267
1329,116,35,116,16,283
1331,118,31,118,17,284
1332,102,31,118,17,268
1333,117,35,117,13,282
1334,119,16,117,13,265
1335,116,33,117,16,282
1336,117,17,117,16,267
1337,116,33,116,17,282
1338,116,16,116,17,265
1339,117,34,116,16,283
1340,118,17,116,16,267
1343,114,36,117,16,283
1344,117,16,117,16,266
1345,116,33,117,16,282
1346,100,33,117,16,266
1348,116,16,117,17,266
1349,115,34,118,14,281
1350,119,17,118,14,268
1351,116,33,115,19,283
1352,117,16,115,19,267
1353,117,33,116,18,284
1356,117,17,117,16,267
1357,117,32,118,16,283
1358,100,32,118,16,266
1359,115,35,115,17,282
1360,115,19,115,17,266
1361,117,33,117,16,283
1363,117,33,118,17,285
1364,117,16,118,17,268
1365,115,33,117,17,282
1366,118,16,117,17,268
1369,117,34,118,16,285
1370,117,16,118,16,267
1371,116,35,115,16,282
1372,118,17,115,16,266
1373,118,32,116,17,283
1375,118,33,118,15,284
1376,117,17,118,15,267
1379,116,32,117,16,281
1380,115,16,117,16,264
1381,116,34,117,17,284
1382,116,17,117,17,267
1384,118,15,118,16,267
1385,115,34,117,15,281
1386,116,17,117,15,265
1387,117,32,119,15,283
1388,117,16,119,15,267
1389,116,35,116,16,283
1390,117,17,116,16,266
1391,116,33,116,16,281
1392,118,16,116,16,266
1394,117,15,117,16,265
1395,116,34,116,18,284
1396,100,34,116,18,268
1397,116,33,117,16,282
1398,116,16,117,16,265
1400,116,16,117,18,267
1402,117,16,119,15,267
1404,116,18,117,15,266
1405,117,32,118,17,284
1406,101,32,118,17,268
1407,116,35,115,18,284
1409,118,32,117,18,285
1413,116,35,117,16,284
1414,118,17,117,16,268
1416,115,18,117,16,266
1417,116,34,116,16,282
1419,117,32,117,17,283
1420,117,17,117,17,268
1422,117,16,116,18,267
1423,118,33,101,16,268
1425,117,33,117,17,284
1426,116,16,117,17,266
1427,117,34,119,13,283
1430,116,18,117,14,265
1431,117,33,115,18,283
1434,117,17,115,19,268
1435,117,32,117,17,283
1436,119,13,117,17,266
1437,116,33,118,17,284
1438,117,14,118,17,266
1439,101,14,118,17,250
1440,115,18,116,16,265
1441,117,34,115,18,284
1442,115,19,115,18,267
1443,115,32,101,15,263
1446,118,17,117,17,269
1447,118,32,102,16,268
1448,116,16,102,16,250
1449,117,35,133,16,301
1451,118,32,117,17,284
1453,116,35,116,16,283
1456,102,33,117,16,268
1457,118,33,115,20,286
1458,116,17,115,20,268
1459,118,33,102,11,264
1460,117,17,102,11,247
1461,116,33,117,17,283
1462,116,16,117,17,266
1463,116,34,116,16,282
1465,117,35,131,17,300
1466,115,20,131,17,283
1467,119,31,134,15,299
1469,133,17,115,18,283
1471,116,32,118,16,282
1472,116,16,118,16,266
1476,117,17,117,15,266
1477,117,33,116,17,283
1479,117,33,117,16,283
1480,118,16,117,16,267
1481,117,34,116,17,284
1482,116,18,116,17,267
1483,117,32,118,16,283
1484,117,15,118,16,266
1486,116,17,118,14,265
1487,116,33,117,18,284
1488,117,16,117,18,268
1491,116,33,117,16,282
1492,118,16,117,16,267
1494,118,14,119,17,268
1495,115,36,116,17,284
1496,117,18,116,17,268
1498,101,31,118,17,267
1500,117,16,119,15,267
1501,115,35,116,17,283
1502,101,35,116,17,269
1504,116,17,115,17,265
1505,118,33,116,16,283
1508,119,15,117,17,268
1509,116,34,116,16,282
1510,116,17,116,16,265
1511,117,32,117,16,282
1512,115,17,117,16,265
1513,116,33,116,19,284
1514,116,16,116,19,267
1515,114,35,117,17,283
1516,117,17,117,17,268
1518,116,16,117,16,265
1519,117,33,117,18,285
1520,117,16,117,18,268
1521,116,35,117,16,284
1522,116,19,117,16,268
1525,118,31,117,18,284
1526,102,31,117,18,268
1527,116,35,116,17,284
1528,117,18,116,17,268
1529,119,33,117,15,284
1531,116,33,117,16,282
1532,114,18,117,16,265
1533,117,34,133,17,301
1535,118,33,117,15,283
1536,100,33,117,15,265
1538,117,15,117,16,265
1540,117,16,116,18,267
1541,117,34,115,17,283
1542,115,18,115,17,265
1543,134,15,118,17,284
1544,117,15,118,17,267
1545,115,33,119,16,283
1546,117,16,119,16,268
1547,115,35,117,16,283
1548,116,18,117,16,267
1549,118,32,118,17,285
1550,115,17,118,17,267
1552,118,17,117,16,268
1553,118,33,117,15,283
1554,102,33,117,15,267
1556,117,16,118,14,265
1557,118,34,116,16,284
1558,118,17,116,16,267
1559,117,33,117,15,282
1560,117,16,117,15,265
1561,116,32,118,15,281
1562,117,15,118,15,265
1564,118,14,117,19,268
1565,115,34,117,17,283
1567,115,33,122,9,279
1569,115,33,117,17,282
1570,118,15,117,17,267
1573,118,32,100,17,267
1574,102,32,100,17,251
1575,116,30,119,18,283
1576,122,9,119,18,268
1577,104,9,119,18,250
1578,117,17,118,16,268
1580,115,17,117,17,266
1581,117,33,116,17,283
1583,112,34,117,15,278
1586,101,33,116,16,266
1587,117,34,116,17,284
1588,117,17,116,17,267
1589,117,32,118,17,284
1590,116,17,118,17,268
1591,117,33,117,18,285
1592,117,15,117,18,267
1593,115,33,119,16,283
1594,116,16,119,16,267
1595,115,35,117,13,280
1596,116,17,117,13,263
1598,101,34,116,16,267
1599,117,33,116,16,282
1600,102,33,116,16,267
1602,119,16,116,16,267
1604,117,13,102,16,248
1607,117,33,117,18,285
1608,116,16,117,18,267
1609,115,33,102,17,267
1610,116,16,102,17,251
1611,115,35,116,16,282
1614,101,32,118,17,268
1616,117,18,116,17,268
1619,103,15,117,17,252
1621,116,35,115,18,284
1623,118,33,115,18,284
1624,116,17,115,18,266
1625,116,33,116,18,283
1626,117,17,116,18,268
1627,117,33,116,17,283
1629,116,34,115,17,282
1630,115,18,115,17,265
1632,115,18,117,17,267
1633,117,34,115,16,282
1634,116,18,115,16,265
1635,117,32,118,15,282
1636,116,17,118,15,266
1641,118,31,118,18,285
1642,115,16,118,18,267
1643,116,34,102,16,268
1644,118,15,102,16,251
1645,117,35,115,16,283
1646,116,19,115,16,266
1647,117,31,118,16,282
1648,115,16,118,16,265
1651,117,32,117,15,281
1652,102,32,117,15,266
1653,118,32,118,17,285
1654,115,16,118,17,266
1655,116,34,118,17,285
1657,116,34,117,17,284
1658,115,17,117,17,266
1659,116,32,102,17,267
1660,117,15,102,17,251
1661,116,35,117,17,285
1662,118,17,117,17,269
1664,118,17,116,16,267
1665,118,33,116,17,284
1667,117,32,118,16,283
1668,102,32,118,16,268
1670,117,17,116,16,266
1671,117,32,116,19,284
1672,116,16,116,19,267
1674,116,17,116,16,265
1675,116,33,117,16,282
1676,101,33,117,16,267
1677,116,33,117,17,283
1679,116,35,134,12,297
1680,116,19,134,12,281
1681,118,31,115,19,283
1682,116,16,115,19,266
1683,115,34,118,16,283
1684,117,16,118,16,267
1685,116,34,117,15,282
1686,100,34,117,15,266
1689,119,31,116,17,283
1691,116,34,116,17,283
1693,117,32,101,18,268
1694,117,15,101,18,251
1695,116,33,118,16,283
1696,130,34,116,18,298
1697,118,34,116,18,286
1698,116,17,116,18,267
1700,116,17,116,17,266
1701,116,33,116,18,283
1702,101,33,116,18,268
1703,102,15,116,18,251
1705,117,34,117,15,283
1707,117,33,117,16,283
1708,116,17,117,16,266
1709,115,34,117,15,281
1710,116,18,117,15,266
1711,117,33,117,15,282
1712,116,18,117,15,266
1713,118,32,119,16,285
1714,100,32,119,16,267
1715,116,34,117,17,284
1716,117,16,117,17,267
1718,117,15,118,15,265
1721,115,35,116,17,283
1722,119,16,116,17,268
1724,101,33,117,16,267
1727,115,34,116,17,282
1728,118,16,116,17,267
1729,115,34,116,17,282
1731,117,33,117,16,283
1732,117,16,117,16,266
1733,116,35,115,18,284
1734,119,17,115,18,269
1735,118,31,118,16,283
1736,116,17,118,16,267
1737,116,34,117,16,283
1738,116,17,117,16,266
1739,116,33,117,19,285
1740,117,16,117,19,269
1741,115,35,116,17,283
1742,115,18,116,17,266
1743,119,32,118,16,285
1744,102,32,118,16,268
1746,117,16,118,15,266
1748,117,19,114,18,268
1749,119,32,117,16,284
1751,117,33,117,17,284
1752,118,16,117,17,268
1753,117,32,119,15,283
1754,101,32,119,15,267
1756,114,18,116,17,265
1757,117,33,116,16,282
1758,117,16,116,16,265
1759,116,34,116,16,282
1760,117,17,116,16,266
1761,117,32,117,18,284
1764,116,17,117,15,265
1765,116,32,117,17,282
1766,116,16,117,17,266
1767,115,34,117,17,283
1768,116,16,117,17,266
1770,117,18,118,15,268
1771,118,31,118,17,284
1772,117,15,118,17,267
1774,117,17,117,16,267
1776,117,17,116,17,267
1777,117,34,133,15,299
1778,118,15,133,15,281
1779,117,33,115,18,283
1780,102,33,115,18,268
1781,118,32,117,17,284
1782,117,16,117,17,267
1783,116,34,116,18,284
1785,114,34,117,16,281
1788,115,18,117,17,267
1789,117,33,116,17,283
1790,117,17,116,17,267
1791,117,34,116,17,284
1794,117,16,115,18,266
1795,118,34,116,17,285
1796,117,17,116,17,267
1797,118,32,116,19,285
1798,116,17,116,19,268
1799,117,34,115,18,284
1800,116,17,115,18,266
1803,116,34,116,17,283
1804,116,17,116,17,266
1805,118,34,116,17,285
1807,118,32,118,17,285
1808,115,18,118,17,268
1810,117,16,117,16,266
1811,116,34,116,16,282
1812,116,17,116,16,265
1813,118,34,115,18,285
1814,116,17,115,18,266
1817,118,31,116,18,283
1819,116,33,118,16,283
1821,132,18,116,16,282
1822,115,18,116,16,265
1823,116,33,116,17,282
1825,117,33,117,16,283
1826,116,18,117,16,267
1827,117,33,118,16,284
1828,118,16,118,16,268
1829,117,33,117,18,285
1833,118,33,116,19,286
1834,117,16,116,19,268
1835,116,34,118,16,284
1837,117,34,116,15,282
1839,118,32,118,15,283
1840,116,17,118,15,266
1842,116,19,115,16,266
1845,118,31,117,18,284
1846,100,31,117,18,266
1847,101,15,117,18,251
1848,118,15,118,17,268
1849,117,33,102,17,269
1850,115,16,102,17,250
1851,114,33,119,17,283
1852,115,16,119,17,267
1853,115,35,116,16,282
1854,117,18,116,16,267
1857,118,32,121,14,285
1858,102,32,121,14,269
1860,119,17,114,19,269
1861,102,17,114,19,252
1862,116,16,118,17,267
1863,115,34,117,16,282
1864,116,16,117,16,265
1866,100,35,116,16,267
1867,117,33,115,16,281
1868,114,19,115,16,264
1869,118,33,116,16,283
1870,118,17,116,16,267
1873,112,34,116,17,279
1874,116,16,116,17,265
1876,115,16,117,17,265
1877,115,34,117,18,284
1878,116,16,117,18,267
1879,116,34,117,18,285
1880,117,17,117,18,269
1881,116,33,118,16,283
1882,116,17,118,16,267
1883,117,33,117,16,283
1885,116,35,133,19,303
1886,117,18,133,19,287
1887,118,34,118,13,283
1888,117,18,118,13,266
1891,118,32,117,16,283
1893,116,35,117,15,283
1894,133,32,117,18,300
1897,102,13,117,18,250
1898,116,16,102,15,249
1899,116,33,117,17,283
1900,117,16,117,17,267
1901,116,34,118,17,285
1902,117,15,118,17,267
1903,113,35,116,16,280
1904,117,18,116,16,267
1905,118,33,116,17,284
1906,102,33,116,17,268
1907,118,32,118,16,284
1911,118,32,117,16,283
1912,116,16,117,16,265
1913,117,34,117,16,284
1914,116,17,117,16,266
1915,118,33,120,13,284
1916,118,16,120,13,267
1919,115,34,118,15,282
1922,117,16,116,19,268
1923,116,33,116,18,283
1924,120,13,116,18,267
1925,115,33,117,17,282
1926,118,16,117,17,268
1927,116,33,117,17,283
1928,118,15,117,17,267
1929,115,36,133,15,299
1930,116,19,133,15,283
1932,116,18,132,19,285
1935,116,33,117,17,283
1936,101,33,117,17,268
1939,119,31,118,17,285
1940,116,16,118,17,267
1942,118,16,116,16,266
1943,102,16,116,16,250
1944,117,17,117,16,267
1946,116,16,118,15,265
1947,117,34,117,16,284
1948,118,17,117,16,268
1951,116,34,118,14,282
1954,118,15,117,16,266
1955,116,34,116,17,283
1956,117,16,116,17,266
1957,117,34,115,18,284
1958,101,34,115,18,268
1959,100,17,115,18,250
1960,101,31,117,17,266
1961,114,34,118,17,283
1963,115,34,116,17,282
1964,116,17,116,17,266
1966,115,18,116,17,266
1967,116,32,116,18,282
1968,102,32,116,18,268
1969,116,35,115,17,283
1973,117,34,117,17,285
1976,101,33,116,17,267
1978,115,17,118,16,266
1979,117,34,117,17,285
1980,117,17,117,17,268
1982,117,17,116,16,266
1983,119,32,116,17,284
1984,101,32,116,17,266
1985,117,34,117,16,284
1987,117,34,116,16,283
1989,117,32,117,17,283
1991,117,33,118,17,285
1992,116,17,118,17,268
1993,115,34,118,15,282
1994,117,16,118,15,266
1995,116,33,118,17,284
2000,118,17,115,17,267
2001,117,32,118,15,282
2002,118,15,118,15,266
2003,116,35,117,15,283
2005,118,33,117,16,284
2006,101,33,117,16,267
2007,117,32,118,17,284
2008,100,32,118,17,267
2013,117,34,115,21,287
2014,117,16,115,21,269
2015,118,34,115,17,284
2016,101,34,115,17,267
2018,116,18,134,17,285
2019,115,33,118,15,281
2020,118,15,118,15,266
2021,115,37,130,17,299
2022,115,21,130,17,283
2023,119,30,117,16,282
2025,118,34,116,17,285
2026,134,32,118,15,299
2027,116,32,118,15,281
2028,118,15,118,15,266
2029,102,15,118,15,250
2030,130,33,117,16,296
2031,117,33,117,16,283
2032,117,16,117,16,266
2033,116,34,116,17,283
2034,116,17,116,17,266
2035,116,32,118,16,282
2037,115,33,118,16,282
2039,115,34,118,16,283
2041,116,34,116,17,283
2042,116,17,116,17,266
2043,116,33,117,16,282
2044,118,16,117,16,267
2045,117,33,117,17,284
2046,101,33,117,17,268
2047,116,34,115,18,283
2048,118,16,115,18,267
2049,117,33,116,17,283
2050,100,33,116,17,266
2052,117,16,117,16,266
2054,117,17,116,16,266
2055,116,33,117,16,282
2056,115,18,117,16,266
2057,117,33,117,17,284
2058,116,17,117,17,267
2059,116,33,118,17,284
2060,117,16,118,17,268
2061,116,33,118,18,285
2062,116,16,118,18,268
2063,117,34,117,16,284
2065,117,34,116,18,285
2066,117,17,116,18,268
2068,101,34,115,18,268
2069,118,34,114,19,285
2070,102,34,114,19,269
2072,102,31,118,17,268
2074,116,18,117,17,268
2077,117,34,116,16,283
2079,118,33,116,16,283
2080,102,33,116,16,267
2081,118,34,132,17,301
2082,117,17,132,17,283
2083,119,32,117,17,285
2085,118,33,116,18,285
2086,116,16,116,18,266
2087,116,33,118,16,283
2088,116,16,118,16,266
2089,115,34,118,17,284
2091,117,34,117,16,284
2092,117,17,117,16,267
2093,117,33,116,16,282
2095,117,33,116,19,285
2098,118,17,115,16,266
2099,118,32,116,16,282
2100,101,32,116,16,265
2101,118,32,117,15,282
2102,116,16,117,15,264
2103,115,36,115,15,281
2104,116,19,115,15,265
2106,115,16,117,17,265
2108,116,16,116,19,267
2109,116,32,103,17,268
2110,117,15,103,17,252
2111,115,34,118,18,285
2112,115,15,118,18,266
2113,100,15,118,18,251
2114,117,17,117,17,268
2115,117,34,116,17,284
2116,116,19,116,17,268
2119,117,34,115,19,285
2120,118,18,115,19,270
2121,118,33,116,17,284
2122,117,17,116,17,267
2124,116,17,116,16,265
2125,116,32,118,17,283
2126,116,16,118,17,267
2127,116,36,114,17,283
2128,115,19,114,17,265
2129,118,32,114,19,283
2130,101,32,114,19,266
2131,117,32,118,17,284
2132,116,16,118,17,267
2133,116,35,117,16,284
2134,118,17,117,16,268
2136,114,17,117,18,266
2137,116,34,117,17,284
2138,114,19,117,17,267
2139,117,34,116,17,284
2140,118,17,116,17,268
2141,117,33,117,15,282
2142,117,16,117,15,265
2144,101,34,115,16,266
2145,120,33,116,16,285
2146,117,17,116,16,266
2147,117,33,116,16,282
2148,116,17,116,16,265
2150,117,15,118,16,266
2151,116,33,119,15,283
2153,115,34,117,16,282
2155,116,33,117,18,284
2157,115,34,120,14,283
2158,118,16,120,14,268
2159,117,33,117,16,283
2160,101,33,117,16,267
2162,117,16,118,17,268
2165,117,33,116,16,282
2166,120,14,116,16,266
2169,116,35,117,17,285
2171,118,32,117,17,284
2172,115,17,117,17,266
2173,113,33,119,15,280
2174,116,16,119,15,266
2175,116,34,117,16,283
2178,117,17,115,17,266
2179,119,32,117,16,284
2180,102,32,117,16,267
2181,117,33,116,17,283
2182,119,15,116,17,267
2183,117,33,117,16,283
2185,115,34,117,15,281
2186,115,17,117,15,264
2187,117,33,133,19,302
2188,117,16,133,19,285
2189,115,33,119,15,282
2190,116,17,119,15,267
2191,116,33,118,17,284
2192,117,16,118,17,268
2195,115,34,117,16,282
2196,133,34,116,18,301
2198,119,15,116,18,268
2199,102,15,116,18,251
2201,117,33,116,16,282
2203,118,32,117,17,284
2205,114,35,117,16,282
2206,116,18,117,16,267
2207,117,33,117,16,283
2211,116,34,116,17,283
2212,117,17,116,17,267
2213,117,34,116,17,284
2214,117,16,116,17,266
2215,117,33,116,16,282
2216,117,16,116,16,265
2217,117,32,119,16,284
2218,101,32,119,16,268
2219,116,34,118,15,283
2221,115,34,116,18,283
2222,116,17,116,18,267
2223,116,32,119,16,283
2224,116,16,119,16,267
2225,115,35,117,17,284
2228,101,32,117,17,267
2229,116,35,133,16,300
2230,116,18,133,16,283
2233,116,34,132,17,299
2234,117,17,132,17,283
2236,117,17,117,17,268
2237,117,34,115,18,284
2238,133,32,117,17,299
2240,116,16,117,17,266
2241,115,34,117,18,284
2243,117,34,101,14,266
2245,118,33,118,15,284
2246,115,18,118,15,266
2247,117,33,116,17,283
2248,117,17,116,17,267
2249,116,35,114,17,282
2250,117,18,114,17,266
2251,118,37,112,17,284
2252,101,37,112,17,267
2253,123,28,118,17,286
2255,117,33,117,17,284
2256,116,17,117,17,267
2257,116,33,117,17,283
2259,117,35,117,16,285
2261,116,34,114,18,282
2265,118,33,118,16,285
2266,117,17,118,16,268
2268,117,16,117,17,267
2270,114,18,101,15,248
2273,118,33,115,21,287
2274,118,16,115,21,270
2275,116,34,115,18,283
2276,117,17,115,18,267
2277,119,32,117,17,285
2278,101,32,117,17,267
2279,116,34,117,15,282
2280,117,16,117,15,265
2281,116,36,131,17,300
2282,115,21,131,17,284
2283,119,31,134,14,298
2284,102,31,134,14,281
2285,118,33,115,19,285
2286,101,33,115,19,268
2287,116,32,120,14,282
2289,117,35,115,17,284
2290,131,34,132,17,314
2291,118,34,132,17,301
2292,117,17,132,17,283
2293,118,33,116,17,284
2294,101,33,116,17,267
2296,102,32,117,16,267
2298,115,17,118,16,266
2299,115,34,118,15,282
2300,132,34,116,17,299
2302,116,17,116,17,266
2303,115,32,101,16,264
2305,117,34,117,15,283
2306,118,16,117,15,266
2307,117,33,117,17,284
2308,118,15,117,17,267
2309,116,34,116,16,282
2311,117,35,114,17,283
2314,117,15,117,18,267
2315,114,35,117,18,284
2316,117,17,117,18,269
2317,117,32,118,16,283
2318,116,16,118,16,266
2319,116,34,117,17,284
2320,114,17,117,17,265
2321,116,34,116,17,283
2322,117,18,116,17,268
2323,117,35,115,16,283
2324,117,18,115,16,266
2325,119,31,118,15,283
2326,103,31,118,15,267
2327,117,34,116,18,285
2330,116,17,116,18,267
2331,116,33,118,16,283
2333,116,33,118,15,282
2335,116,35,133,17,301
2336,116,18,133,17,284
2337,118,33,117,16,284
2338,101,33,117,16,267
2340,118,16,117,16,267
2341,116,32,118,16,282
2342,101,32,118,16,267
2343,116,35,115,17,283
2344,133,33,118,14,298
2345,118,33,118,14,283
2347,116,33,118,15,282
2348,117,16,118,15,266
2349,116,33,117,16,282
2350,118,16,117,16,267
2353,115,33,117,16,281
2356,118,15,118,16,267
2357,116,33,117,16,282
2358,117,16,117,16,266
2360,100,35,116,17,268
2362,102,31,118,16,267
2364,118,16,119,13,266
2365,117,32,117,17,283
2366,117,16,117,17,267
2367,117,35,116,16,284
2368,116,17,116,16,265
2369,118,32,116,19,285
2371,115,33,117,17,282
2372,119,13,117,17,266
2373,116,34,116,17,283
2374,117,17,116,17,267
2375,116,33,118,17,284
2377,116,35,116,16,283
2378,116,19,116,16,267
2379,115,32,116,17,280
2381,117,33,117,16,283
2382,116,17,117,16,266
2383,116,35,116,16,283
2384,118,17,116,16,267
2385,119,32,118,15,284
2388,116,17,119,15,267
2389,117,33,119,16,285
2390,117,16,119,16,268
2391,115,34,118,16,283
2393,116,33,101,19,269
2394,118,15,101,19,253
2395,117,34,133,16,300
2397,102,15,133,16,266
2398,101,34,115,17,267
2399,117,33,116,16,282
2400,118,16,116,16,266
2401,116,33,117,17,283
2402,101,33,117,17,268
2403,115,33,116,16,280
2404,133,33,116,19,301
2405,115,33,116,19,283
2407,115,33,117,18,283
2408,116,16,117,18,267
2409,113,35,117,16,281
2410,117,17,117,16,267
2412,101,31,119,16,267
2414,116,19,115,16,266
2415,118,33,132,17,300
2416,117,18,132,17,284
2417,117,33,132,17,299
2418,117,16,132,17,282
2419,118,33,116,16,283
2420,119,16,116,16,267
2422,115,16,118,17,266
2425,115,33,117,17,282
2426,116,16,117,17,266
2427,115,33,117,17,282
2428,116,16,117,17,266
2429,116,35,116,18,285
2430,100,35,116,18,269
2431,118,30,120,17,285
2432,116,15,120,17,268
2434,117,17,116,19,269
2435,117,33,117,17,284
2439,119,33,117,15,284
2440,120,17,117,15,269
2441,118,34,115,17,284
2442,116,19,115,17,267
2444,102,32,118,17,269
2445,117,34,115,17,283
2446,133,32,117,16,298
2450,115,17,117,16,265
2451,117,35,115,16,283
2452,118,17,115,16,266
2453,118,31,117,18,284
2454,101,31,117,18,267
2456,117,16,102,15,250
2457,116,34,117,16,283
2458,117,16,117,16,266
2460,115,16,118,17,266
2461,117,35,116,16,284
2462,117,18,116,16,267
2463,118,33,116,17,284
2465,117,32,101,17,267
2469,118,32,116,17,283
2470,116,16,116,17,265
2473,117,33,118,14,282
2474,101,33,118,14,266
2477,118,31,116,18,283
2478,116,17,116,18,267
2479,116,34,116,17,283
2480,116,17,116,17,266
2481,116,32,119,15,282
2482,118,14,119,15,266
2483,115,36,114,19,284
2484,114,19,114,19,266
2485,119,32,118,17,286
2486,102,32,118,17,269
2487,117,33,102,14,266
2488,116,17,102,14,249
2489,115,33,135,16,299
2491,117,35,133,17,302
2492,114,19,133,17,283
2493,119,34,116,15,284
2495,119,31,116,19,285
2496,102,31,116,19,268
2497,115,35,115,17,282
2502,116,15,118,16,265
2503,102,15,118,16,251
2505,117,32,118,17,284
2508,115,17,119,15,266
2510,100,34,117,17,268
2511,118,34,117,16,285
2512,116,17,117,16,266
2514,118,17,116,16,267
2515,102,17,116,16,251
2516,102,32,118,15,267
2518,117,17,115,16,265
2519,117,33,116,16,282
2520,117,16,116,16,265
2523,115,33,102,14,264
2524,100,33,102,14,249
2525,116,32,119,16,283
2526,115,16,119,16,266
2527,114,34,117,19,284
2531,117,32,116,17,282
2532,102,32,116,17,267
2534,119,16,117,17,269
2536,101,35,114,17,267
2537,119,31,117,17,284
2538,115,16,117,17,265
2540,116,17,116,16,265
2541,116,34,116,16,282
2542,117,17,116,16,266
2543,118,32,117,17,284
2544,114,17,117,17,265
2547,117,32,117,19,285
2549,115,34,117,17,283
2550,116,16,117,17,266
2552,117,17,117,16,267
2553,117,34,115,17,283
2554,117,17,115,17,266
2555,118,34,114,17,283
2556,102,34,114,17,267
2557,118,32,118,14,282
2559,117,33,116,17,283
2560,117,16,116,17,266
2561,116,33,117,16,282
2562,115,17,117,16,265
2563,117,33,118,17,285
2564,114,17,118,17,266
2566,118,14,119,17,268
2567,115,34,118,15,282
2572,100,35,116,18,269
2573,116,34,115,16,281
2574,102,34,115,16,267
2575,119,31,117,18,285
2577,116,34,118,16,284
2578,118,16,118,16,268
2579,116,35,116,16,283
2581,117,31,117,16,281
2583,115,35,116,16,282
2584,100,35,116,16,267
2586,101,33,115,19,268
2587,117,33,118,17,285
2588,116,16,118,17,267
2590,101,32,117,17,267
2591,116,34,117,17,284
2592,116,16,117,17,266
2593,115,35,117,15,282
2594,115,19,117,15,266
2595,117,34,114,19,284
2596,118,17,114,19,268
2597,119,31,117,16,283
2600,117,17,118,15,267
2602,117,15,116,19,267
2603,115,35,116,17,283
2605,119,31,117,17,284
2606,117,16,117,17,267
2607,116,34,118,14,282
2608,118,15,118,14,265
2609,115,35,116,15,281
2611,119,33,116,16,284
2612,116,17,116,16,265
2614,117,17,117,18,269
2615,115,32,122,13,282
2617,116,34,118,17,285
2618,116,15,118,17,266
2620,116,16,118,15,265
2621,117,35,115,17,284
2624,122,13,116,16,267
2625,116,34,133,17,300
2626,118,17,133,17,285
2627,117,32,118,17,284
2629,116,34,117,16,283
2630,115,17,117,16,265
2631,113,32,118,16,279
2633,115,35,116,17,283
2634,115,18,116,17,266
2635,116,34,116,16,282
2636,101,34,116,16,267
2637,101,17,116,16,250
2638,117,16,118,16,267
2639,117,33,117,17,284
2642,116,17,116,17,266
2644,116,16,117,16,265
2645,116,34,116,18,284
2646,118,16,116,18,268
2648,101,33,116,18,268
2649,117,33,118,15,283
2650,116,17,118,15,266
2652,117,16,117,16,266
2653,115,35,115,18,283
2654,116,18,115,18,267
2655,118,33,115,18,284
2656,116,18,115,18,267
2657,118,32,117,16,283
2658,118,15,117,16,266
2660,117,16,118,16,267
2661,116,35,116,17,284
2662,115,18,116,17,266
2663,118,33,116,16,283
2664,115,18,116,16,265
2666,101,32,119,16,268
2667,116,34,116,17,283
2669,117,34,117,16,284
2670,116,17,117,16,266
2673,116,35,116,16,283
2674,119,16,116,16,267
2675,117,32,115,20,284
2676,116,17,115,20,268
2677,116,34,117,16,283
2680,101,32,118,17,268
2681,114,34,117,16,281
2682,116,16,117,16,265
2683,117,35,115,17,284
2685,117,32,117,16,282
2686,117,16,117,16,266
2687,116,34,115,18,283
2688,101,34,115,18,268
2691,118,34,117,16,285
2692,115,17,117,16,265
2693,116,33,118,16,283
2694,117,16,118,16,267
2696,115,18,117,15,265
2697,117,33,118,16,284
2698,101,33,118,16,268
2699,117,33,117,17,284
2700,117,16,117,17,267
2701,116,34,118,15,283
2702,118,16,118,15,267
2703,118,32,118,17,285
2704,117,15,118,17,267
2705,115,35,116,16,282
2706,118,16,116,16,266
2709,116,33,118,15,282
2710,118,15,118,15,266
2712,118,17,117,17,269
2713,116,32,118,17,283
2714,116,16,118,17,267
2715,116,34,118,15,283
2717,115,33,117,18,283
2718,118,15,117,18,268
2719,116,35,117,16,284
2720,117,17,117,16,267
2722,102,33,117,17,269
2724,118,15,117,16,266
2725,115,35,133,16,299
2727,117,33,116,17,283
2728,117,16,116,17,266
2730,117,17,115,17,266
2735,116,33,117,16,282
2737,116,33,116,18,283
2738,115,17,116,18,266
2739,117,34,115,17,283
2740,121,14,115,17,267
2742,115,18,133,17,283
2743,117,33,117,17,284
2744,117,16,117,17,267
2745,117,34,117,15,283
2747,114,32,118,16,280
2748,100,32,118,16,266
2750,133,34,117,16,300
2752,117,17,117,16,267
2753,101,17,117,16,251
2754,117,15,118,16,266
2755,102,15,118,16,251
2757,116,33,116,17,282
2758,116,17,116,17,266
2759,116,34,117,15,282
2760,117,16,117,15,265
2761,133,16,117,17,283
2763,116,34,115,18,283
2764,100,34,115,18,267
2766,116,17,101,17,251
2767,115,33,118,17,283
2771,117,33,117,16,283
2774,101,33,117,17,268
2775,116,34,115,18,283
2776,101,34,115,18,268
2777,117,33,116,16,282
2778,117,16,116,16,265
2779,118,33,117,17,285
2780,117,16,117,17,267
2781,116,34,115,17,282
2782,117,17,115,17,266
2783,117,33,116,17,283
2784,115,18,116,17,266
2785,116,32,117,16,281
2786,116,16,117,16,265
2787,115,35,116,17,283
2788,117,17,116,17,267
2789,117,32,101,17,267
2793,117,32,118,18,285
2794,117,16,118,18,269
2795,115,35,116,18,284
2797,118,31,118,18,285
2798,101,31,118,18,268
2799,101,14,118,18,251
2800,116,17,117,16,266
2802,118,18,131,18,285
2803,118,33,132,17,300
2804,116,18,132,17,283
2805,117,33,116,16,282
2806,118,18,116,16,268
2809,116,33,118,17,284
2810,131,34,117,16,298
2811,116,34,117,16,283
2812,116,16,117,16,265
2814,116,16,117,16,265
2815,116,34,116,18,284
2816,117,17,116,18,268
2817,117,34,115,21,287
2818,118,17,115,21,271
2821,116,33,118,17,284
2822,117,16,118,17,268
2823,116,35,117,16,284
2825,117,36,130,17,300
2827,120,30,117,17,284
2828,118,16,117,17,268
2831,118,33,117,15,283
2832,117,16,117,15,265
2833,118,33,116,18,285
2834,130,34,117,15,296
2836,117,17,117,15,266
2837,117,33,117,16,283
2838,115,18,117,16,266
2839,116,32,119,16,283
2841,115,35,115,17,282
2842,116,18,115,17,266
2843,117,32,118,16,283
2844,117,15,118,16,266
2845,117,34,117,16,284
2846,117,16,117,16,266
2847,116,34,117,14,281
2848,119,16,117,14,266
2849,118,32,114,19,283
2850,115,17,114,19,265
2851,115,34,115,18,282
2852,118,16,115,18,267
2853,116,33,117,17,283
2855,115,32,102,17,266
2856,117,14,102,17,250
2857,102,14,102,17,235
2859,115,34,117,17,283
2860,115,18,117,17,267
2862,117,17,117,17,268
2863,116,32,117,19,284
2865,119,35,101,14,269
2866,117,18,101,14,250
2867,119,33,132,18,302
2869,117,34,132,17,300
2870,117,17,132,17,283
2871,117,34,115,17,283
2873,119,33,116,16,284
2874,101,33,116,16,266
2876,132,34,117,19,302
2877,115,34,117,19,285
2878,116,16,117,19,268
2879,117,34,102,17,270
2880,115,17,102,17,251
2882,116,16,117,17,266
2883,117,34,117,15,283
2886,117,19,130,18,284
2887,119,32,131,17,299
2888,102,32,131,17,282
2890,117,17,132,18,284
2892,100,32,118,17,267
2896,116,15,117,18,266
2900,118,17,132,17,284
2901,101,17,132,17,267
2903,115,35,117,16,283
2904,117,18,117,16,268
2906,101,33,116,18,268
2907,116,33,117,16,282
2909,117,33,116,19,285
2910,118,16,116,19,269
2911,101,16,116,19,252
2912,117,16,116,18,267
2913,116,34,117,16,283
2914,116,18,117,16,267
2915,118,32,117,16,283
2917,116,35,116,16,283
2918,116,19,116,16,267
2920,101,33,115,17,266
2922,117,16,116,16,265
2923,117,32,118,16,283
2924,117,16,118,16,267
2925,117,34,100,17,268
2927,117,33,118,16,284
2928,115,17,118,16,266
2929,115,33,118,17,283
2930,116,16,118,17,267
2931,116,34,116,19,285
2932,118,16,116,19,269
2933,116,34,101,15,266
2934,100,34,101,15,250
2935,118,33,117,17,285
2936,118,16,117,17,268
2938,118,17,115,17,267
2941,118,32,115,22,287
2942,101,32,115,22,270
2943,116,34,116,16,282
2944,117,17,116,16,266
2946,115,17,118,16,266
2947,117,34,117,15,283
2948,115,17,117,15,264
2949,117,37,130,16,300
2952,103,29,117,17,266
2955,117,32,117,19,285
2957,117,35,117,16,285
2958,130,33,117,16,296
2959,117,33,117,16,283
2960,117,17,117,16,267
2961,116,33,117,18,284
2962,116,17,117,18,268
2963,116,35,114,18,283
2964,117,19,114,18,268
2965,118,32,117,16,283
2966,117,16,117,16,266
2968,117,16,118,16,267
2969,117,35,116,15,283
2972,100,32,116,18,266
2974,117,16,121,13,267
2975,116,34,118,16,284
2976,118,16,118,16,268
2977,117,32,117,17,283
2978,116,15,117,17,265
2980,116,18,116,16,266
2981,117,33,117,17,284
2982,101,33,117,17,268
2983,116,34,116,16,282
2984,118,16,116,16,266
2985,117,32,117,17,283
2987,117,33,118,16,284
2989,112,35,114,18,279
2990,117,17,114,18,266
2991,116,32,117,16,281
2994,100,34,116,17,267
2995,117,33,116,16,282
2996,101,33,116,16,266
2997,116,33,116,17,282
2998,114,18,116,17,265
3000,117,16,117,18,268
3001,116,34,116,19,285
3003,116,32,118,20,286
3006,116,17,104,14,251
3007,116,35,116,16,283
3009,118,34,133,16,301
3010,116,19,133,16,284
3011,119,35,114,15,283
3012,118,20,114,15,267
3014,104,31,115,16,266
3015,118,32,116,19,285
3016,116,16,116,19,267
3019,134,15,117,18,284
3020,114,15,117,18,264
3022,115,16,117,17,265
3023,115,36,116,16,283
3024,116,19,116,16,267
3026,115,17,118,14,264
3027,116,34,116,17,283
3028,101,34,116,17,268
3029,118,32,101,17,268
3031,100,17,101,17,235
3032,116,16,116,18,266
3033,117,32,119,14,282
3035,116,35,132,18,301
3036,116,17,132,18,283
3037,118,32,118,16,284
3038,101,32,118,16,267
3040,116,18,133,17,284
3041,116,31,119,17,283
3043,115,34,117,17,283
3044,116,16,117,17,266
3045,133,16,116,19,284
3047,117,34,116,16,283
3048,133,34,133,17,317
3050,119,17,133,17,286
3051,101,17,133,17,268
3052,117,17,118,15,267
3053,116,35,116,16,283
3054,116,19,116,16,267
3056,116,16,118,16,266
3058,115,18,117,16,266
3061,117,34,117,15,283
3062,116,16,117,15,264
3063,117,33,117,16,283
3064,101,33,117,16,267
3065,117,34,116,18,285
3066,117,16,116,18,267
3068,118,15,120,15,268
3071,115,34,117,17,283
3072,117,16,117,17,267
3073,115,35,115,18,283
3074,116,18,115,18,267
3075,117,33,115,17,282
3076,120,15,115,17,267
3078,102,32,116,17,267
3079,116,34,117,16,283
3082,115,18,117,16,266
3083,115,32,117,17,281
3084,115,17,117,17,266
3085,117,33,117,17,284
3086,116,17,117,17,267
3088,117,16,117,16,266
3089,117,34,117,17,285
3090,117,16,117,17,267
3093,118,33,116,17,284
3094,101,33,116,17,267
3095,116,33,117,17,283
3097,115,35,115,20,285
3098,117,17,115,20,269
3099,118,33,115,17,283
3100,118,16,115,17,266
3101,118,32,117,16,283
3103,116,34,116,17,283
3104,117,17,116,17,267
3105,116,36,131,17,300
3106,115,20,131,17,283
3107,118,30,118,16,282
3108,115,17,118,16,266
3109,117,33,117,16,283
3110,117,16,117,16,266
3111,116,34,117,16,283
3112,116,17,117,16,266
3113,117,34,117,16,284
3114,131,33,116,18,298
3116,101,33,116,18,268
3117,117,32,118,16,283
3118,101,32,118,16,267
3119,116,34,116,17,283
3121,117,34,116,17,284
3122,117,16,116,17,266
3123,116,34,133,15,298
3125,118,32,134,17,301
3126,118,16,134,17,285
3127,116,33,118,17,284
3128,116,17,118,17,268
3129,115,34,101,17,267
3130,116,17,101,17,251
3132,133,33,133,17,316
3133,117,33,133,17,300
3134,116,18,133,17,284
3136,118,17,133,16,284
3138,101,34,131,17,283
3139,102,17,131,17,267
3140,101,32,116,18,267
3142,133,34,116,17,300
3146,115,16,118,16,265
3147,117,35,117,16,285
3149,117,32,118,15,282
3150,101,32,118,15,266
3151,116,34,117,16,283
3152,116,17,117,16,266
3153,117,33,117,16,283
3155,117,34,117,15,283
3157,116,32,118,16,282
3158,101,32,118,16,267
3159,116,34,116,18,284
3161,116,33,118,16,283
3164,117,15,120,14,266
3165,115,34,117,16,282
3167,116,34,116,17,283
3168,116,18,116,17,267
3169,117,33,116,16,282
3170,101,33,116,16,266
3172,101,33,116,17,267
3175,117,34,117,17,285
3176,116,17,117,17,267
3177,116,32,119,16,283
3178,116,16,119,16,267
3180,116,17,118,15,266
3182,117,18,133,15,283
3183,118,33,115,17,283
3184,101,33,115,17,266
3185,118,33,116,16,283
3187,118,32,117,17,284
3188,118,15,117,17,267
3189,116,35,115,18,284
3192,115,17,118,17,267
3193,115,33,118,16,282
3196,117,17,119,15,268
3199,118,34,116,15,283
3201,118,32,117,17,284
3202,102,32,117,17,268
3203,117,34,117,15,283
3204,100,34,117,15,266
3206,120,14,115,16,265
3207,117,31,117,17,282
3208,116,15,117,17,265
3211,115,32,118,16,281
3212,117,15,118,16,266
3214,115,16,117,18,266
3216,117,17,116,17,267
3217,116,35,115,17,283
3218,116,18,115,17,266
3219,117,32,117,17,283
3220,102,32,117,17,268
3221,117,34,117,16,284
3222,101,34,117,16,268
3224,116,17,118,16,267
3225,133,17,116,17,283
3226,115,17,116,17,265
3227,116,34,117,17,284
3228,117,17,117,17,268
3229,118,33,117,16,284
3231,118,33,119,14,284
3232,118,16,119,14,267
3233,117,33,117,17,284
3234,116,17,117,17,267
3235,116,35,133,16,300
3236,117,17,133,16,283
3238,117,16,117,17,267
3239,116,33,116,18,283
3241,117,34,117,16,284
3242,117,17,117,16,267
3243,116,34,116,16,282
3244,133,33,115,17,298
3245,133,17,115,17,282
3247,115,33,116,18,282
3249,117,33,118,15,283
3250,117,16,118,15,266
3252,116,16,117,16,265
3256,116,18,115,18,267
3258,118,15,118,16,267
3259,116,33,118,17,284
3262,117,17,117,18,269
3263,117,34,117,14,282
3265,116,33,118,16,283
3267,117,34,116,18,285
3269,118,34,115,16,283
3270,117,18,115,16,266
3271,119,30,101,18,268
3272,117,14,101,18,250
3273,114,36,134,16,300
3274,118,16,134,16,284
3275,117,34,116,15,282
3277,118,31,118,17,284
3278,115,16,118,17,266
3279,115,34,116,17,282
3280,101,34,116,17,268
3281,115,35,115,17,282
3282,134,31,118,16,299
3283,118,31,118,16,283
3284,116,15,118,16,265
3286,118,17,116,17,268
3287,117,32,118,16,283
3288,116,17,118,16,267
3289,115,34,116,17,282
3290,115,17,116,17,265
3291,116,33,117,18,284
3293,116,34,116,21,287
3294,116,17,116,21,270
3295,118,33,104,13,268
3296,118,16,104,13,251
3297,117,33,134,16,300
3298,116,17,134,16,283
3299,116,35,131,17,299
3300,117,18,131,17,283
3301,118,36,112,16,282
3304,104,30,117,15,266
3306,134,32,117,17,300
3307,117,32,117,17,283
3309,116,33,118,16,283
3310,112,16,118,16,262
3311,115,34,117,17,283
3312,117,15,117,17,266
3314,116,16,117,16,265
3315,116,34,117,16,283
3316,117,17,117,16,267
3317,117,33,117,16,283
3318,118,16,117,16,267
3319,115,34,117,16,282
3321,117,32,118,15,282
3322,117,16,118,15,266
3324,117,16,118,16,267
3326,117,16,118,16,267
3327,116,34,118,16,284
3328,117,16,118,16,267
3330,118,15,119,16,268
3331,115,35,118,14,282
3332,118,16,118,14,266
3333,117,33,116,19,285
3334,101,33,116,19,269
3335,116,34,117,17,284
3336,118,16,117,17,268
3342,116,19,116,16,267
3343,117,33,116,16,282
3344,117,17,116,16,266
3345,117,32,117,17,283
3346,117,16,117,17,267
3348,117,18,116,17,268
3349,118,33,116,18,285
3350,116,16,116,18,266
3352,116,16,116,20,268
3353,116,34,116,17,283
3354,117,17,116,17,267
3355,118,33,134,15,300
3356,116,17,134,15,282
3357,116,34,133,17,300
3358,116,18,133,17,284
3360,116,20,131,16,283
3362,116,17,116,17,266
3364,134,33,115,19,301
3366,115,18,115,19,267
3367,118,33,117,16,284
3368,115,16,117,16,264
3369,117,33,117,17,284
3370,116,17,117,17,267
3371,117,34,115,18,284
3372,116,17,115,18,266
3373,118,34,117,16,285
3374,115,19,117,16,267
3376,101,32,116,17,266
3377,117,34,116,17,284
3378,117,17,116,17,267
3379,117,33,116,16,282
3381,118,34,116,14,282
3383,117,32,116,19,284
3384,116,17,116,19,268
3385,116,34,117,16,283
3386,116,17,117,16,266
3387,118,32,118,17,285
3388,116,16,118,17,267
3393,118,32,117,16,283
3396,101,34,116,16,267
3397,117,33,117,16,283
3398,103,33,117,16,269
3399,118,32,117,18,285
3400,116,15,117,18,266
3401,115,34,117,17,283
3402,117,16,117,17,267
3403,116,33,118,15,282
3404,116,16,118,15,265
3406,117,16,116,16,265
3407,116,34,117,16,283
3408,101,34,117,16,268
3409,117,33,117,17,284
3410,101,33,117,17,268
3411,117,32,118,17,284
3413,115,33,118,16,282
3415,116,35,116,17,284
3417,117,34,117,16,284
3419,117,33,115,17,282
3420,102,33,115,17,267
3421,118,32,118,16,284
3422,102,32,118,16,268
3423,115,34,117,17,283
3424,116,17,117,17,267
3425,134,16,117,16,283
3427,101,16,117,16,250
3428,115,17,118,15,265
3430,118,16,116,19,269
3431,117,34,116,16,283
3432,117,17,116,16,266
3434,117,16,116,18,267
3435,118,32,117,17,284
3436,101,32,117,17,267
3438,116,19,114,17,266
3439,118,31,117,17,283
3441,115,35,117,18,285
3442,116,18,117,18,269
3443,117,32,117,17,283
3444,117,17,117,17,268
3445,117,33,117,17,284
3447,116,34,118,17,285
3448,117,17,118,17,269
3450,117,18,113,17,265
3451,120,31,116,17,284
3452,103,31,116,17,267
3453,118,33,117,17,285
3454,101,33,117,17,268
3455,117,35,116,16,284
3456,118,17,116,16,267
3458,113,17,119,14,263
3459,116,34,118,16,284
3460,116,17,118,16,267
3461,117,34,116,17,284
3462,100,34,116,17,267
3463,116,33,117,17,283
3464,116,16,117,17,266
3465,118,32,119,16,285
3466,119,14,119,16,268
3467,116,35,117,16,284
3468,118,16,117,16,267
3469,117,33,116,16,282
3470,116,17,116,16,265
3473,116,33,116,16,281
3474,102,33,116,16,267
3475,116,33,116,18,283
3477,117,32,118,17,284
3478,116,16,118,17,267
3479,115,36,115,18,284
3480,116,18,115,18,267
3484,116,18,117,16,267
3485,118,33,115,17,283
3489,118,33,116,17,284
3490,102,33,116,17,268
3491,118,33,117,16,284
3492,117,16,117,16,266
3493,117,32,116,19,284
3494,115,17,116,19,267
3495,116,35,115,17,283
3496,116,17,115,17,265
3498,100,33,117,17,267
3500,117,16,117,15,265
3502,116,19,133,17,285
3505,116,35,115,16,282
3506,117,17,115,16,265
3508,117,15,118,17,267
3509,117,35,116,16,284
3510,116,17,116,16,265
3511,118,36,130,16,300
3513,119,29,117,18,283
3515,115,35,116,16,282
3520,130,34,116,16,296
3524,100,32,118,16,266
3527,118,32,118,17,285
3529,101,16,118,17,252
3530,116,16,102,15,249
3532,118,16,132,19,285
3533,116,33,118,15,282
3534,117,15,118,15,265
3537,118,31,118,16,283
3538,102,31,118,16,267
3541,114,34,117,16,281
3542,118,15,117,16,266
3543,115,33,119,16,283
3545,116,34,117,16,283
3546,118,16,117,16,267
3547,117,35,116,16,284
3550,102,31,117,17,267
3551,116,35,116,17,284
3553,117,32,118,15,282
3554,101,32,118,15,266
3555,116,34,117,16,283
3556,116,16,117,16,265
3557,117,33,117,16,283
3558,117,17,117,16,267
3559,115,34,116,17,282
3560,116,17,116,17,266
3561,117,32,118,17,284
3563,115,34,117,17,283
3564,117,16,117,17,267
3565,117,33,118,15,283
3566,100,33,118,15,266
3567,116,34,117,17,284
3568,116,17,117,17,267
3569,116,34,113,21,284
3570,101,34,113,21,269
3571,117,33,117,16,283
3572,117,17,117,16,267
3573,117,32,118,17,284
3574,101,32,118,17,268
3575,116,35,116,17,284
3576,117,17,116,17,267
3577,117,34,117,15,283
3578,113,21,117,15,266
3579,134,16,116,17,283
3582,101,34,116,18,269
3583,117,33,101,16,267
3584,116,17,101,16,250
3586,117,15,116,18,266
3587,116,33,101,17,267
3588,116,17,101,17,251
3589,116,35,115,18,284
3590,116,18,115,18,267
3594,116,18,133,17,284
3595,118,33,134,16,301
3596,101,33,134,16,284
3597,117,34,116,17,284
3598,115,18,116,17,266
3599,117,32,118,16,283
3600,119,15,118,16,268
3601,117,34,116,17,284
3602,133,34,115,19,301
3603,116,34,115,19,284
3607,116,33,118,14,281
3608,101,33,118,14,266
3609,118,33,117,16,284
3610,116,17,117,16,266
3612,115,19,115,18,267
3613,118,31,117,17,283
3615,115,33,119,15,282
3619,117,35,115,18,285
3620,115,18,115,18,266
3621,118,32,116,18,284
3622,102,32,116,18,268
3624,119,15,116,17,267
3625,116,34,116,17,283
3627,117,34,116,16,283
3629,118,33,116,17,284
3630,101,33,116,17,267
3632,116,17,120,13,266
3633,116,34,116,18,284
3635,117,33,118,17,285
3636,116,16,118,17,267
3637,117,34,117,17,285
3638,116,17,117,17,267
3640,101,32,117,17,267
3641,116,35,117,16,284
3643,117,34,116,17,284
3644,118,17,116,17,268
3645,118,33,116,16,283
3647,115,32,116,18,281
3649,117,34,117,17,285
3650,117,16,117,17,267
3651,116,34,115,19,284
3652,116,17,115,19,267
3655,117,34,116,16,283
3657,116,34,115,17,282
3658,117,17,115,17,266
3660,115,19,115,17,266
3661,118,31,101,16,266
3663,117,33,102,14,266
3664,116,16,102,14,248
3665,115,34,118,16,283
3666,115,17,118,16,266
3667,117,34,116,18,285
3668,115,17,116,18,266
3669,118,34,115,17,284
3670,101,34,115,17,267
3671,100,18,115,17,250
3672,102,31,118,18,269
3676,116,18,116,18,268
3678,115,17,118,16,266
3679,118,35,116,16,285
3680,101,35,116,16,268
3681,117,32,116,17,282
3682,101,32,116,17,266
3683,117,35,133,15,300
3684,116,18,133,15,282
3686,102,32,116,18,268
3688,116,16,118,17,267
3689,116,33,118,16,283
3690,116,17,118,16,267
3691,116,35,116,17,284
3692,133,33,117,16,299
3693,117,33,117,16,283
3696,101,34,116,16,267
3701,118,33,117,16,284
3702,117,16,117,16,266
3703,116,33,117,16,282
3704,116,16,117,16,265
3705,116,33,117,19,285
3707,116,34,117,16,283
3708,117,16,117,16,266
3713,116,36,115,17,284
3714,100,36,115,17,268
3715,118,31,116,17,282
3716,117,16,116,17,266
3717,116,34,116,17,283
3718,116,18,116,17,267
3722,115,17,115,19,266
3723,117,32,118,17,284
3724,101,32,118,17,268
3726,116,17,101,17,251
3727,118,34,133,16,301
3729,132,19,115,17,283
3731,119,33,115,17,284
3733,118,32,117,16,283
3735,117,34,117,16,284
3737,118,33,116,18,285
3739,116,33,116,16,281
3740,115,17,116,16,264
3742,117,16,117,17,267
3743,117,34,116,16,283
3744,117,16,116,16,265
3745,117,34,117,15,283
3746,100,34,117,15,266
3749,115,35,117,16,283
3752,116,16,101,16,249
3756,117,19,115,16,267
3758,117,16,116,17,266
3759,117,33,119,15,284
3760,101,33,119,15,268
3761,115,33,118,17,283
3762,117,16,118,17,268
3763,117,33,119,16,285
3764,115,16,119,16,266
3765,115,34,118,16,283
3766,116,17,118,16,267
3767,117,34,116,16,283
3768,119,15,116,16,266
3769,117,34,132,18,301
3773,118,33,117,17,285
3774,101,33,117,17,268
3778,132,34,117,17,300
3780,117,16,117,17,267
3782,117,17,115,18,267
3783,118,33,117,16,284
3784,102,33,117,16,268
3786,101,34,116,17,268
3788,101,33,116,15,265
3789,117,33,115,16,281
3790,115,18,115,16,264
3792,117,16,116,16,265
3793,116,34,115,17,282
3794,116,17,115,17,265
3795,117,31,118,17,283
3796,116,15,118,17,266
3798,115,16,119,15,265
3799,114,34,117,17,282
3800,116,16,117,17,266
3801,115,34,119,15,283
3802,115,17,119,15,266
3803,116,34,116,18,284
3804,101,34,116,18,269
3805,118,32,118,15,283
3806,102,32,118,15,267
3807,116,34,116,17,283
3808,117,17,116,17,267
3809,117,34,118,15,284
3810,119,15,118,15,267
3812,116,18,115,18,267
3813,117,31,117,17,282
3814,118,15,117,17,267
3815,116,34,118,17,285
3816,116,17,118,17,268
3817,114,34,116,16,280
3821,117,32,117,18,284
3822,102,32,117,18,269
3823,117,35,116,16,284
3825,116,31,117,18,282
3827,116,35,119,13,283
3828,116,17,119,13,265
3830,117,18,117,17,269
3832,116,16,117,16,265
3833,117,34,116,17,284
3834,117,18,116,17,268
3836,119,13,118,16,266
3837,116,36,115,16,283
3838,117,17,115,16,265
3839,118,31,118,16,283
3841,117,34,116,17,284
3843,114,33,116,18,281
3844,118,16,116,18,268
3846,115,16,118,17,266
3847,116,34,117,16,283
3849,117,33,117,17,284
3853,117,34,114,18,283
3854,118,17,114,18,267
3855,117,32,117,18,284
3856,117,16,117,18,268
3857,117,34,116,17,284
3859,118,33,121,13,285
3860,117,16,121,13,267
3861,116,33,116,18,283
3865,118,32,118,15,283
3867,116,34,116,16,282
3868,121,13,116,16,266
3869,119,33,116,17,285
3870,101,33,116,17,267
3871,117,33,117,16,283
3873,117,33,117,17,284
3875,112,33,116,18,279
3876,116,16,116,18,266
3877,117,34,117,17,285
3879,117,33,116,17,283
3880,117,16,116,17,266
3881,115,34,117,16,282
3882,117,17,117,16,267
3884,116,18,116,16,266
3885,117,34,115,18,284
3887,117,32,117,17,283
3888,116,17,117,17,267
3889,116,34,116,17,283
3890,117,16,116,17,266
3891,118,32,119,15,284
3892,100,32,119,15,266
3894,115,18,118,15,266
3895,118,33,118,16,285
3897,116,33,116,17,282
3898,116,17,116,17,266
3899,117,33,117,17,284
3900,101,33,117,17,268
3901,102,15,117,17,251
3902,118,15,118,16,267
3903,117,34,115,17,283
3904,118,16,115,17,266
3905,118,32,117,16,283
3907,115,34,116,16,281
3911,116,32,118,15,281
3912,115,17,118,15,265
3913,117,33,118,16,284
3914,117,16,118,16,267
3915,116,33,101,18,268
3916,116,16,101,18,251
3918,116,17,116,17,266
3919,118,32,118,16,284
3921,116,34,117,17,284
3924,101,34,117,13,265
3925,117,33,116,18,284
3927,116,33,116,18,283
3928,118,16,116,18,268
3929,116,34,116,16,282
3930,117,17,116,16,266
3931,116,30,102,17,265
3932,100,30,102,17,249
3933,101,13,102,17,233
3934,116,18,132,16,282
3935,117,33,115,17,282
3936,116,18,115,17,266
3937,117,32,118,17,284
3939,115,34,118,16,283
3940,102,34,118,16,270
3941,117,33,117,18,285
3942,115,17,117,18,267
3943,117,33,117,17,284
3945,116,35,116,17,284
3946,118,17,116,17,268
3947,118,33,117,16,284
3949,118,34,116,17,285
3950,117,18,116,17,268
3951,119,32,116,17,284
3952,117,17,116,17,267
3953,116,34,117,16,283
3955,116,33,116,17,282
3956,117,16,116,17,266
3957,117,34,116,16,283
3959,118,32,117,16,283
3961,116,34,118,16,284
3962,117,16,118,16,267
3963,116,33,116,17,282
3964,116,17,116,17,266
3965,116,33,118,16,283
3966,116,16,118,16,266
3967,134,16,117,17,284
3969,115,35,115,18,283
3972,116,17,118,15,266
3974,118,16,134,16,284
3976,117,17,117,17,268
3977,131,18,115,17,281
3978,115,18,115,17,265
3979,118,32,117,18,285
3980,101,32,117,18,268
3981,115,35,116,18,284
3982,134,33,115,17,299
3984,117,17,115,17,266
3986,115,17,117,18,267
3987,132,18,115,18,283
3990,116,18,115,17,266
3991,118,31,117,18,284
3994,117,18,117,16,268
3995,118,33,115,18,284
3997,117,33,117,17,284
3999,118,34,115,17,284
4000,117,18,115,17,267
4001,118,33,116,18,285
4002,117,16,116,18,267
4003,118,33,117,17,285
4004,115,18,117,17,267
4005,117,34,115,20,286
4006,100,34,115,20,269
4008,115,17,116,18,266
4009,115,35,115,18,283
4010,116,18,115,18,267
4011,119,33,117,15,284
4013,117,35,115,16,283
4015,120,31,116,18,285
4020,100,32,134,18,284
4021,117,34,118,16,285
4022,115,16,118,16,265
4024,100,34,115,18,267
4026,115,18,115,17,265
4027,116,33,116,17,282
4029,116,34,116,17,283
4031,102,16,116,17,251
4032,115,18,115,19,267
4033,118,32,117,17,284
4035,115,34,117,16,282
4036,116,17,117,16,266
4038,116,17,116,17,266
4040,115,19,115,18,267
4041,119,32,116,18,285
4042,117,17,116,18,268
4043,117,33,118,16,284
4045,116,34,116,17,283
4046,116,17,116,17,266
4047,118,34,116,16,284
4048,115,18,116,16,265
4049,118,33,117,16,284
4050,116,18,117,16,267
4051,117,33,117,16,283
4052,118,16,117,16,267
4053,117,33,118,15,283
4054,116,17,118,15,266
4055,117,33,117,17,284
4056,116,16,117,17,266
4058,117,16,117,17,267
4060,100,33,116,17,266
4061,117,33,117,18,285
4062,118,15,117,18,268
4063,116,34,117,16,283
4064,117,17,117,16,267
4065,116,34,116,16,282
4066,100,34,116,16,266
4068,101,32,118,16,267
4071,118,32,117,17,284
4072,117,16,117,17,267
4076,118,16,101,16,251
4077,117,33,117,18,285
4079,116,34,117,16,283
4081,117,34,116,16,283
4083,117,32,118,16,283
4085,118,35,116,16,285
4086,117,18,116,16,267
4087,118,32,117,16,283
4089,116,33,117,16,282
4093,117,33,116,18,284
4095,116,33,117,17,283
4096,117,16,117,17,267
4097,116,33,101,15,265
4099,115,33,117,18,283
4100,116,16,117,18,267
4101,115,35,115,16,281
4103,117,33,115,19,284
4104,101,33,115,19,268
4105,117,32,119,15,283
4106,101,32,119,15,267
4107,116,35,115,18,284
4108,117,18,115,18,268
4109,118,31,118,16,283
4110,115,16,118,16,265
4111,115,36,115,16,282
4112,115,19,115,16,265
4113,119,32,117,16,284
4115,117,34,117,15,283
4116,115,18,117,15,265
4117,118,32,117,17,284
4118,118,16,117,17,268
4120,115,16,118,16,265
4122,117,16,117,17,267
4123,117,33,118,16,284
4124,117,15,118,16,266
4126,117,17,117,17,268
4127,117,33,117,17,284
4128,101,33,117,17,268
4129,116,34,117,15,282
4130,117,17,117,15,266
4131,116,33,116,18,283
4132,118,16,116,18,268
4133,117,34,115,17,283
4134,117,17,115,17,266
4135,117,33,117,16,283
4136,117,17,117,16,267
4137,117,32,118,16,283
4138,117,15,118,16,266
4141,117,32,118,17,284
4143,116,34,116,18,284
4145,116,33,118,15,282
4147,117,34,116,17,284
4148,116,17,116,17,266
4149,118,34,117,16,285
4150,101,34,117,16,268
4151,117,33,117,16,283
4154,118,15,118,16,267
4155,116,34,117,17,284
4157,116,34,116,17,283
4159,118,33,116,18,285
4160,117,16,116,18,267
4162,118,16,118,15,267
4163,117,34,116,16,283
4164,117,17,116,16,266
4165,116,33,117,16,282
4166,116,17,117,16,266
4167,116,34,115,19,284
4168,116,18,115,19,268
4169,117,32,118,16,283
4170,118,15,118,16,267
4171,116,33,117,18,284
4174,117,16,118,16,267
4175,117,35,116,16,284
4177,117,32,116,16,281
4179,117,34,115,17,283
4180,117,18,115,17,267
4181,117,33,116,16,282
4183,118,33,117,16,284
4184,116,16,117,16,265
4185,116,32,118,16,282
4187,116,34,118,16,284
4190,116,16,117,17,266
4191,115,34,118,16,283
4192,117,16,118,16,267
4194,118,16,118,17,269
4195,117,34,117,15,283
4196,118,16,117,15,266
4197,117,33,117,18,285
4199,116,34,116,16,282
4200,118,16,116,16,266
4203,117,31,119,15,282
4204,117,15,119,15,266
4205,116,36,116,16,284
4206,117,18,116,16,267
4208,116,16,119,15,266
4209,115,33,118,16,282
4210,115,16,118,16,265
4211,115,34,118,17,284
4213,116,34,117,16,283
4214,116,16,117,16,265
4215,117,33,117,16,283
4217,117,33,117,16,283
4218,118,16,117,16,267
4219,115,35,116,16,282
4221,117,32,117,18,284
4222,117,16,117,18,268
4223,115,33,117,17,282
4225,116,33,118,17,284
4226,117,16,118,17,268
4227,115,34,116,17,282
4228,116,16,116,17,265
4229,116,35,116,15,282
4230,117,18,116,15,266
4231,118,32,117,16,283
4232,102,32,117,16,267
4236,116,17,117,16,266
4237,116,33,118,16,283
4239,116,34,116,18,284
4240,117,16,116,18,267
4243,117,33,134,16,300
4244,117,16,134,16,283
4245,115,34,133,17,299
4246,118,16,133,17,284
4247,116,34,116,17,283
4249,117,32,119,17,285
4250,101,32,119,17,269
4251,116,34,116,18,284
4252,134,33,117,17,301
4253,116,33,117,17,283
4254,116,17,117,17,267
4255,117,34,117,16,284
4256,116,17,117,16,266
4257,117,35,115,16,283
4259,118,32,116,17,283
4260,116,18,116,17,267
4262,101,33,117,16,267
4265,115,33,121,13,282
4267,117,34,117,17,285
4268,116,17,117,17,267
4269,117,33,117,16,283
4270,117,16,117,16,266
4271,116,33,118,17,284
4272,117,16,118,17,268
4274,121,13,116,16,266
4276,117,17,116,16,266
4278,117,16,117,16,266
4280,118,17,133,16,284
4281,114,31,118,17,280
4283,115,34,101,17,267
4284,116,16,101,17,250
4286,117,16,117,17,267
4287,115,35,115,17,282
4288,133,33,117,17,300
4289,118,33,117,17,285
4290,118,17,117,17,269
4293,101,15,117,17,250
4295,117,33,118,16,284
4296,115,17,118,16,266
4297,116,35,116,16,283
4298,117,17,116,16,266
4300,102,32,117,16,267
4301,117,33,116,19,285
4303,117,34,116,17,284
4308,117,16,117,18,268
4309,116,35,117,15,283
4311,117,32,117,16,282
4312,101,32,117,16,266
4315,116,35,116,16,283
4316,117,18,116,16,267
4317,119,32,116,18,285
4318,117,15,116,18,266
4320,117,16,117,17,267
4321,116,34,116,18,284
4323,117,33,118,15,283
4324,116,16,118,15,265
4326,116,18,116,17,267
4327,117,33,117,16,283
4328,117,17,117,16,267
4329,117,34,116,16,283
4331,117,32,117,17,283
4332,118,15,117,17,267
4336,117,16,118,16,267
4337,117,33,116,17,283
4338,116,16,116,17,265
4339,115,34,116,18,283
4340,117,17,116,18,268
4342,119,15,115,17,266
4343,102,15,115,17,249
4345,117,32,119,15,283
4347,116,35,117,17,285
4348,116,18,117,17,268
4349,115,32,117,17,281
4350,115,17,117,17,266
4351,115,33,118,16,282
4354,100,34,117,17,268
4357,119,32,116,18,285
4358,102,32,116,18,268
4360,118,16,118,15,267
4361,115,34,116,16,281
4362,117,17,116,16,266
4363,116,34,116,16,282
4364,133,33,116,16,298
4365,118,33,116,16,283
4366,116,18,116,16,266
4367,117,32,118,20,287
4368,101,32,118,20,271
4370,116,16,118,17,267
4371,115,34,116,18,283
4374,116,16,117,18,267
4376,118,20,128,18,284
4379,117,33,115,18,283
4380,116,18,115,18,267
4381,117,34,116,16,283
4382,117,18,116,16,267
4383,117,31,118,17,283
4385,115,35,115,17,282
4386,116,17,115,17,265
4387,118,33,117,17,285
4389,117,33,116,17,283
4390,116,16,116,17,265
4391,117,34,116,17,284
4392,118,17,116,17,268
4394,115,17,117,17,266
4397,117,32,116,18,283
4398,116,17,116,18,267
4400,116,17,118,15,266
4401,118,33,116,19,286
4404,117,16,115,18,266
4405,118,33,118,14,283
4406,116,18,118,14,266
4407,117,33,116,17,283
4408,118,15,116,17,266
4411,117,32,101,15,265
4412,101,32,101,15,249
4413,118,32,117,18,285
4414,118,14,117,18,267
4415,114,34,117,18,283
4417,117,35,117,15,284
4419,119,33,116,16,284
4420,101,33,116,16,266
4421,116,33,116,17,282
4422,117,18,116,17,268
4424,101,34,116,16,267
4425,117,32,118,16,283
4427,117,33,119,14,283
4428,116,16,119,14,265
4429,101,16,119,14,250
4430,116,17,117,16,266
4431,117,33,117,18,285
4432,116,16,117,18,267
4434,118,16,117,15,266
4435,117,32,118,15,282
4437,116,34,116,17,283
4438,117,16,116,17,266
4439,116,35,115,17,283
4442,117,15,118,16,266
4443,114,33,101,17,265
4444,118,15,101,17,251
4445,115,34,117,16,282
4446,116,17,117,16,266
4448,115,17,116,17,265
4449,116,33,118,15,282
4450,118,16,118,15,267
4451,116,34,116,17,283
4452,101,34,116,17,268
4453,118,32,117,18,285
4454,117,16,117,18,268
4455,116,34,116,17,283
4457,116,33,116,18,283
4458,118,15,116,18,267
4460,116,17,118,15,266
4461,117,34,116,17,284
4465,115,34,116,18,283
4467,117,33,116,18,284
4468,118,15,116,18,267
4469,117,34,100,15,266
4470,116,17,100,15,248
4471,118,34,133,17,302
4472,101,34,133,17,285
4473,119,33,132,16,300
4474,116,18,132,16,282
4475,116,33,133,17,299
4477,117,32,118,16,283
4480,133,32,116,17,298
4481,118,32,116,17,283
4482,117,15,116,17,265
4483,117,34,117,17,285
4484,133,33,116,18,300
4485,118,33,116,18,285
4486,118,16,116,18,268
4487,116,34,118,16,284
4488,115,18,118,16,267
4489,116,32,118,17,283
4490,101,32,118,17,268
4491,117,35,116,17,285
4492,117,17,116,17,267
4493,117,33,117,17,284
4495,118,34,115,17,284
4497,103,16,115,17,251
4498,118,17,115,17,267
4499,117,33,116,17,283
4500,100,33,116,17,266
4501,118,34,116,16,284
4502,100,34,116,16,266
4503,116,32,118,17,283
4504,115,17,118,17,267
4505,116,33,102,15,266
4506,115,17,102,15,249
4507,116,34,117,16,283
4508,116,17,117,16,266
4509,116,33,121,13,283
4510,116,16,121,13,266
4512,118,17,116,17,268
4513,119,32,116,17,284
4517,116,34,135,15,300
4518,100,34,135,15,284
4520,116,17,116,17,266
4521,118,32,101,15,266
4522,116,17,101,15,249
4523,116,34,116,17,283
4524,117,17,116,17,267
4525,113,35,132,17,297
4526,117,18,132,17,284
4527,118,32,132,17,299
4528,116,17,132,17,282
4530,101,32,117,18,268
4533,116,34,116,17,283
4536,117,15,117,17,266
4538,117,18,115,18,268
4540,116,17,117,16,266
4542,116,17,116,16,265
4543,116,33,116,17,282
4545,117,34,117,16,284
4546,115,18,117,16,266
4547,118,32,101,14,265
4548,117,16,101,14,248
4549,116,33,118,17,284
4550,116,16,118,17,267
4551,116,34,133,17,300
4552,116,17,133,17,283
4553,117,34,133,17,301
4554,117,16,133,17,283
4555,117,33,117,16,283
4556,101,33,117,16,267
4557,117,34,117,15,283
4559,118,32,118,16,284
4560,101,32,118,16,267
4561,115,34,117,16,282
4562,116,17,117,16,266
4565,116,33,117,16,282
4566,117,15,117,16,265
4567,116,34,116,18,284
4568,118,16,116,18,268
4569,117,33,118,16,284
4571,116,33,117,16,282
4572,117,16,117,16,266
4573,115,33,117,17,282
4574,117,16,117,17,267
4575,115,35,117,14,281
4576,116,18,117,14,265
4577,117,33,116,16,282
4578,118,16,116,16,266
4581,116,34,116,18,284
4582,117,17,116,18,268
4583,117,32,119,17,285
4584,117,14,119,17,267
4585,114,34,118,16,282
4587,134,15,117,17,283
4588,118,15,117,17,267
4589,116,35,117,16,284
4590,116,18,117,16,267
4591,116,34,116,15,281
4593,118,32,117,18,285
4594,118,16,117,18,269
4595,116,33,102,14,265
4596,117,17,102,14,250
4597,117,34,116,17,284
4599,116,32,119,15,282
4601,115,36,116,16,283
4603,119,31,118,16,284
4605,115,34,116,17,282
4606,116,17,116,17,266
4607,116,33,116,18,283
4608,119,15,116,18,268
4609,116,34,115,17,282
4610,116,16,115,17,264
4611,118,33,117,17,285
4612,101,33,117,17,268
4613,117,33,119,15,284
4614,116,17,119,15,267
4615,115,34,115,19,283
4616,116,18,115,19,268
4621,118,33,101,16,268
4623,118,34,117,16,285
4624,115,19,117,16,267
4625,119,33,117,17,286
4628,100,34,117,16,267
4629,116,32,118,16,282
4630,101,32,118,16,267
4631,118,34,116,17,285
4632,117,16,116,17,266
4633,118,34,117,16,285
4634,117,17,117,16,267
4635,118,33,117,16,284
4636,117,16,117,16,266
4638,118,16,117,16,267
4641,116,34,116,16,282
4642,117,16,116,16,265
4644,100,33,116,16,265
4645,116,33,117,17,283
4646,117,16,117,17,267
4647,117,33,117,16,283
4648,114,19,117,16,266
4649,115,33,119,15,282
4650,116,16,119,15,266
4652,116,16,118,16,266
4653,115,35,117,15,282
4654,117,17,117,15,266
4656,101,32,117,16,266
4657,116,34,116,18,284
4658,119,15,116,18,268
4659,117,33,118,16,284
4660,118,16,118,16,268
4662,117,15,116,19,267
4663,116,33,117,18,284
4664,117,16,117,18,268
4666,116,18,115,17,266
4667,117,33,117,16,283
4668,101,33,117,16,267
4669,116,34,116,15,281
4670,116,19,116,15,266
4671,118,33,133,17,301
4673,118,32,118,16,284
4674,115,17,118,16,266
4675,115,34,117,16,282
4676,117,16,117,16,266
4677,118,32,118,16,284
4678,116,15,118,16,265
4679,101,15,118,16,250
4680,133,33,117,16,299
4682,118,16,117,16,267
4683,116,33,117,16,282
4684,117,16,117,16,266
4686,101,33,117,17,268
4687,115,34,116,16,281
4688,116,17,116,16,265
4689,116,33,116,17,282
4690,117,16,116,17,266
4691,116,33,116,19,284
4692,117,16,116,19,268
4694,117,17,116,18,268
4695,117,32,117,17,283
4696,116,16,117,17,266
4697,115,34,116,17,282
4698,116,17,116,17,266
4701,118,33,120,13,284
4702,116,18,120,13,267
4703,118,32,118,15,283
4704,117,17,118,15,267
4705,117,33,117,17,284
4708,115,18,99,18,250
4710,120,13,116,16,265
4711,118,32,117,19,286
4714,117,17,118,16,268
4716,99,32,120,16,267
4718,116,16,116,18,266
4719,115,36,115,17,283
4721,119,32,116,17,284
4723,116,34,116,16,282
4724,120,16,116,16,268
4725,118,32,117,17,284
4726,116,18,117,17,268
4727,117,34,117,16,284
4728,115,17,117,16,265
4729,116,33,116,18,283
4731,115,33,118,15,281
4732,116,16,118,15,265
4733,118,34,116,20,288
4735,117,33,116,17,283
4737,117,34,116,17,284
4741,116,37,114,17,284
4742,116,20,114,17,267
4743,119,30,101,15,265
4745,117,34,115,17,283
4750,114,17,115,17,263
4753,116,33,117,18,284
4754,115,17,117,18,267
4759,117,35,116,17,285
4760,100,35,116,17,268
4761,119,33,117,15,284
4762,102,33,117,15,267
4763,117,33,116,16,282
4766,116,18,117,16,267
4768,116,17,115,18,266
4770,117,15,118,17,267
4771,115,33,117,16,281
4772,116,16,117,16,265
4773,117,34,116,17,284
4774,117,16,116,17,266
4775,116,34,116,17,283
4776,115,18,116,17,266
4777,116,34,116,15,281
4778,101,34,116,15,266
4779,118,31,118,16,283
4780,102,31,118,16,267
4783,117,34,102,14,267
4784,116,17,102,14,249
4785,116,32,119,15,282
4787,116,34,117,17,284
4788,118,16,117,17,268
4789,117,36,116,15,284
4791,119,30,117,18,284
4792,102,30,117,18,267
4793,115,34,118,17,284
4794,119,15,118,17,269
4795,116,34,116,18,284
4796,117,17,116,18,268
4797,116,33,117,17,283
4799,117,34,119,14,284
4804,116,18,115,18,267
4805,116,33,115,17,281
4806,117,17,115,17,266
4808,119,14,116,18,267
4810,116,16,118,16,266
4811,117,34,117,17,285
4814,100,32,117,18,267
4815,113,35,116,16,280
4816,116,18,116,16,266
4818,118,16,117,15,266
4820,117,17,132,17,283
4821,119,33,116,16,284
4823,118,32,118,16,284
4825,115,33,118,17,283
4826,117,15,118,17,267
4827,115,34,116,18,283
4828,132,33,101,18,284
4829,117,33,101,18,269
4831,116,34,117,16,283
4833,116,34,119,14,283
4834,118,17,119,14,268
4835,118,33,115,17,283
4836,116,18,115,17,266
4837,117,33,117,17,284
4838,101,33,117,17,268
4840,117,16,117,16,266
4841,116,34,116,16,282
4842,119,14,116,16,265
4845,114,35,116,16,281
4847,117,32,118,17,284
4849,113,33,118,17,281
4850,116,16,118,17,267
4853,115,34,119,16,284
4855,116,35,115,18,284
4856,118,17,115,18,268
4857,118,33,117,17,285
4859,117,32,117,18,284
4861,116,35,117,16,284
4862,119,16,117,16,268
4864,115,18,116,16,265
4867,117,33,115,19,284
4868,102,33,115,19,269
4870,117,16,116,17,266
4871,118,32,101,17,268
4872,116,16,101,17,250
4873,115,33,117,17,282
4874,115,16,117,17,265
4877,117,32,133,16,298
4881,101,15,117,19,252
4882,117,17,117,16,267
4883,117,33,118,16,284
4884,115,16,118,16,265
4885,116,34,117,17,284
4887,116,35,114,18,283
4888,117,19,114,18,268
4889,119,31,116,19,285
4890,102,31,116,19,268
4892,118,16,117,16,267
4893,117,34,116,16,283
4894,117,17,116,16,266
4895,118,33,117,16,284
4896,114,18,117,16,265
4898,101,34,115,16,266
4899,117,32,116,18,283
4900,117,16,116,18,267
4902,116,16,118,17,267
4903,117,34,116,18,285
4904,117,16,116,18,267
4906,115,16,102,17,250
4907,115,35,118,14,282
4909,117,34,116,15,282
4911,117,33,115,19,284
4912,116,18,115,19,268
4913,118,33,118,16,285
4914,102,33,118,16,269
4915,102,16,118,16,252
4917,115,33,118,17,283
4918,116,15,118,17,266
4919,101,15,118,17,251
4920,115,19,116,15,265
4921,117,33,117,16,283
4922,118,16,117,16,267
4923,116,32,118,16,282
4924,118,16,118,16,268
4925,116,34,117,17,284
4927,118,32,116,19,285
4930,117,16,116,16,265
4931,117,33,116,18,284
4932,101,33,116,18,268
4933,117,34,116,16,283
4934,100,34,116,16,266
4935,117,33,116,16,282
4937,116,32,117,18,283
4939,115,35,115,16,281
4940,116,18,115,16,265
4942,116,16,117,16,265
4943,118,33,118,15,284
4945,116,35,116,16,283
4946,117,18,116,16,267
4949,115,34,118,16,283
4951,116,33,117,16,282
4952,118,15,117,16,266
4954,116,16,117,16,265
4955,117,34,116,16,283
4956,101,34,116,16,267
4957,117,33,116,17,283
4958,118,16,116,17,267
4960,117,16,117,17,267
4962,117,16,118,16,267
4964,116,16,117,19,268
4965,115,34,121,14,284
4966,116,17,121,14,268
4967,117,33,116,19,285
4968,117,17,116,19,269
4969,116,34,119,14,283
4970,118,16,119,14,267
4972,117,19,116,16,268
4973,119,33,115,16,283
4974,102,33,115,16,266
4976,102,33,116,16,267
4977,117,32,117,16,282
4978,119,14,117,16,266
4980,116,16,116,17,265
4981,113,32,101,18,264
4982,115,16,101,18,250
4985,114,33,117,17,281
4987,115,34,117,16,282
4988,116,17,117,16,266
4989,117,33,117,16,283
4992,116,17,117,17,267
4996,117,16,116,18,267
4997,115,33,118,18,284
4998,117,16,118,18,269
4999,117,34,102,15,268
5000,117,17,102,15,251
5001,117,33,119,15,284
5002,117,16,119,15,267
5004,116,18,118,15,267
5006,101,35,114,17,267
5007,119,29,118,18,284
5010,119,15,116,17,267
5011,118,33,116,18,285
5013,116,33,119,15,283
5014,114,17,119,15,265
5018,116,17,118,16,267
5019,115,34,117,16,282
5020,116,18,117,16,267
5021,118,33,116,17,284
5022,119,15,116,17,267
5024,115,17,117,18,267
5025,116,35,117,15,283
5026,118,16,117,15,266
5027,118,33,116,18,285
5029,115,33,117,16,281
5032,117,18,116,17,268
5034,117,15,116,17,265
5035,115,35,116,15,281
5036,116,18,116,15,265
5038,117,16,117,16,266
5039,117,34,116,17,284
5040,116,17,116,17,266
5041,116,32,117,18,283
5042,101,32,117,18,268
5043,116,33,117,17,283
5044,116,15,117,17,265
5045,115,34,118,17,284
5048,116,17,118,15,266
5049,118,34,115,17,284
5050,101,34,115,17,267
5053,116,35,116,16,283
5054,118,17,116,16,267
5055,118,32,118,16,284
5056,118,15,118,16,267
5060,117,17,117,17,268
5061,116,33,116,19,284
5062,99,33,116,19,267
5064,118,16,116,16,266
5065,118,33,116,17,284
5066,118,16,116,17,267
5067,117,34,117,15,283
5068,117,17,117,15,266
5070,101,34,133,16,284
5073,115,34,117,16,282
5076,117,15,116,19,267
5077,117,35,115,17,284
5078,133,31,118,18,300
5079,134,15,118,18,285
5082,117,16,117,17,267
5083,115,35,115,18,283
5084,100,35,115,18,268
5085,119,32,118,16,285
5086,115,17,118,16,266
5087,116,35,114,18,283
5088,118,18,114,18,268
5095,117,33,116,17,283
5096,114,18,116,17,265
5098,100,34,116,16,266
5099,118,32,117,17,284
5102,116,16,118,16,266
5103,117,34,118,16,285
5104,116,17,118,16,267
5105,116,33,116,18,283
5108,117,17,117,17,268
5109,117,33,101,16,267
5110,118,16,101,16,251
5112,118,16,117,16,267
5114,101,33,116,18,268
5115,117,34,117,15,283
5116,117,17,117,15,266
5119,117,32,134,16,299
5120,117,16,134,16,283
5121,118,34,116,18,286
5122,100,34,116,18,268
5123,117,32,117,16,282
5124,117,15,117,16,265
5125,116,33,117,17,283
5126,131,35,115,18,299
5127,115,35,115,18,283
5128,117,17,115,18,267
5129,118,34,116,16,284
5131,117,31,119,16,283
5132,102,31,119,16,268
5137,117,33,116,18,284
5138,116,16,116,18,266
5139,117,34,115,17,283
5140,101,34,115,17,267
5141,102,16,115,17,250
5144,117,16,117,17,267
5145,116,34,117,17,284
5146,116,18,117,17,268
5148,115,17,116,19,267
5149,115,35,116,17,283
5150,113,21,116,17,267
5151,117,33,115,17,282
5152,117,17,115,17,266
5153,118,34,115,16,283
5154,117,17,115,16,265
5157,121,33,116,16,286
5158,116,17,116,16,265
5159,117,32,117,17,283
5160,115,17,117,17,266
5161,115,33,117,17,282
5162,115,16,117,17,265
5163,117,34,117,16,284
5164,115,17,117,16,265
5165,116,33,117,17,283
5167,117,34,117,16,284
5168,117,17,117,16,267
5169,117,33,117,17,284
5172,117,16,117,17,267
5176,117,16,117,17,267
5177,117,34,116,17,284
5178,117,17,116,17,267
5179,117,33,117,17,284
5181,117,34,117,15,283
5182,117,17,117,15,266
5183,117,33,115,19,284
5184,101,33,115,19,268
5185,117,33,116,17,283
5187,117,34,117,16,284
5188,100,34,117,16,267
5190,117,15,118,16,266
5191,116,35,115,17,283
5192,115,19,115,17,266
5193,118,32,116,19,285
5196,117,16,115,17,265
5197,116,33,117,16,282
5198,101,33,117,16,267
5199,118,33,116,19,286
5201,117,35,115,17,284
5202,116,19,115,17,267
5203,117,31,118,15,281
5205,115,34,116,18,283
5206,117,16,116,18,267
5207,117,35,116,17,285
5208,100,35,116,17,268
5209,119,32,116,17,284
5210,115,17,116,17,265
5211,118,32,118,18,286
5212,118,15,118,18,269
5215,118,34,132,16,300
5218,101,32,116,17,266
5219,116,35,115,16,282
5220,118,18,115,16,267
5221,119,31,119,16,285
5222,116,16,119,16,267
5223,115,34,116,18,283
5224,132,33,101,16,282
5225,117,33,101,16,267
5227,116,33,117,18,284
5230,119,16,117,15,267
5232,116,18,117,15,266
5233,118,33,117,17,285
5237,116,32,117,16,281
5239,117,33,117,18,285
5240,117,15,117,18,267
5241,116,35,116,16,283
5242,117,17,116,16,266
5244,117,15,117,17,266
5245,115,33,101,14,263
5246,117,16,101,14,248
5247,115,35,132,18,300
5248,117,18,132,18,285
5249,117,32,134,17,300
5251,115,34,117,17,283
5252,117,17,117,17,268
5253,117,32,118,18,285
5254,101,32,118,18,269
5256,132,34,117,17,300
5257,116,34,117,17,284
5258,118,16,117,17,268
5259,117,34,117,16,284
5260,117,17,117,16,267
5261,103,17,117,16,253
5262,102,34,116,16,268
5263,119,31,118,17,285
5266,117,17,116,16,266
5267,117,33,118,14,282
5268,117,16,118,14,265
5269,117,33,116,18,284
5271,117,34,115,17,283
5272,101,34,115,17,267
5273,117,32,117,18,284
5274,100,32,117,18,267
5275,115,33,117,16,281
5279,117,32,118,16,283
5280,115,17,118,16,266
5281,116,35,116,17,284
5285,100,16,117,18,251
5286,115,17,117,16,265
5287,117,34,117,15,283
5288,118,16,117,15,266
5289,117,34,115,19,285
5291,118,33,115,17,283
5292,102,33,115,17,267
5293,118,32,117,18,285
5295,115,33,117,17,282
5297,115,36,115,16,282
5298,115,19,115,16,265
5299,119,31,118,16,284
5302,117,18,115,17,267
5303,117,32,117,18,284
5304,117,17,117,18,269
5305,117,33,117,18,285
5306,115,16,117,18,266
5307,117,34,118,13,282
5308,118,16,118,13,265
5314,102,33,115,18,268
5315,117,30,103,17,267
5316,101,30,103,17,251
5317,115,37,132,18,302
5318,117,18,132,18,285
5319,118,32,133,16,299
5321,117,34,132,18,301
5322,115,18,132,18,283
5323,116,33,117,16,282
5324,103,33,117,16,269
5325,101,16,117,16,250
5327,116,33,117,18,284
5329,117,33,117,18,285
5331,115,34,117,18,284
5332,117,16,117,18,268
5333,115,33,118,15,281
5334,117,16,118,15,266
5338,117,18,116,16,267
5339,117,34,116,15,282
5340,101,34,116,15,266
5342,118,15,117,16,266
5343,116,34,117,17,284
5345,117,33,118,17,285
5346,116,16,118,17,267
5347,116,33,102,15,266
5349,115,33,119,15,282
5350,117,16,119,15,267
5351,115,35,116,16,282
5353,117,34,116,16,283
5354,118,17,116,16,267
5355,117,33,116,16,282
5356,102,33,116,16,267
5357,118,32,117,17,284
5358,119,15,117,17,268
5359,116,33,117,17,283
5360,116,16,117,17,266
5361,115,34,117,16,282
5362,116,16,117,16,265
5363,117,33,117,17,284
5365,115,34,117,17,283
5367,117,33,116,17,283
5368,117,17,116,17,267
5369,116,33,117,17,283
5370,100,33,117,17,267
5371,116,34,116,17,283
5373,117,34,115,18,284
5374,117,17,115,18,267
5375,133,17,118,15,283
5376,116,17,118,15,266
5378,117,17,116,18,268
5380,116,17,117,16,266
5381,116,34,115,19,284
5383,118,32,117,16,283
5384,118,15,117,16,266
5385,116,35,115,19,285
5387,118,32,118,16,284
5388,117,16,118,16,267
5390,115,19,116,16,266
5391,117,31,118,17,283
5394,115,19,115,18,267
5395,118,32,117,16,283
5397,118,33,116,17,284
5399,117,34,116,17,284
5401,118,34,115,17,284
5403,117,32,117,17,283
5406,116,17,117,18,268
5407,116,34,119,15,284
5408,116,17,119,15,267
5409,117,33,117,16,283
5412,117,17,117,17,268
5413,118,34,115,17,284
5414,101,34,115,17,267
5415,118,33,116,16,283
5416,101,33,116,16,266
5417,118,32,118,16,284
5418,117,16,118,16,267
5421,118,32,118,15,283
5422,115,17,118,15,265
5423,114,33,117,16,280
5424,116,16,117,16,265
5427,116,34,115,17,282
5428,116,17,115,17,265
5429,118,32,118,16,284
5432,117,16,117,18,268
5433,115,35,116,16,282
5434,116,18,116,16,266
5435,117,32,118,16,283
5437,115,34,117,16,282
5438,118,16,117,16,267
5439,117,34,115,18,284
5440,101,34,115,18,268
5441,118,32,101,17,268
5443,117,34,117,17,285
5444,118,16,117,17,268
5446,117,16,117,17,267
5447,117,34,116,16,283
5448,115,18,116,16,265
5449,117,34,115,17,283
5450,101,34,115,17,267
5451,117,33,115,18,283
5452,117,17,115,18,267
5453,117,33,117,18,285
5454,101,33,117,18,269
5455,118,32,119,16,285
5456,116,16,119,16,267
5457,115,34,117,18,284
5458,115,17,117,18,267
5459,116,34,116,18,284
5460,115,18,116,18,267
5461,117,35,115,16,283
5462,117,18,115,16,266
5463,119,32,115,19,285
5464,103,32,115,19,269
5465,118,34,115,16,283
5466,101,34,115,16,266
5468,101,33,116,17,267
5469,117,32,117,17,283
5470,115,16,117,17,265
5471,115,35,116,18,284
5472,115,19,116,18,268
5475,134,17,115,18,284
5476,116,17,115,18,266
5477,117,33,117,16,283
5478,117,17,117,16,267
5479,118,35,114,16,283
5480,116,18,114,16,264
5482,103,31,116,19,269
5483,116,34,116,16,282
5484,115,18,116,16,265
5485,117,33,116,18,284
5487,116,32,117,18,283
5489,116,36,115,18,285
5490,116,19,115,18,268
5491,119,31,102,16,268
5492,101,31,102,16,250
5493,115,35,116,17,283
5494,116,18,116,17,267
5495,118,33,115,17,283
5497,118,34,115,18,285
5498,115,18,115,18,266
5500,102,33,116,17,268
5502,116,17,116,18,267
5503,118,32,117,18,285
5504,115,17,117,18,267
5505,116,35,119,14,284
5506,115,18,119,14,266
5507,117,33,117,17,284
5508,116,17,117,17,267
5511,119,33,116,17,285
5512,102,33,116,17,268
5513,118,33,117,17,285
5514,119,14,117,17,267
5518,115,17,101,15,248
5519,117,34,117,16,284
5520,116,17,117,16,266
5522,117,17,115,17,266
5523,117,33,117,15,282
5524,115,18,117,15,265
5526,101,34,116,15,266
5531,117,33,116,18,284
5533,117,33,117,17,284
5534,116,15,117,17,265
5535,115,34,117,15,281
5536,116,17,117,15,265
5537,117,34,116,20,287
5538,117,17,116,20,270
5539,116,33,117,17,283
5540,116,18,117,17,268
5541,116,33,118,15,282
5543,117,32,118,17,284
5544,117,15,118,17,267
5547,121,31,115,18,285
5548,103,31,115,18,267
5551,116,34,117,17,284
5553,117,33,116,19,285
5555,116,34,117,17,284
5556,115,18,117,17,267
5557,116,33,117,17,283
5558,101,33,117,17,268
5559,117,34,115,17,283
5560,117,17,115,17,266
5561,117,34,115,17,283
5562,116,19,115,17,267
5563,119,33,116,17,285
5564,117,17,116,17,267
5567,117,32,117,17,283
5568,115,17,117,17,266
5570,115,17,116,17,265
5572,116,17,116,17,266
5573,117,32,101,16,266
5575,117,34,117,16,284
5576,117,17,117,16,267
5579,116,34,133,17,300
5580,116,17,133,17,283
5581,116,32,118,17,283
5582,101,32,118,17,268
5583,116,34,117,17,284
5584,117,16,117,17,267
5592,117,17,115,19,268
5594,117,15,118,15,265
5595,116,35,117,16,284
5596,116,18,117,16,267
5598,115,17,117,16,265
5599,116,35,116,15,282
5600,115,19,116,15,265
5601,117,31,118,17,283
5602,102,31,118,17,268
5603,116,35,116,16,283
5604,117,16,116,16,265
5605,118,32,118,15,283
5609,115,35,132,18,300
5610,118,17,132,18,285
5611,116,32,118,16,282
5613,116,33,119,15,283
5614,118,15,119,15,267
5615,115,32,118,17,282
5616,118,14,118,17,267
5617,114,35,117,17,283
5618,132,34,116,17,299
5619,116,34,116,17,283
5620,118,16,116,17,267
5621,116,33,118,16,283
5622,119,15,118,16,268
5623,116,33,118,15,282
5625,117,34,118,15,284
5626,117,17,118,15,267
5627,116,33,117,18,284
5628,116,17,117,18,268
5629,115,34,116,17,282
5630,118,16,116,17,267
5631,118,32,118,17,285
5632,101,32,118,17,268
5633,116,34,116,19,285
5634,118,15,116,19,268
5635,117,35,133,16,301
5637,117,32,117,16,282
5638,116,17,117,16,266
5639,116,34,115,17,282
5640,118,17,115,17,267
5641,116,34,120,11,281
5642,101,34,120,11,266
5643,118,33,116,16,283
5644,116,17,116,16,265
5645,118,32,117,17,284
5646,117,16,117,17,267
5647,116,33,118,16,283
5648,115,17,118,16,266
5650,120,11,117,17,265
5651,133,16,118,17,284
5652,116,16,118,17,267
5653,116,34,116,18,284
5654,117,17,116,18,268
5655,118,33,116,17,284
5656,118,16,116,17,267
5659,116,35,115,16,282
5661,118,33,117,16,284
5663,117,32,118,16,283
5664,116,17,118,16,267
5666,117,16,117,18,268
5667,115,33,119,16,283
5668,115,16,119,16,266
5669,116,35,115,19,285
5671,118,33,116,17,284
5673,117,34,116,17,284
5674,101,34,116,17,268
5675,118,33,116,16,283
5677,116,34,115,18,283
5678,115,19,115,18,267
5679,117,32,116,17,282
5680,116,17,116,17,266
5682,116,17,116,16,265
5684,116,16,118,16,266
5686,115,18,116,16,265
5687,118,32,117,17,284
5689,116,33,118,16,283
5690,116,16,118,16,266
5691,116,34,118,16,284
5692,118,16,118,16,268
5693,117,33,117,16,283
5695,117,34,117,16,284
5697,117,33,117,17,284
5698,118,16,117,17,268
5700,100,34,117,15,266
5701,117,32,117,18,284
5702,101,32,117,18,268
5703,116,34,117,16,283
5706,117,17,117,16,267
5707,116,32,117,18,283
5708,117,15,117,18,267
5710,100,35,116,14,265
5711,117,32,118,16,283
5712,117,16,118,16,267
5715,116,34,115,18,283
5716,101,34,115,18,268
5717,118,30,118,19,285
5718,116,14,118,19,267
5721,116,34,115,18,283
5723,118,33,117,17,285
5724,115,18,117,17,267
5726,118,19,117,16,270
5727,117,31,118,16,282
5728,116,16,118,16,266
5730,115,18,116,16,265
5731,118,34,115,17,284
5733,119,33,117,15,284
5734,117,16,117,15,265
5736,102,32,117,18,269
5737,117,33,118,17,285
5739,115,34,116,18,283
5741,115,33,117,16,281
5742,117,15,117,16,265
5743,116,35,115,17,283
5744,117,18,115,17,267
5745,118,33,113,19,283
5747,118,33,116,17,284
5748,101,33,116,17,267
5749,116,32,118,17,283
5750,101,32,118,17,268
5751,116,34,117,16,283
5752,115,17,117,16,265
5753,116,33,118,16,283
5754,113,19,118,16,266
5755,117,34,117,17,285
5758,101,34,118,14,267
5759,101,17,118,14,250
5760,117,16,117,18,268
5761,119,34,117,16,286
5762,118,16,117,16,267
5763,117,34,116,17,284
5765,117,32,117,17,283
5766,118,14,117,17,266
5767,116,35,115,16,282
5769,117,32,116,17,282
5770,117,16,116,17,266
5771,116,34,133,17,300
5772,116,17,133,17,283
5773,115,33,117,16,281
5774,101,33,117,16,267
5775,117,32,101,17,267
5776,115,16,101,17,249
5777,115,34,133,18,300
5778,116,17,133,18,284
5779,116,34,117,19,286
5781,117,33,118,16,284
5782,100,33,118,16,267
5783,101,16,118,16,251
5784,101,33,117,16,267
5785,117,33,117,17,284
5786,118,15,117,17,267
5788,117,19,113,17,266
5789,119,31,116,17,283
5790,103,31,116,17,267
5791,101,16,116,17,250
5793,115,34,118,16,283
5794,117,17,118,16,268
5795,116,33,118,15,282
5796,113,17,118,15,263
5797,115,34,117,16,282
5798,116,17,117,16,266
5799,117,33,116,19,285
5803,118,32,117,18,285
5804,118,15,117,18,268
5805,116,34,118,16,284
5806,117,16,118,16,267
5807,116,35,115,17,283
5809,117,31,117,16,281
5813,117,33,116,17,283
5814,118,16,116,17,267
5815,118,33,117,16,284
5816,115,17,117,16,265
5817,116,32,119,17,284
5819,116,36,115,17,284
5820,115,19,115,17,266
5821,117,32,117,17,283
5825,101,16,116,17,250
5826,101,35,116,16,268
5827,119,32,116,18,285
5828,115,17,116,18,266
5832,116,17,117,16,266
5833,115,34,116,17,282
5834,116,16,116,17,265
5835,117,34,117,16,284
5836,100,34,117,16,267
5838,116,15,119,17,267
5840,117,16,118,16,267
5841,115,34,118,16,283
5842,116,17,118,16,267
5844,117,16,116,17,266
5847,118,32,118,16,284
5848,118,16,118,16,268
5849,117,34,117,16,284
5850,118,16,117,16,267
5852,116,17,116,17,266
5853,116,32,118,17,283
5854,115,16,118,17,266
5855,115,35,115,19,284
5856,118,16,115,19,268
5857,116,33,116,18,283
5859,117,33,116,18,284
5860,100,33,116,18,267
5862,118,17,116,17,268
5863,116,34,116,17,283
5864,115,19,116,17,267
5865,117,33,116,16,282
5866,101,33,116,16,266
5867,118,33,132,17,300
5868,116,18,132,17,283
5869,117,33,132,17,299
5870,116,17,132,17,282
5871,118,34,115,18,285
5872,116,17,115,18,266
5873,118,32,117,16,283
5874,116,16,117,16,265
5875,117,33,118,16,284
5876,132,33,118,16,299
5877,116,33,118,16,283
5880,115,18,116,16,265
5881,117,32,117,18,284
5882,101,32,117,18,268
5884,100,34,117,17,268
5885,117,33,116,18,284
5887,117,33,101,17,268
5888,116,16,101,17,250
5890,117,18,131,18,284
5892,117,17,134,16,284
5895,117,33,117,15,282
5896,101,33,117,15,266
5897,117,32,118,16,283
5898,116,15,118,16,265
5899,115,36,115,18,284
5900,116,18,115,18,267
5901,119,33,116,16,284
5902,117,17,116,16,266
5903,117,31,118,17,283
5904,101,31,118,17,267
5906,118,16,101,16,251
5908,115,18,116,17,266
5909,117,32,118,16,283
5910,116,16,118,16,266
5911,116,34,116,18,284
5915,117,34,117,15,283
5916,116,17,117,15,265
5917,117,33,116,17,283
5918,118,16,116,17,267
5919,117,34,132,17,300
5920,116,18,132,17,283
5921,118,34,115,17,284
5922,118,17,115,17,267
5923,118,31,117,18,284
5924,117,15,117,18,267
5925,115,34,118,16,283
5927,117,33,117,17,284
5928,132,34,117,15,298
5930,115,17,117,15,264
5931,116,34,116,17,283
5932,117,18,116,17,268
5934,118,16,115,18,267
5935,116,33,117,16,282
5937,117,32,119,14,282
5939,116,35,116,16,283
5941,116,33,116,17,282
5942,115,18,116,17,266
5943,117,33,117,17,284
5944,117,16,117,17,267
5945,116,32,119,15,282
5946,119,14,119,15,267
5947,115,34,118,15,282
5948,116,16,118,15,265
5949,117,34,117,15,283
5950,116,17,117,15,265
5951,116,34,115,18,283
5953,116,32,118,15,281
5954,102,32,118,15,267
5955,116,33,118,16,283
5956,118,15,118,16,267
5958,117,15,119,16,267
5960,115,18,116,18,267
5962,101,32,102,15,250
5963,115,34,117,17,283
5965,116,34,117,16,283
5966,119,16,117,16,268
5967,118,34,116,16,284
5970,102,34,115,17,268
5971,118,32,117,15,282
5972,117,17,117,15,266
5973,116,33,118,15,282
5974,117,16,118,15,266
5975,117,33,117,17,284
5977,117,34,117,17,285
5978,115,17,117,17,266
5979,117,32,117,17,283
5980,100,32,117,17,266
5981,115,34,117,16,282
5982,118,15,117,16,266
5983,116,34,117,17,284
5984,117,17,117,17,268
5988,117,17,119,15,268
5990,117,16,118,15,266
5991,116,35,115,18,284
5992,117,17,115,18,267
5995,116,35,116,18,285
5998,118,15,119,16,268
