序号,发送->接收,接收->转发,转发->接收,接收->处理,总计
1,82,16,68,16,182
2,64,34,67,16,181
3,51,34,67,16,168
5,84,33,64,18,199
6,68,33,64,18,183
7,66,17,64,18,165
9,67,17,65,17,166
11,68,13,68,18,167
12,64,34,69,15,182
13,82,34,67,17,200
14,65,34,67,17,183
15,81,35,66,16,198
16,68,35,66,16,185
17,85,32,67,18,202
18,69,32,67,18,186
19,67,17,67,18,169
22,66,33,67,18,184
23,84,34,65,17,200
24,67,34,65,17,183
25,68,16,65,17,166
26,67,33,65,20,185
27,68,16,65,20,169
30,65,33,69,17,184
33,67,16,75,6,164
34,69,33,65,17,184
35,67,18,65,17,167
37,91,23,67,17,198
39,60,23,67,17,167
40,65,34,67,16,182
43,68,16,67,17,168
44,67,34,66,16,183
45,67,17,66,16,166
46,67,33,68,14,182
47,83,33,68,17,201
49,83,35,65,16,199
51,66,19,65,16,166
52,68,33,65,22,188
53,65,19,65,22,171
54,68,32,68,18,186
56,65,33,68,18,184
58,65,35,64,17,181
60,68,33,83,17,201
61,70,15,83,17,185
62,68,31,69,17,185
63,64,13,69,17,163
64,64,36,65,18,183
65,63,19,65,18,165
67,82,32,68,23,205
68,69,32,68,23,192
69,69,15,68,23,175
70,65,37,64,17,183
71,86,31,68,15,200
72,69,31,68,15,183
73,52,31,68,15,166
75,73,10,66,16,165
76,64,35,65,15,179
77,66,18,65,15,164
79,76,34,66,17,193
81,83,34,66,17,200
82,65,34,66,17,182
83,84,32,67,18,201
84,68,32,67,18,185
88,66,33,67,16,182
89,68,16,67,16,167
90,67,34,67,17,185
92,67,33,66,16,182
93,83,34,65,17,199
94,67,34,65,17,183
96,67,32,67,16,182
97,67,15,67,16,165
98,66,33,68,17,184
100,65,34,67,15,181
101,82,34,68,15,199
102,67,34,68,15,184
103,67,18,68,15,168
104,68,33,67,16,184
105,68,16,67,16,167
106,67,35,65,17,184
108,68,32,66,16,182
109,66,17,66,16,165
111,68,17,67,17,169
112,65,33,66,17,181
113,67,16,66,17,166
114,66,34,67,15,182
115,66,18,67,15,166
116,67,32,69,14,182
117,67,15,69,14,165
118,66,35,65,17,183
120,67,34,65,17,183
122,69,31,51,17,168
124,65,34,84,16,199
125,84,34,82,17,217
126,65,34,82,17,198
128,51,17,82,17,167
129,67,21,62,16,166
130,84,16,67,16,183
131,67,16,67,16,166
132,82,17,67,17,183
134,62,34,66,17,179
135,65,18,66,17,166
136,67,33,67,16,183
138,67,33,66,18,184
140,66,34,66,16,182
142,67,32,67,21,187
143,66,16,67,21,170
144,66,34,68,15,183
146,66,33,66,19,184
148,67,35,67,15,184
149,84,31,69,17,201
151,67,16,69,17,169
152,66,36,66,17,185
153,64,17,66,17,164
154,67,33,65,17,182
157,67,16,67,14,164
158,66,32,67,17,182
159,68,15,67,17,167
160,65,35,66,16,182
161,83,32,50,17,182
162,67,32,50,17,166
163,64,18,50,17,149
164,67,34,66,16,183
165,67,17,66,16,166
166,66,33,66,17,182
168,50,17,66,17,150
169,66,17,68,17,168
170,66,33,67,16,182
171,83,35,65,16,199
172,66,35,65,16,182
173,67,18,65,16,166
174,68,32,67,15,182
175,69,15,67,15,166
177,66,17,84,16,183
178,65,34,66,18,183
180,67,32,69,16,184
181,66,17,69,16,168
182,84,16,67,17,184
183,68,16,67,17,168
184,66,35,66,16,183
185,69,17,66,16,168
188,67,34,65,17,183
189,66,17,65,17,165
192,68,31,69,15,183
193,68,14,69,15,166
195,66,18,67,15,166
196,66,34,66,17,183
197,66,17,66,17,166
198,69,33,65,16,183
199,67,18,65,16,166
200,67,33,84,15,199
203,68,15,67,18,168
204,65,34,66,17,182
205,66,18,66,17,167
206,84,15,67,15,181
207,67,15,67,15,164
208,67,33,67,16,183
209,69,15,67,16,167
210,66,34,67,18,185
212,67,33,52,15,167
213,64,18,52,15,149
215,66,18,66,17,167
216,67,33,70,14,184
217,70,15,70,14,169
218,52,15,70,14,151
220,66,37,81,17,201
221,65,20,81,17,183
225,67,16,68,16,167
226,81,17,66,17,181
228,82,18,66,17,183
229,66,18,66,17,167
230,68,33,66,18,185
231,66,17,66,18,167
232,66,33,66,17,182
233,68,16,66,17,167
234,66,33,67,15,181
236,66,33,67,17,183
237,82,34,67,16,199
238,66,34,67,16,183
239,66,17,67,16,166
240,67,33,67,17,184
242,67,34,82,18,201
243,84,33,67,17,201
245,68,17,67,17,169
246,67,32,69,16,184
248,82,18,66,16,182
249,66,18,66,16,166
250,67,34,65,17,183
252,69,32,67,16,184
253,68,16,67,16,167
258,67,33,67,17,184
259,67,17,67,17,168
260,67,33,68,18,186
261,68,15,68,18,169
262,66,34,52,15,167
265,83,33,65,18,199
266,68,33,65,18,184
267,69,15,65,18,167
268,52,15,65,18,150
269,65,17,67,18,167
270,82,16,68,16,182
271,80,34,67,16,197
272,65,34,67,16,182
274,67,34,68,15,184
275,68,16,68,15,167
276,68,33,67,17,185
277,66,17,67,17,167
279,84,32,67,15,198
281,67,17,67,15,166
283,68,16,66,17,167
284,82,17,66,17,182
287,65,17,67,19,168
288,66,34,67,17,184
289,83,33,67,17,200
290,66,33,67,17,183
292,67,34,66,18,185
293,69,15,66,18,168
294,67,33,68,15,183
297,81,35,82,17,215
298,66,35,82,17,200
299,84,33,66,17,200
300,68,33,66,17,184
301,66,18,66,17,167
302,68,32,68,16,184
304,82,17,67,15,181
307,68,17,65,16,166
309,67,17,65,18,167
311,65,17,67,17,166
312,65,33,68,16,182
313,82,34,66,20,202
314,65,34,66,20,185
315,68,16,66,20,170
316,67,34,66,18,185
317,68,17,66,18,169
318,68,32,67,17,184
319,66,16,67,17,166
321,83,33,84,18,218
322,66,33,84,18,201
324,67,34,85,15,201
325,64,17,85,15,181
327,66,16,67,18,167
329,67,18,66,17,168
330,85,15,67,18,185
332,67,34,65,18,184
334,66,33,68,15,182
335,82,32,69,15,198
336,67,32,69,15,183
337,67,14,69,15,165
338,65,36,65,17,183
339,66,18,65,17,166
341,65,18,65,17,165
342,69,32,67,17,185
343,66,17,67,17,167
345,67,16,66,17,166
346,65,34,66,17,182
347,67,17,66,17,167
348,67,32,67,17,183
350,66,34,68,16,184
351,66,17,68,16,167
353,82,35,65,17,199
354,67,35,65,17,184
355,67,18,65,17,167
356,68,33,67,16,184
357,67,17,67,16,167
360,65,35,65,16,181
361,66,18,65,16,165
362,67,33,83,16,199
365,69,14,67,17,167
367,83,33,68,16,200
369,81,35,66,16,198
370,67,35,66,16,184
371,68,18,66,16,168
373,67,17,67,15,166
375,84,34,67,14,199
377,66,18,67,14,165
378,67,33,66,16,182
379,66,18,66,16,166
380,67,34,64,19,184
381,69,16,64,19,168
384,66,32,69,15,182
386,64,34,66,17,181
389,85,31,67,18,201
390,69,31,67,18,185
391,65,16,67,18,166
392,66,35,67,15,183
393,64,18,67,15,164
394,81,17,68,17,183
395,66,17,68,17,168
396,67,35,65,17,184
397,68,17,65,17,167
399,67,18,68,14,167
400,68,32,69,14,183
401,82,36,82,17,217
402,65,36,82,17,200
403,67,19,82,17,185
404,68,33,66,16,183
406,69,33,66,17,185
407,66,19,66,17,168
408,82,17,65,17,181
409,68,17,65,17,167
410,66,33,67,16,182
413,67,15,67,17,166
414,65,35,66,17,183
415,66,18,66,17,167
416,67,32,68,15,182
417,66,16,68,15,165
419,84,34,65,17,200
420,66,34,65,17,182
421,67,17,65,17,166
424,67,32,68,16,183
425,65,17,68,16,166
426,65,33,68,16,182
427,67,16,68,16,167
428,65,35,67,17,184
429,67,18,67,17,169
430,68,33,66,17,184
431,84,34,65,18,201
432,68,34,65,18,185
434,67,32,68,16,183
435,68,15,68,16,167
436,66,33,68,16,183
437,67,16,68,16,167
438,65,35,66,16,182
439,66,17,66,16,165
440,68,33,66,17,184
442,68,33,66,21,188
443,66,17,66,21,170
444,66,33,67,17,183
445,83,33,66,18,200
447,67,16,66,18,167
448,66,34,66,16,182
449,71,13,66,16,166
450,67,32,68,17,184
451,67,15,68,17,167
452,66,34,68,15,183
453,79,34,67,16,196
454,66,34,67,16,183
458,68,33,68,15,184
459,67,18,68,15,168
460,67,32,68,16,183
461,66,16,68,16,166
463,67,19,81,17,184
464,68,32,82,17,199
465,67,17,82,17,183
466,68,34,65,19,186
467,67,18,65,19,169
468,81,17,67,16,181
469,66,17,67,16,166
472,65,34,68,16,183
473,69,15,68,16,168
474,67,34,65,17,183
475,67,18,65,17,167
476,68,34,65,17,184
478,68,31,51,16,166
481,65,17,68,16,166
483,66,16,66,17,165
485,68,17,66,17,168
486,68,31,67,17,183
487,67,15,67,17,166
488,66,35,68,15,184
489,65,18,68,15,166
490,66,32,67,16,181
491,67,15,67,16,165
492,67,36,65,17,185
493,67,19,65,17,168
494,68,31,68,17,184
495,66,16,68,17,167
496,67,34,66,19,186
498,65,34,65,18,182
499,67,17,65,18,167
500,68,32,68,15,183
501,69,15,68,15,167
502,66,33,67,18,184
503,68,14,67,18,167
504,65,35,66,16,182
505,83,32,68,15,198
507,81,34,66,18,199
508,67,34,66,18,185
509,67,16,66,18,167
511,67,18,66,16,167
514,66,34,66,16,182
515,68,16,66,16,166
517,67,18,83,17,185
518,68,32,68,15,183
524,68,34,66,17,185
525,52,34,66,17,169
526,68,30,69,17,184
527,66,15,69,17,167
529,85,33,66,16,200
530,66,33,66,16,181
531,68,16,66,16,166
533,68,15,67,18,168
534,65,34,68,17,184
535,67,15,68,17,167
536,66,33,67,15,181
537,65,17,67,15,164
538,50,17,67,15,149
540,68,32,67,16,183
541,69,15,67,16,167
542,67,34,67,17,185
544,82,17,68,16,183
545,65,17,68,16,166
546,67,34,65,17,183
547,68,18,65,17,168
549,68,17,66,17,168
551,68,15,67,18,168
552,65,35,65,17,182
554,66,32,68,15,181
556,67,33,69,14,183
557,68,15,69,14,166
559,65,18,66,16,165
560,68,34,66,16,184
561,65,19,66,16,166
562,69,32,67,18,186
563,66,18,67,18,169
566,66,33,67,16,182
567,68,17,67,16,168
568,67,32,67,18,184
570,65,35,67,15,182
571,67,17,67,15,166
572,67,32,68,16,183
573,81,35,65,18,199
575,67,17,65,18,167
576,67,33,67,15,182
577,66,18,67,15,166
578,68,32,68,16,184
579,66,16,68,16,166
580,65,35,65,18,183
581,68,17,65,18,168
583,66,18,65,17,166
584,68,32,50,18,168
586,65,33,67,17,182
588,65,35,64,19,183
589,66,18,64,19,167
592,67,32,68,17,184
593,82,35,66,17,200
594,64,35,66,17,182
595,82,33,67,18,200
597,68,15,67,18,168
598,68,33,52,15,168
599,66,16,52,15,149
600,66,34,67,16,183
601,65,17,67,16,165
602,67,33,68,16,184
603,68,15,68,16,167
604,52,15,68,16,151
606,67,34,64,19,184
607,83,33,67,16,199
608,68,33,67,16,184
609,67,17,67,16,167
613,67,17,65,17,166
615,66,17,65,17,165
616,69,32,68,15,184
617,66,16,68,15,165
618,65,33,69,15,182
621,84,34,65,18,201
624,69,32,69,13,183
625,67,17,69,13,166
626,82,17,66,16,181
627,67,17,66,16,166
628,65,36,81,17,199
629,68,18,81,17,184
630,69,30,68,17,184
631,66,17,68,17,168
633,64,18,67,16,165
634,81,17,67,16,181
637,69,16,66,17,168
638,67,34,82,18,201
640,67,32,68,16,183
641,66,16,68,16,166
643,67,18,66,17,168
644,82,18,65,19,184
645,66,18,65,19,168
648,66,32,68,17,183
650,65,34,68,17,184
651,68,15,68,17,168
654,68,34,65,18,185
655,66,17,65,18,166
656,68,32,68,16,184
657,69,15,68,16,168
659,65,17,68,16,166
660,65,35,66,18,184
661,83,33,65,18,199
662,68,33,65,18,184
663,68,17,65,18,168
664,68,33,50,15,166
666,66,32,68,17,183
667,68,14,68,17,167
668,65,33,68,18,184
669,67,15,68,18,168
670,65,35,66,17,183
671,82,33,67,17,199
672,68,33,67,17,185
673,67,16,67,17,167
674,68,33,67,16,184
675,67,15,67,16,165
676,51,15,67,16,149
677,66,17,66,18,167
678,67,33,68,15,183
679,66,16,68,15,165
680,67,33,67,16,183
681,66,17,67,16,166
684,68,32,66,17,183
685,67,17,66,17,167
686,67,33,68,17,185
687,82,33,68,16,199
688,65,33,68,16,182
694,68,32,66,18,184
695,67,16,66,18,167
696,65,35,83,17,200
697,83,31,52,17,183
698,67,31,52,17,167
700,66,35,67,16,184
701,67,17,67,16,167
703,68,17,65,17,167
704,52,17,65,17,151
705,66,18,67,16,167
706,67,32,67,17,183
707,66,16,67,17,166
711,67,16,66,19,168
712,67,33,68,17,185
713,67,16,68,17,168
714,65,33,68,18,184
715,82,35,66,16,199
716,66,35,66,16,183
717,84,33,66,16,199
718,68,33,66,16,183
720,68,33,67,17,185
721,67,15,67,17,166
722,66,33,66,17,182
723,65,17,66,17,165
725,82,32,68,16,198
726,67,32,68,16,183
728,66,33,69,16,184
729,83,35,68,14,200
730,65,35,68,14,182
731,65,18,68,14,165
732,68,34,66,17,185
733,67,18,66,17,168
736,68,32,66,18,184
737,66,18,66,18,168
738,66,33,67,17,183
740,65,33,51,17,166
743,67,16,67,15,165
744,67,34,66,16,183
745,67,17,66,16,166
747,65,18,66,16,165
748,67,33,67,15,182
749,83,33,68,14,198
750,66,33,68,14,181
751,67,17,68,14,166
752,66,34,84,16,200
753,67,18,84,16,185
754,67,34,66,17,184
755,66,19,66,17,168
756,68,32,66,18,184
758,84,16,65,18,183
759,69,16,65,18,168
760,66,32,69,14,181
762,66,33,66,17,182
763,81,36,64,17,198
764,65,36,64,17,182
765,66,18,64,17,165
767,65,16,69,17,167
771,67,18,65,20,170
772,69,33,66,18,186
773,69,16,66,18,169
774,68,32,68,17,185
775,68,15,68,17,168
776,65,34,68,17,184
777,68,14,68,17,167
778,66,34,66,16,182
779,83,34,65,18,200
780,68,34,65,18,185
781,65,17,65,18,165
782,68,32,67,17,184
783,67,15,67,17,166
785,82,34,67,16,199
786,65,34,67,16,182
787,66,16,67,16,165
788,67,32,67,19,185
790,51,15,67,19,152
791,83,32,69,17,201
792,67,32,69,17,185
793,66,16,69,17,168
794,67,34,67,17,185
795,67,15,67,17,166
797,66,19,65,18,168
798,69,32,67,15,183
799,67,15,67,15,164
801,68,16,68,15,167
802,65,34,66,17,182
804,67,34,64,19,184
805,65,19,64,19,167
806,68,32,66,18,184
809,68,15,69,16,168
810,64,34,68,18,184
811,68,15,68,18,169
812,66,35,66,17,184
813,67,17,66,17,167
815,66,17,50,18,151
816,68,33,85,12,198
817,68,15,85,12,180
818,66,35,62,19,182
819,67,18,62,19,166
820,50,18,62,19,149
822,85,12,72,16,185
823,68,12,72,16,168
824,50,12,72,16,150
825,66,17,67,18,168
826,65,36,65,17,183
828,72,31,66,18,187
829,69,15,66,18,168
831,67,16,67,17,167
832,65,32,67,16,180
833,66,15,67,16,164
834,66,35,82,16,199
835,83,32,66,18,199
836,67,32,66,18,183
837,67,15,66,18,166
838,67,33,69,16,185
839,65,17,69,16,167
842,66,36,64,18,184
844,51,18,64,18,151
847,66,16,52,15,149
848,64,34,67,19,184
849,66,16,67,19,168
850,83,15,67,17,182
851,68,15,67,17,167
852,52,15,67,17,151
853,68,15,66,18,167
855,68,14,67,18,167
856,53,14,67,18,152
857,81,34,67,16,198
858,66,34,67,16,183
859,81,33,68,18,200
860,67,33,68,18,186
862,67,34,67,16,184
863,68,15,67,16,166
864,67,34,66,17,184
866,68,33,66,18,185
867,82,33,66,17,198
868,67,33,66,17,183
869,67,17,66,17,167
871,81,33,67,18,199
872,66,33,67,18,184
875,66,18,65,18,167
876,68,32,68,16,184
877,66,16,68,16,166
879,83,35,65,16,199
881,84,31,69,16,200
882,68,31,69,16,184
883,66,15,69,16,166
886,65,35,65,16,181
889,67,16,68,15,166
890,51,16,68,15,150
893,65,19,64,17,165
894,68,32,68,15,183
895,66,17,68,15,166
897,69,14,69,15,167
901,83,33,51,15,182
902,69,33,51,15,168
903,67,18,51,15,151
904,66,33,66,16,181
906,84,15,68,16,183
907,69,15,68,16,168
908,66,33,67,17,183
911,64,19,66,17,166
912,68,32,65,19,184
913,67,16,65,19,167
914,67,34,68,15,184
915,68,17,68,15,168
917,67,14,52,16,149
918,65,37,65,18,185
919,67,18,65,18,168
920,68,31,67,16,182
922,52,16,67,16,151
924,65,33,68,14,180
925,68,15,68,14,165
926,67,34,66,18,185
928,67,34,66,17,184
929,66,17,66,17,166
930,68,32,67,16,183
931,66,18,67,16,167
935,69,16,68,12,165
936,67,34,84,16,201
937,65,18,84,16,183
938,67,34,81,18,200
939,68,16,81,18,183
942,84,16,66,16,182
943,66,16,66,16,164
946,67,33,67,18,185
948,66,32,53,14,165
949,67,16,53,14,150
950,65,35,67,15,182
951,65,18,67,15,165
953,69,14,68,15,166
954,67,35,67,15,184
956,67,33,68,14,182
957,64,18,68,14,164
958,68,34,67,17,186
960,67,34,64,18,183
962,68,33,65,17,183
963,67,19,65,17,168
964,67,31,69,14,181
965,69,14,69,14,166
967,68,16,67,18,169
969,83,32,67,15,197
970,69,32,67,15,183
975,67,18,65,19,169
976,67,33,68,15,183
977,64,18,68,15,165
978,67,32,68,16,183
979,69,14,68,16,167
982,68,32,67,18,185
983,65,17,67,18,167
986,84,15,65,17,181
987,84,35,64,17,200
988,67,35,64,17,183
989,69,17,64,17,167
991,80,34,69,15,198
993,81,33,67,17,198
995,66,16,67,17,166
997,69,17,64,16,166
999,67,16,67,16,166
1000,67,33,68,18,186
1001,81,34,66,17,198
1002,64,34,66,17,181
1003,83,34,66,18,201
1004,67,34,66,18,185
1005,66,18,66,18,168
1006,68,32,69,16,185
1007,70,14,69,16,169
1008,66,34,66,17,183
1009,67,17,66,17,167
1011,83,31,83,19,216
1012,69,31,83,19,202
1013,68,15,83,19,185
1014,66,33,69,15,183
1017,64,20,64,17,165
1018,83,19,66,16,184
1019,66,19,66,16,167
1020,69,31,68,16,184
1021,53,31,68,16,168
1025,67,17,67,16,167
1026,68,32,67,17,184
1030,67,32,69,15,183
1031,67,16,69,15,167
1033,85,34,83,16,218
1034,67,34,83,16,200
1035,67,18,83,16,184
1036,69,32,83,18,202
1038,66,33,68,15,182
1039,66,17,68,15,166
1040,83,16,65,17,181
1042,83,18,65,17,183
1044,68,31,67,16,182
1046,65,34,68,16,183
1047,66,17,68,16,167
1048,65,33,68,15,181
1051,66,19,67,16,168
1052,68,33,66,17,184
1054,68,34,65,16,183
1055,67,19,65,16,167
1056,67,32,67,17,183
1057,67,16,67,17,167
1058,66,33,66,17,182
1059,68,16,66,17,167
1060,65,34,66,16,181
1061,65,18,66,16,165
1062,67,32,68,16,183
1063,67,15,68,16,166
1065,67,17,69,16,169
1066,66,34,67,15,182
1067,83,35,81,19,218
1069,67,19,81,19,186
1070,69,32,68,15,184
1071,69,16,68,15,168
1072,67,33,66,17,183
1073,66,18,66,17,167
1074,81,19,65,16,181
1075,84,31,66,19,200
1076,68,31,66,19,184
1077,68,16,66,19,169
1081,66,16,67,17,166
1082,66,33,69,15,183
1083,68,14,69,15,166
1084,51,14,69,15,149
1086,67,35,65,18,185
1087,83,32,66,17,198
1088,69,32,66,17,184
1089,67,17,66,17,167
1090,67,33,67,16,183
1095,65,17,67,17,166
1096,67,34,66,18,185
1097,83,33,67,16,199
1098,68,33,67,16,184
1100,67,33,66,18,184
1101,68,16,66,18,168
1102,66,34,67,17,184
1103,68,16,67,17,168
1105,66,16,68,16,166
1106,66,35,65,18,184
1109,68,16,66,18,168
1111,66,16,67,18,167
1112,65,34,66,19,184
1113,66,16,66,19,167
1114,66,33,52,14,165
1117,67,15,67,18,167
1118,66,33,68,17,184
1119,67,14,68,17,166
1120,52,14,68,17,151
1121,67,15,68,16,166
1122,67,34,66,17,184
1124,68,34,66,16,184
1125,83,32,68,17,200
1126,68,32,68,17,185
1129,66,17,66,17,166
1131,66,18,65,19,168
1132,68,32,68,17,185
1133,68,15,68,17,168
1134,66,33,68,16,183
1135,83,35,67,16,201
1136,65,35,67,16,183
1137,83,33,67,16,199
1138,68,33,67,16,184
1140,68,34,66,16,184
1141,65,18,66,16,165
1143,66,17,65,18,166
1144,50,17,65,18,150
1147,82,34,51,17,184
1148,65,34,51,17,167
1150,66,33,68,17,184
1151,67,16,68,17,168
1155,67,17,67,16,167
1156,68,34,66,17,185
1159,67,17,65,18,167
1160,67,33,66,17,183
1161,66,17,66,17,166
1162,66,32,67,18,183
1163,67,15,67,18,167
1166,66,33,67,18,184
1167,66,16,67,18,167
1168,67,34,67,16,184
1169,67,16,67,16,166
1170,67,33,67,17,184
1172,67,34,66,17,184
1173,67,16,66,17,166
1175,67,17,65,18,167
1176,67,33,50,16,166
1177,82,32,86,16,216
1178,66,32,86,16,200
1180,65,34,68,15,182
1182,66,33,68,16,183
1183,66,16,68,16,166
1186,68,33,68,15,184
1188,68,34,66,16,184
1189,83,34,66,15,198
1192,68,32,83,17,200
1193,67,17,83,17,184
1194,66,34,66,16,182
1196,66,33,67,17,183
1197,66,18,67,17,168
1198,83,17,67,17,184
1199,67,17,67,17,168
1200,66,34,68,15,183
1202,67,33,67,15,182
1204,67,35,82,15,199
1206,68,32,65,18,183
1207,66,17,65,18,166
1210,82,15,66,18,181
1212,65,34,50,17,166
1213,50,34,50,17,151
1214,66,32,68,16,182
1216,66,35,67,16,184
1218,50,17,67,16,150
1219,69,15,66,18,168
1220,68,34,67,16,185
1221,66,18,67,16,167
1222,67,32,51,19,169
1224,66,35,66,16,183
1225,85,35,64,16,200
1226,67,35,64,16,182
1227,67,19,64,16,166
1228,51,19,64,16,150
1229,52,31,67,17,167
1230,66,33,51,15,165
1233,85,32,67,17,201
1234,67,32,67,17,183
1236,51,15,67,17,150
1237,68,17,66,16,167
1238,83,16,68,17,184
1239,66,16,68,17,167
1241,66,17,66,18,167
1243,84,32,67,16,199
1245,68,15,67,16,166
1246,66,34,66,17,183
1247,68,16,66,17,167
1249,65,17,66,18,166
1250,67,33,67,16,183
1251,65,17,67,16,165
1254,66,34,68,16,184
1255,84,34,65,18,201
1256,67,34,65,18,184
1258,68,34,65,16,183
1260,68,31,69,17,185
1261,68,15,69,17,169
1263,67,16,67,17,167
1264,65,35,64,18,182
1266,69,32,67,15,183
1267,68,15,67,15,165
1269,68,15,72,13,168
1270,64,35,65,18,182
1273,65,22,64,15,166
1274,72,28,67,18,185
1275,67,15,67,18,167
1276,65,36,65,17,183
1277,86,31,69,15,201
1278,64,31,69,15,179
1279,66,16,69,15,166
1280,67,34,67,16,184
1282,65,35,66,18,184
1283,67,18,66,18,169
1284,69,32,66,18,185
1286,67,34,66,17,184
1289,69,14,67,18,168
1293,65,16,68,17,166
1294,67,33,68,15,183
1295,67,15,68,15,165
1296,51,15,68,15,149
1297,84,33,83,16,216
1298,68,33,83,16,200
1299,67,16,83,16,182
1301,65,19,65,18,167
1303,65,17,67,18,167
1305,68,16,68,17,169
1307,68,16,65,18,167
1308,67,34,65,18,184
1310,68,31,68,16,183
1313,65,16,69,16,166
1314,65,34,67,17,183
1315,66,16,67,17,166
1316,68,35,64,17,184
1317,66,19,64,17,166
1321,68,15,68,18,169
1322,64,35,67,16,182
1323,83,33,66,17,199
1324,67,33,66,17,183
1325,66,17,66,17,166
1327,69,16,67,15,167
1328,67,32,68,15,182
1329,67,16,68,15,166
1331,83,33,82,18,216
1332,67,33,82,18,200
1333,66,18,82,18,184
1334,68,32,68,16,184
1335,66,17,68,16,167
1336,82,17,69,13,181
1337,67,17,69,13,166
1338,82,18,67,16,183
1339,67,18,67,16,168
1340,68,35,62,20,185
1343,66,19,67,14,166
1344,67,30,51,17,165
1345,51,30,51,17,149
1346,62,37,65,18,182
1348,67,31,68,17,183
1349,65,17,68,17,167
1350,51,17,68,17,153
1351,67,15,51,16,149
1352,65,34,82,19,200
1353,69,16,82,19,186
1356,67,33,67,16,183
1357,65,17,67,16,165
1358,82,19,64,18,183
1359,65,19,64,18,166
1360,84,16,66,17,183
1361,68,16,66,17,167
1363,67,16,67,17,167
1364,64,34,68,16,182
1365,66,16,68,16,166
1366,66,33,69,15,183
1369,66,18,67,15,166
1370,68,34,65,18,185
1371,67,18,65,18,168
1372,69,33,66,16,184
1373,67,18,66,16,167
1375,66,17,66,18,167
1376,65,34,66,16,181
1379,67,16,70,15,168
1380,66,34,51,16,167
1381,66,16,51,16,149
1382,66,36,81,16,199
1384,70,31,66,16,183
1385,67,16,66,16,165
1386,51,16,66,16,149
1387,67,17,67,17,168
1388,81,16,70,15,182
1389,66,16,70,15,167
1390,66,34,51,15,166
1391,66,18,51,15,150
1392,67,36,64,16,183
1394,70,30,68,15,183
1395,69,15,68,15,167
1396,51,15,68,15,149
1397,66,17,65,18,166
1398,64,34,66,17,181
1400,68,31,69,15,183
1402,65,35,66,17,183
1404,66,34,67,15,182
1405,68,17,67,15,167
1406,69,32,68,16,185
1407,83,35,66,18,202
1409,66,18,66,18,168
1413,67,17,66,18,168
1414,66,33,67,16,182
1416,51,15,67,16,149
1417,83,34,50,16,183
1419,82,34,82,17,215
1420,67,34,82,17,200
1422,68,32,67,17,184
1423,66,16,67,17,166
1425,66,17,66,18,167
1426,82,17,67,17,183
1427,83,32,67,17,199
1430,66,35,67,16,184
1431,84,32,68,15,199
1434,67,35,67,15,184
1435,66,18,67,15,166
1436,67,33,67,17,184
1437,66,17,67,17,167
1438,68,34,63,18,183
1439,66,19,63,18,166
1440,67,33,67,16,183
1441,84,30,53,15,182
1442,67,30,53,15,165
1443,69,13,53,15,150
1446,67,31,67,18,183
1447,66,15,67,18,166
1448,53,15,67,18,153
1449,68,16,68,16,168
1451,65,17,67,17,166
1453,84,32,66,17,199
1456,67,35,67,14,183
1457,66,18,67,14,165
1458,67,31,68,16,182
1459,67,15,68,16,166
1460,66,36,65,16,183
1461,66,19,65,16,166
1462,67,32,67,17,183
1463,65,18,67,17,167
1465,84,34,65,17,200
1466,65,34,65,17,181
1467,67,18,65,17,167
1469,68,14,68,16,166
1471,83,34,50,16,183
1472,65,34,50,16,165
1476,68,32,67,17,184
1477,67,16,67,17,167
1479,67,18,67,17,169
1480,84,15,68,16,183
1481,68,15,68,16,167
1482,67,35,65,18,185
1483,67,18,65,18,168
1484,67,33,66,18,184
1486,68,32,68,17,185
1487,67,16,68,17,168
1488,65,34,66,18,183
1491,68,16,66,16,166
1492,68,32,67,18,185
1494,51,15,67,18,151
1495,66,16,67,16,165
1496,66,33,68,17,184
1498,67,34,67,15,183
1500,67,34,66,16,183
1501,67,18,66,16,167
1502,68,33,65,19,185
1504,67,33,67,16,183
1505,66,18,67,16,167
1508,65,35,67,16,183
1509,69,16,67,16,168
1510,67,32,67,18,184
1511,67,16,67,18,168
1512,67,35,65,18,185
1513,83,32,68,19,202
1514,67,32,68,19,186
1515,67,16,68,19,170
1516,67,33,68,17,185
1518,65,35,67,14,181
1519,84,33,67,16,200
1520,68,33,67,16,184
1521,69,14,67,16,166
1522,54,14,67,16,151
1525,62,19,65,18,164
1526,67,32,67,16,182
1527,66,16,67,16,165
1528,65,33,68,17,183
1529,67,17,68,17,169
1531,67,16,68,15,166
1532,67,34,82,16,199
1533,67,18,82,16,183
1535,67,17,82,17,183
1536,68,31,68,16,183
1538,65,33,67,19,184
1540,82,17,67,16,182
1541,67,17,67,16,167
1542,68,32,65,19,184
1543,67,16,65,19,167
1544,67,35,67,16,185
1545,68,16,67,16,167
1546,67,30,69,17,183
1547,67,14,69,17,167
1548,65,37,67,15,184
1549,65,18,67,15,165
1550,67,32,50,16,165
1552,69,35,67,15,186
1553,67,18,67,15,167
1554,67,31,68,17,183
1556,50,16,68,17,151
1557,66,19,64,17,166
1558,67,32,67,15,181
1559,67,17,67,15,166
1560,68,32,68,17,185
1561,68,15,68,17,168
1562,64,35,67,15,181
1564,67,33,66,18,184
1565,83,34,65,20,202
1567,68,17,65,20,170
1569,67,17,66,19,169
1570,66,33,68,17,184
1573,83,35,84,16,218
1574,66,35,84,16,201
1575,83,34,81,18,216
1576,68,34,81,18,201
1577,65,17,81,18,181
1578,52,17,81,18,168
1580,84,16,67,16,183
1581,67,16,67,16,166
1583,66,18,67,16,167
1586,67,33,65,19,184
1587,68,17,65,19,169
1588,67,32,68,16,183
1589,67,16,68,16,167
1590,65,33,69,15,182
1591,66,16,69,15,166
1592,65,35,65,19,184
1593,68,16,65,19,168
1594,68,34,65,19,186
1595,67,18,65,19,169
1596,69,31,53,16,169
1598,65,34,83,17,199
1599,83,35,81,17,216
1600,65,35,81,17,198
1602,53,16,81,17,167
1604,83,17,66,18,184
1607,66,17,68,16,167
1608,66,33,69,16,184
1609,68,15,69,16,168
1610,66,35,65,18,184
1611,85,34,64,18,201
1614,69,31,68,17,185
1616,65,33,69,16,183
1619,83,34,65,17,199
1621,84,31,67,19,201
1623,67,15,67,19,168
1624,65,34,67,18,184
1625,65,17,67,18,167
1626,65,33,68,16,182
1627,66,16,68,16,166
1629,69,15,67,16,167
1630,67,34,66,18,185
1632,52,16,66,18,152
1633,65,17,51,17,150
1634,67,33,67,16,183
1635,65,17,67,16,165
1636,66,35,65,17,183
1641,65,17,68,17,167
1642,65,33,69,16,183
1643,66,16,69,16,167
1644,66,35,66,17,184
1645,67,18,66,17,168
1646,68,34,65,17,184
1647,68,17,65,17,167
1648,69,32,66,18,185
1651,66,16,68,16,166
1652,65,33,66,17,181
1653,82,35,65,17,199
1654,66,35,65,17,183
1655,67,17,65,17,166
1657,67,15,69,16,167
1658,66,34,67,17,184
1659,65,17,67,17,166
1660,65,35,66,17,183
1661,84,32,67,17,200
1662,69,32,67,17,185
1664,67,34,65,19,185
1665,67,17,65,19,168
1667,67,16,67,17,167
1668,67,32,67,18,184
1670,65,35,68,14,182
1671,67,16,68,14,165
1672,67,32,68,16,183
1674,67,36,65,15,183
1675,66,18,65,15,164
1676,68,32,65,17,182
1677,65,18,65,17,165
1679,66,17,66,17,166
1680,65,32,68,17,182
1681,66,17,68,17,168
1682,65,34,51,17,167
1683,83,34,82,18,217
1684,66,34,82,18,200
1685,68,17,82,18,185
1686,68,34,82,15,199
1689,66,17,65,18,166
1691,65,18,66,16,165
1693,67,15,69,17,168
1694,65,35,68,16,184
1695,67,17,68,16,168
1696,66,34,67,17,184
1697,84,34,66,16,200
1698,69,34,66,16,185
1700,68,33,67,15,183
1701,68,17,67,15,167
1702,67,33,68,16,184
1703,67,16,68,16,167
1705,84,34,66,16,200
1707,65,19,66,16,166
1708,68,31,67,17,183
1709,68,15,67,17,167
1710,65,35,65,17,182
1711,66,19,65,17,167
1712,66,32,68,17,183
1713,66,16,68,17,167
1714,67,33,67,16,183
1715,68,16,67,16,167
1716,65,35,83,17,200
1718,68,32,83,17,200
1721,66,18,66,18,168
1722,83,17,67,15,182
1724,83,17,67,18,185
1727,67,17,66,15,165
1728,67,32,67,16,182
1729,67,17,67,16,167
1731,83,33,66,18,200
1732,66,33,66,18,183
1733,66,18,66,18,168
1734,67,33,66,17,183
1735,65,17,66,17,165
1736,66,33,70,14,183
1737,67,17,70,14,168
1738,66,33,68,15,182
1739,83,37,81,16,217
1740,66,37,81,16,200
1741,67,20,81,16,184
1742,70,31,66,17,184
1743,66,17,66,17,166
1744,68,33,67,17,185
1746,81,16,68,17,182
1748,66,34,66,16,182
1749,68,17,66,16,167
1751,67,17,83,15,182
1752,68,32,66,17,183
1753,68,15,66,17,166
1754,66,35,66,16,183
1756,83,15,68,16,182
1757,66,15,68,16,165
1758,66,35,65,18,184
1759,67,18,65,18,168
1760,66,33,65,17,181
1761,66,17,65,17,165
1764,65,33,68,16,182
1765,67,15,68,16,166
1766,65,34,68,17,184
1767,66,17,68,17,168
1768,67,34,67,18,186
1770,68,34,65,17,184
1771,85,33,65,17,200
1772,68,33,65,17,183
1774,67,32,68,16,183
1776,65,33,68,16,182
1777,65,16,68,16,165
1778,65,35,66,17,183
1779,64,18,66,17,165
1780,68,33,66,18,185
1781,67,17,66,18,168
1782,68,33,66,19,186
1783,67,17,66,19,169
1785,83,33,67,18,201
1788,51,15,67,18,151
1789,68,14,67,18,167
1790,66,34,67,17,184
1791,67,15,67,17,166
1794,67,34,51,15,167
1795,82,32,67,17,198
1796,67,32,67,17,183
1797,66,15,67,17,165
1798,66,34,68,15,183
1799,67,15,68,15,165
1800,66,33,68,16,183
1803,83,33,66,17,199
1804,68,33,66,17,184
1805,66,18,66,17,167
1807,67,18,66,18,169
1808,67,32,67,16,182
1810,66,34,65,19,184
1811,67,17,65,19,168
1812,66,33,67,17,183
1813,68,15,67,17,167
1814,67,32,69,15,183
1817,82,34,82,17,215
1819,68,17,82,17,184
1821,65,17,67,18,167
1822,66,34,67,18,185
1823,66,17,67,18,168
1825,67,17,52,15,151
1826,67,34,65,19,185
1827,68,16,65,19,168
1828,67,33,68,16,184
1829,69,15,68,16,168
1833,66,17,66,16,165
1834,68,33,65,17,183
1835,67,17,65,17,166
1837,66,17,66,17,166
1839,82,34,68,16,200
1840,65,34,68,16,183
1842,66,33,51,14,164
1845,66,19,66,15,166
1846,68,30,69,16,183
1847,67,14,69,16,166
1848,51,14,69,16,150
1849,68,17,65,18,168
1850,66,33,66,18,183
1851,83,32,67,17,199
1852,69,32,67,17,185
1853,66,16,67,17,166
1854,65,34,66,18,183
1857,83,33,68,15,199
1858,67,33,68,15,183
1860,66,34,67,16,183
1861,66,16,67,16,165
1862,67,34,67,16,184
1863,68,16,67,16,167
1864,68,33,66,17,184
1866,67,34,66,16,183
1867,65,18,66,16,165
1868,67,32,67,16,182
1869,68,16,67,16,167
1870,66,34,67,15,182
1873,66,17,66,19,168
1874,67,34,66,16,183
1876,67,32,68,16,183
1877,66,17,68,16,167
1878,66,34,66,18,184
1879,84,34,67,15,200
1880,66,34,67,15,182
1881,67,18,67,15,167
1882,68,32,67,16,183
1883,65,16,67,16,164
1885,68,17,66,16,167
1886,67,32,67,18,184
1887,66,17,67,18,168
1888,67,34,65,19,185
1891,67,17,68,15,167
1893,69,14,68,17,168
1894,65,36,66,17,184
1897,65,17,67,17,166
1898,68,34,66,17,185
1899,66,17,66,17,166
1900,66,33,66,18,183
1901,68,16,66,18,168
1902,67,33,66,18,184
1903,67,16,66,18,167
1904,66,33,67,16,182
1905,66,16,67,16,165
1906,66,33,66,18,183
1907,82,34,69,14,199
1911,65,16,68,16,165
1912,66,37,65,17,185
1913,85,31,51,17,184
1914,69,31,51,17,168
1915,53,31,51,17,152
1916,68,34,67,16,185
1919,68,17,65,17,167
1922,67,32,68,16,183
1923,82,34,67,15,198
1924,65,34,67,15,181
1925,66,17,67,15,165
1926,66,34,67,16,183
1927,68,16,67,16,167
1928,68,33,67,15,183
1929,67,17,67,15,166
1930,67,34,65,17,183
1932,67,33,69,12,181
1935,67,17,68,15,167
1936,65,37,81,16,199
1939,66,19,83,15,183
1940,68,32,66,17,183
1942,81,16,68,15,180
1943,69,16,68,15,168
1944,83,15,69,17,184
1946,66,36,66,16,184
1947,65,19,66,16,166
1948,68,33,65,17,183
1951,69,16,65,18,168
1954,65,33,67,17,182
1955,65,16,67,17,165
1956,65,34,67,16,182
1957,67,16,67,16,166
1958,67,33,69,15,184
1959,67,16,69,15,167
1960,67,34,68,16,185
1961,66,17,68,16,167
1963,66,19,64,18,167
1964,69,33,65,17,184
1966,68,31,67,16,182
1967,68,15,67,16,166
1968,64,34,66,18,182
1969,67,16,66,18,167
1973,82,34,66,19,201
1976,67,33,66,18,184
1978,67,33,68,16,184
1979,65,17,68,16,166
1980,66,33,67,18,184
1982,66,35,65,19,185
1983,68,17,65,19,169
1984,68,32,69,17,186
1985,65,16,69,17,167
1987,67,15,68,15,165
1989,68,17,66,16,167
1991,83,34,66,16,199
1992,68,34,66,16,184
1993,83,33,65,17,198
1994,66,33,65,17,181
1995,65,17,65,17,164
2000,65,34,68,16,183
2001,65,17,68,16,166
2002,66,34,66,17,183
2003,67,17,66,17,167
2005,67,18,66,16,167
2006,68,32,67,16,183
2007,83,34,66,19,202
2008,66,34,66,19,185
2013,83,35,66,17,201
2014,66,35,66,17,184
2015,69,16,66,17,168
2016,68,33,65,16,182
2018,68,33,85,14,200
2019,65,17,85,14,181
2020,66,32,67,17,182
2021,68,15,67,17,167
2022,65,33,68,17,183
2023,82,34,51,17,184
2025,82,34,67,16,199
2026,67,34,67,16,184
2027,68,17,67,16,168
2028,68,34,66,17,185
2029,65,17,66,17,165
2030,51,17,66,17,151
2031,68,16,66,16,166
2032,67,33,66,18,184
2033,66,17,66,18,167
2034,66,33,68,17,184
2035,66,16,68,17,167
2037,66,17,52,14,149
2039,67,17,65,21,170
2041,69,14,55,14,152
2042,52,14,55,14,135
2043,65,17,66,16,164
2044,65,35,65,18,183
2045,69,14,65,18,166
2046,55,14,65,18,152
2047,69,14,52,16,151
2048,66,34,68,17,185
2049,79,34,65,18,196
2050,65,34,65,18,182
2052,52,16,65,18,151
2054,68,31,71,15,185
2055,67,14,71,15,167
2056,65,34,52,15,166
2057,66,16,52,15,149
2058,65,37,81,17,200
2059,85,30,68,17,200
2060,71,30,68,17,186
2061,68,15,68,17,168
2062,52,15,68,17,152
2063,67,17,67,18,169
2065,66,17,67,16,166
2066,68,33,67,15,183
2068,67,34,66,17,184
2069,84,33,65,16,198
2070,67,33,65,16,181
2072,67,33,67,16,183
2074,83,15,67,17,182
2077,66,19,65,18,168
2079,66,16,68,17,167
2080,67,33,68,16,184
2081,68,16,68,16,168
2082,65,35,65,17,182
2083,84,33,66,19,202
2085,68,16,66,19,169
2086,68,32,67,19,186
2087,66,16,67,19,168
2088,65,34,65,18,182
2089,65,17,65,18,165
2091,69,14,66,17,166
2092,67,32,70,17,186
2093,69,13,70,17,169
2095,80,36,81,19,216
2098,70,32,68,16,186
2099,69,15,68,16,168
2100,53,15,68,16,152
2101,69,15,51,18,153
2102,81,19,65,17,182
2103,64,19,65,17,165
2104,68,34,64,19,185
2106,51,18,64,19,152
2108,65,33,67,17,182
2109,66,16,67,17,166
2110,83,15,66,19,183
2111,68,15,66,19,168
2112,52,15,66,19,152
2113,66,17,68,16,167
2114,67,33,69,15,184
2115,81,35,65,18,199
2116,66,35,65,18,184
2119,67,18,62,21,168
2120,69,31,52,16,168
2121,65,16,52,16,149
2122,65,31,70,17,183
2124,62,37,68,14,181
2125,68,16,68,14,166
2126,52,16,68,14,150
2127,66,17,66,16,165
2128,70,35,80,18,203
2129,84,31,84,17,216
2130,68,31,84,17,200
2131,66,17,84,17,184
2132,66,33,68,17,184
2133,65,17,68,17,167
2134,80,18,68,15,181
2136,84,17,66,17,184
2137,68,17,66,17,168
2138,68,34,65,18,185
2139,52,34,65,18,169
2140,68,32,65,19,184
2141,66,17,65,19,167
2142,66,33,51,15,165
2144,65,32,68,18,183
2145,68,14,68,18,168
2146,65,34,68,18,185
2147,67,15,68,18,168
2148,51,15,68,18,152
2150,68,34,66,16,184
2151,67,16,66,16,165
2153,68,16,65,18,167
2155,66,16,66,17,165
2157,64,17,67,18,166
2158,65,33,69,16,183
2159,67,15,69,16,167
2160,66,34,68,16,184
2162,67,35,67,15,184
2165,68,17,64,19,168
2166,68,34,64,18,184
2169,66,15,52,16,149
2171,67,15,69,15,166
2172,64,34,67,16,181
2173,67,16,67,16,166
2174,52,16,67,16,151
2175,68,16,66,17,167
2178,67,34,66,16,183
2179,64,18,66,16,164
2180,66,33,65,19,183
2181,84,33,68,14,199
2182,67,33,68,14,182
2183,66,18,68,14,166
2185,65,16,69,15,165
2186,65,36,65,19,185
2187,69,17,65,19,170
2188,68,33,66,14,181
2189,66,19,66,14,165
2190,69,32,67,17,185
2191,65,17,67,17,166
2192,65,34,67,17,183
2195,65,19,68,14,166
2196,67,34,66,17,184
2198,50,17,66,17,150
2199,70,17,66,16,169
2201,65,18,67,16,166
2203,83,33,65,19,200
2205,68,17,65,19,169
2206,67,32,52,12,163
2207,66,16,52,12,146
2211,68,12,69,18,167
2212,52,12,69,18,151
2213,69,15,66,16,166
2214,68,32,68,18,186
2215,81,34,66,18,199
2216,69,34,66,18,187
2217,81,34,66,19,200
2218,66,34,66,19,185
2219,66,18,66,19,169
2221,68,14,70,14,166
2222,66,34,50,18,168
2223,68,16,50,18,152
2224,66,36,81,16,199
2225,67,17,81,16,181
2228,50,18,65,16,149
2229,65,17,65,18,165
2230,81,16,68,15,180
2233,65,17,70,16,168
2234,65,35,67,16,183
2236,68,35,67,13,183
2237,67,20,67,13,167
2238,70,32,66,16,184
2240,67,35,65,15,182
2241,68,19,65,15,167
2243,64,18,67,16,165
2245,66,18,65,17,166
2246,65,33,65,18,181
2247,67,18,65,18,168
2248,67,32,67,16,182
2249,67,16,67,16,166
2250,65,33,67,18,183
2251,67,16,67,18,168
2252,65,34,51,16,166
2253,83,33,53,14,183
2255,66,17,53,14,150
2256,67,34,69,13,183
2257,67,16,69,13,165
2259,51,33,67,16,167
2261,67,18,66,16,167
2265,65,19,65,17,166
2266,66,30,69,17,182
2268,65,35,67,16,183
2270,65,34,66,16,181
2273,67,16,69,14,166
2274,67,33,67,17,184
2275,66,17,67,17,167
2276,66,36,64,16,182
2277,65,20,64,16,165
2278,69,31,68,16,184
2279,67,17,68,16,168
2280,67,33,67,16,183
2281,68,16,67,16,167
2282,64,35,66,16,181
2283,85,32,66,18,201
2284,68,32,66,18,184
2285,67,16,66,18,167
2286,67,34,65,17,183
2287,67,18,65,17,167
2289,66,16,68,20,170
2290,66,33,55,13,167
2291,68,15,55,13,151
2292,65,35,65,19,184
2293,66,18,65,19,168
2294,68,33,67,17,185
2296,55,13,67,17,152
2298,65,35,66,16,182
2299,64,16,66,16,162
2300,67,34,66,15,182
2302,52,17,66,15,150
2303,64,18,67,16,165
2305,65,18,68,16,167
2306,66,33,67,15,181
2307,67,18,67,15,167
2308,67,35,65,16,183
2309,67,19,65,16,167
2311,53,32,67,14,166
2314,65,34,66,14,179
2315,65,18,66,14,163
2316,67,33,67,15,182
2317,66,19,67,15,167
2318,67,33,65,18,183
2319,67,17,65,18,167
2320,80,20,65,16,181
2321,66,20,65,16,167
2322,67,31,69,15,182
2323,66,16,69,15,166
2324,65,34,67,16,182
2325,69,16,67,16,168
2326,65,35,67,14,181
2327,66,19,67,14,166
2330,67,35,64,18,184
2331,67,19,64,18,168
2333,66,17,68,16,167
2335,69,14,68,16,167
2336,64,35,65,17,181
2337,68,17,65,17,167
2338,68,33,67,16,184
2340,68,32,69,16,185
2341,66,16,69,16,167
2342,65,35,66,18,184
2343,66,18,66,18,168
2344,67,34,66,17,184
2345,67,18,66,17,168
2347,68,16,68,17,169
2348,50,16,68,17,151
2349,68,16,67,15,166
2350,66,34,67,14,181
2353,67,16,65,18,166
2356,67,31,67,16,181
2357,64,17,67,16,164
2358,65,35,65,16,181
2360,66,32,67,17,182
2362,67,33,67,17,184
2364,65,34,67,19,185
2365,64,18,67,19,168
2366,67,33,53,14,167
2367,68,16,53,14,151
2368,67,34,67,17,185
2369,68,17,67,17,169
2371,69,14,66,17,166
2372,53,14,66,17,150
2373,66,18,67,16,167
2374,67,32,67,17,183
2375,65,15,67,17,164
2377,67,18,67,16,168
2378,67,32,67,16,182
2379,82,35,67,15,199
2381,67,18,67,15,167
2382,67,32,66,19,184
2383,67,16,66,19,168
2384,67,35,65,18,185
2385,66,19,65,18,168
2388,66,34,68,17,185
2389,69,15,68,17,169
2390,65,34,68,14,181
2391,68,16,68,14,166
2393,65,18,64,19,166
2394,68,34,66,16,184
2395,67,17,66,16,166
2397,66,16,68,16,166
2398,64,36,65,16,181
2399,83,32,67,17,199
2400,66,32,67,17,182
2401,68,16,67,17,168
2402,68,33,68,17,186
2403,65,17,68,17,167
2404,65,34,67,17,183
2405,65,18,67,17,167
2407,68,17,66,18,169
2408,68,33,66,16,183
2409,69,16,66,16,167
2410,67,33,67,15,182
2412,66,33,66,17,182
2414,66,34,67,15,182
2415,65,18,67,15,165
2416,67,32,68,17,184
2417,64,17,68,17,166
2418,66,35,67,16,184
2419,67,18,67,16,168
2420,67,33,65,19,184
2422,68,34,66,16,184
2425,68,15,69,17,169
2426,65,35,67,15,182
2427,67,16,67,15,165
2428,66,34,65,16,181
2429,66,18,65,16,165
2430,69,33,66,16,184
2431,67,16,66,16,165
2432,51,16,66,16,149
2434,65,34,67,16,182
2435,64,18,67,16,165
2439,67,18,65,18,168
2440,67,32,68,17,184
2441,67,16,68,17,168
2442,66,33,69,15,183
2444,65,35,67,16,183
2445,84,34,65,18,201
2446,68,34,65,18,185
2450,67,32,67,16,182
2451,66,16,67,16,165
2452,65,33,67,16,181
2453,68,15,67,16,166
2454,65,34,68,16,183
2456,67,33,66,18,184
2457,65,17,66,18,166
2458,67,35,66,15,183
2460,68,31,50,19,168
2461,68,15,50,19,152
2462,66,35,67,16,184
2463,68,17,67,16,168
2465,65,19,65,18,167
2469,68,16,66,21,171
2470,65,33,54,13,165
2473,68,14,67,18,167
2474,66,34,67,17,184
2477,81,34,66,16,197
2478,67,34,66,16,183
2479,64,16,66,16,162
2480,51,16,66,16,149
2481,66,17,67,15,165
2482,68,32,67,17,184
2483,66,16,67,17,166
2484,66,35,65,17,183
2485,65,19,65,17,166
2486,67,32,67,18,184
2487,66,17,67,18,168
2488,67,33,67,19,186
2489,68,16,67,19,170
2491,67,17,68,15,167
2492,67,33,66,19,185
2493,68,15,66,19,168
2495,69,16,66,16,167
2496,68,31,68,15,182
2497,81,35,65,18,199
2502,68,32,69,16,185
2503,81,36,66,15,198
2505,67,18,66,15,166
2508,69,33,66,17,185
2510,66,32,68,17,183
2511,65,17,68,17,167
2512,65,34,66,18,183
2514,66,34,65,18,183
2515,68,17,65,18,168
2516,68,32,67,16,183
2518,66,33,68,17,184
2519,67,15,68,17,167
2520,65,34,67,16,182
2523,65,18,67,16,166
2524,68,33,66,17,184
2525,83,34,66,17,200
2526,67,34,66,17,184
2527,67,18,66,17,168
2531,67,17,66,17,167
2532,66,33,66,17,182
2534,51,16,66,17,150
2536,66,33,67,17,183
2537,82,35,65,18,200
2538,66,35,65,18,184
2540,68,32,51,17,168
2541,68,15,51,17,151
2542,67,33,69,15,184
2543,67,16,69,15,167
2544,65,35,65,20,185
2547,67,18,66,17,168
2549,66,16,70,13,165
2550,65,35,83,16,199
2552,66,35,64,16,181
2553,68,18,64,16,166
2554,70,32,67,14,183
2555,63,19,67,14,163
2556,83,16,68,16,183
2557,66,16,68,16,166
2559,67,19,66,16,168
2560,67,33,66,17,183
2561,65,19,66,17,167
2562,68,33,66,17,184
2563,68,17,66,17,168
2564,66,33,66,18,183
2566,66,33,67,16,182
2567,83,33,66,18,200
2572,67,32,68,18,185
2573,66,16,68,18,168
2574,66,34,68,18,186
2575,66,16,68,18,168
2577,67,17,69,12,165
2578,68,34,81,17,200
2579,68,16,81,17,182
2581,69,17,63,17,166
2583,63,17,51,18,149
2584,81,17,51,18,167
2586,63,35,67,15,180
2587,68,18,67,15,168
2588,51,18,67,15,151
2590,51,18,66,17,152
2591,66,19,64,17,166
2592,67,33,65,19,184
2593,66,18,65,19,168
2594,66,31,53,14,164
2595,69,14,53,14,150
2596,64,34,66,18,182
2597,66,17,66,18,167
2600,53,14,68,16,151
2602,66,35,82,20,203
2603,65,17,82,20,184
2605,67,17,84,16,184
2606,51,17,84,16,168
2607,67,16,67,16,166
2608,82,20,63,18,183
2609,66,20,63,18,167
2611,67,16,67,17,167
2612,67,32,52,16,167
2614,63,35,84,17,199
2615,66,17,84,17,184
2617,68,16,68,17,169
2618,52,16,68,17,153
2620,84,17,64,18,183
2621,67,17,64,18,166
2624,64,33,67,19,183
2625,81,34,67,17,199
2626,64,34,67,17,182
2627,81,33,69,20,203
2629,66,16,69,20,171
2630,67,34,66,19,186
2631,68,15,66,19,168
2633,67,18,66,16,167
2634,51,18,66,16,151
2635,70,11,67,19,167
2636,66,35,67,16,184
2637,84,32,68,16,200
2638,66,32,68,16,182
2639,78,35,65,17,195
2642,67,33,66,16,182
2644,68,32,67,17,184
2645,81,34,67,17,199
2646,65,34,67,17,183
2648,66,33,67,16,182
2649,83,34,66,18,201
2650,67,34,66,18,185
2652,67,33,68,16,184
2653,68,16,68,16,168
2654,67,33,67,16,183
2655,66,17,67,16,166
2656,66,35,65,18,184
2657,67,17,65,18,167
2658,68,32,67,17,184
2660,67,33,68,18,186
2661,65,17,68,18,168
2662,65,34,65,18,182
2663,67,16,65,18,166
2664,67,34,67,16,184
2666,68,31,70,14,183
2667,81,36,66,17,200
2669,84,34,66,15,199
2670,67,34,66,15,182
2673,66,18,65,19,168
2674,66,34,66,15,181
2675,67,17,66,15,165
2676,66,31,68,16,181
2677,67,16,68,16,167
2680,66,33,66,17,182
2681,66,18,66,17,167
2682,68,33,67,17,185
2683,82,33,69,16,200
2685,70,14,69,16,169
2686,66,34,67,17,184
2687,67,17,67,17,168
2688,67,35,66,16,184
2691,68,16,65,19,168
2692,51,16,65,19,151
2693,67,17,65,18,167
2694,66,31,68,17,182
2696,65,34,68,16,183
2697,67,15,68,16,166
2698,65,34,67,18,184
2699,83,34,66,15,198
2700,68,34,66,15,183
2701,66,17,66,15,164
2702,68,33,84,15,200
2703,66,17,84,15,182
2704,67,33,66,17,183
2705,68,15,66,17,166
2706,66,32,68,17,183
2709,81,34,67,17,199
2710,66,34,67,17,184
2712,51,17,67,17,152
2713,66,18,67,16,167
2714,69,32,66,18,185
2715,67,17,66,18,168
2717,67,18,64,17,166
2718,67,31,66,17,181
2719,68,15,66,17,166
2720,66,33,67,16,182
2722,64,33,68,16,181
2724,66,34,68,14,182
2725,82,34,67,16,199
2727,66,18,67,16,167
2728,68,34,64,18,184
2730,68,33,67,15,183
2735,86,32,68,15,201
2737,66,17,68,15,166
2738,68,34,65,19,186
2739,67,17,65,19,168
2740,66,34,66,18,184
2742,68,31,53,15,167
2743,66,16,53,15,150
2744,65,35,82,18,200
2745,84,33,83,16,216
2747,51,33,83,16,183
2748,53,15,83,16,167
2750,82,18,65,19,184
2752,67,32,68,16,183
2753,67,16,68,16,167
2754,64,33,69,20,186
2755,67,16,69,20,172
2757,68,16,65,16,165
2758,68,34,66,17,185
2759,67,18,66,17,168
2760,69,31,68,16,184
2761,70,11,68,16,165
2763,65,19,65,18,167
2764,66,33,67,16,182
2766,68,32,68,16,184
2767,68,16,68,16,168
2771,67,17,67,17,168
2774,66,34,66,16,182
2775,66,18,66,16,166
2776,67,32,69,15,183
2777,83,34,68,16,201
2778,66,34,68,16,184
2779,67,17,68,16,168
2780,66,35,66,17,184
2781,65,19,66,17,167
2782,69,33,65,16,183
2783,67,18,65,16,166
2784,68,33,65,18,184
2785,68,17,65,18,168
2786,66,32,68,16,182
2787,68,15,68,16,167
2788,65,33,67,17,182
2789,65,17,67,17,166
2793,68,16,67,17,168
2794,67,35,66,15,183
2795,66,18,66,15,165
2797,66,17,66,18,167
2798,67,34,66,17,184
2799,67,17,66,17,167
2800,66,32,68,17,183
2802,66,34,66,18,184
2803,67,16,66,18,167
2804,66,34,67,16,183
2805,68,17,67,16,168
2806,68,32,66,19,185
2809,67,17,67,18,169
2810,67,31,54,14,166
2811,81,36,65,16,198
2812,66,36,65,16,183
2814,67,32,66,17,182
2815,69,14,66,17,166
2816,54,14,66,17,151
2817,82,33,68,17,200
2818,65,33,68,17,183
2821,67,17,67,16,167
2822,67,34,83,16,200
2823,67,18,83,16,184
2825,68,16,66,17,167
2827,67,18,66,16,167
2828,67,32,67,17,183
2831,67,17,66,17,167
2832,66,33,65,20,184
2833,66,17,65,20,168
2834,67,33,68,15,183
2836,66,32,68,18,184
2837,67,15,68,18,168
2838,65,36,66,16,183
2839,84,32,68,15,199
2841,66,17,68,15,166
2842,68,34,66,17,185
2843,66,16,66,17,165
2844,66,34,67,16,183
2845,67,18,67,16,168
2846,68,32,51,17,168
2847,65,17,51,17,150
2848,66,35,65,17,183
2849,85,33,66,16,200
2850,67,33,66,16,182
2851,68,17,66,16,167
2852,51,17,66,16,150
2853,66,17,68,15,166
2855,83,34,65,22,204
2856,66,34,65,22,187
2857,67,18,65,22,172
2859,66,18,64,18,166
2860,67,32,68,16,183
2862,65,32,69,15,181
2863,72,10,69,15,166
2865,67,18,65,17,167
2866,68,33,67,17,185
2867,79,32,69,16,196
2869,66,17,69,16,168
2870,65,35,67,17,184
2871,66,18,67,17,168
2873,52,34,66,16,168
2874,69,33,66,16,184
2876,67,33,67,16,183
2877,67,16,67,16,166
2878,66,33,68,16,183
2879,66,17,68,16,167
2880,66,34,66,16,182
2882,83,18,65,15,181
2883,67,18,65,15,165
2886,66,33,67,15,181
2887,66,17,67,15,165
2888,65,34,65,18,182
2890,67,33,67,16,183
2892,67,32,67,17,183
2896,67,32,67,18,184
2900,68,31,68,15,182
2901,68,15,68,15,166
2903,68,15,68,16,167
2904,64,35,66,17,182
2906,68,33,65,17,183
2907,83,33,66,16,198
2909,65,17,66,16,164
2910,66,32,65,19,182
2911,68,15,65,19,167
2912,65,34,68,17,184
2913,66,17,68,17,168
2914,66,31,69,16,182
2915,65,15,69,16,165
2917,67,18,65,19,169
2918,68,32,67,17,184
2920,54,15,67,17,153
2922,65,34,68,17,184
2923,67,15,68,17,167
2924,67,34,65,18,184
2925,68,17,65,18,168
2927,65,18,66,17,166
2928,68,31,67,17,183
2929,68,14,67,17,166
2930,65,35,65,17,182
2931,84,32,68,15,199
2932,66,32,68,15,181
2933,66,15,68,15,164
2934,67,33,67,17,184
2935,66,16,67,17,166
2936,65,35,68,14,182
2938,68,32,67,16,183
2941,67,19,66,15,167
2942,68,31,66,18,183
2943,67,17,66,18,168
2944,67,35,65,17,184
2946,66,31,67,18,182
2947,67,16,67,18,168
2948,66,34,67,17,184
2949,84,33,67,19,203
2952,67,34,52,17,170
2955,67,16,68,17,168
2957,68,17,64,17,166
2958,52,17,64,17,150
2959,52,32,66,17,167
2960,68,32,67,16,183
2961,66,15,67,16,164
2962,64,34,67,17,182
2963,83,33,66,19,201
2964,66,33,66,19,184
2965,66,16,66,19,167
2966,67,34,65,20,186
2968,67,32,69,14,182
2969,67,15,69,14,165
2972,65,36,65,17,183
2974,69,31,68,17,185
2975,64,17,68,17,166
2976,67,34,68,15,184
2977,64,17,68,15,164
2978,65,34,67,15,181
2980,68,34,66,15,183
2981,68,17,66,15,166
2982,68,33,65,16,182
2983,66,18,65,16,165
2984,67,33,84,15,199
2985,65,18,84,15,182
2987,66,17,67,19,169
2989,66,19,65,18,168
2990,84,15,69,14,182
2991,69,15,69,14,167
2994,51,14,67,18,150
2995,66,18,65,17,166
2996,51,18,65,17,151
2997,81,34,67,16,198
2998,67,34,67,16,184
3000,65,32,68,17,182
3001,68,15,68,17,168
3003,66,17,66,16,165
3006,68,33,66,17,184
3007,83,33,66,18,200
3009,83,33,68,16,200
3010,66,33,68,16,183
3011,65,17,68,16,166
3012,66,33,69,16,184
3014,66,35,67,16,184
3015,68,17,67,16,168
3016,68,34,66,16,184
3019,67,17,65,18,167
3020,67,33,66,16,182
3022,66,32,67,18,183
3023,66,16,67,18,167
3024,65,34,66,18,183
3026,66,33,68,15,182
3027,66,17,68,15,166
3028,67,33,67,17,184
3029,67,15,67,17,166
3031,68,17,67,16,168
3032,68,32,67,18,185
3033,65,17,67,18,167
3035,66,18,67,16,167
3036,67,32,68,15,182
3037,68,16,68,15,167
3038,51,16,68,15,150
3040,67,33,64,19,183
3041,84,32,67,17,200
3043,82,32,69,16,199
3044,65,32,69,16,182
3045,68,13,69,16,166
3047,68,16,66,16,166
3048,67,34,65,17,183
3050,69,32,66,17,184
3051,82,33,67,17,199
3052,66,33,67,17,183
3053,65,17,67,17,166
3054,65,33,67,16,181
3056,66,34,66,18,184
3058,67,33,67,17,184
3061,66,17,68,16,167
3062,66,34,66,19,185
3063,83,34,51,16,184
3064,67,34,51,16,168
3065,85,32,68,16,201
3066,68,32,68,16,184
3068,66,35,66,18,185
3071,68,16,67,17,168
3072,68,33,67,17,185
3073,65,17,67,17,166
3074,66,34,50,16,166
3075,83,33,67,15,198
3076,67,33,67,15,182
3078,67,33,67,16,183
3079,66,16,67,16,165
3082,67,33,67,15,182
3083,83,33,67,17,200
3084,67,33,67,17,184
3085,82,34,66,16,198
3086,66,34,66,16,182
3088,67,33,67,16,183
3089,66,18,67,16,167
3090,67,33,66,17,183
3093,67,18,65,17,167
3094,67,32,68,17,184
3095,66,16,68,17,167
3097,67,16,52,16,151
3098,65,35,67,15,182
3099,66,18,67,15,166
3100,68,33,66,18,185
3101,68,16,66,18,168
3103,66,19,65,17,167
3104,67,32,68,17,184
3105,65,17,68,17,167
3106,49,17,68,17,151
3107,69,15,68,17,169
3108,65,35,65,18,183
3109,67,18,65,18,168
3110,68,33,65,18,184
3111,67,16,65,18,166
3112,68,32,67,17,184
3113,68,15,67,17,167
3114,65,33,51,16,165
3116,65,34,67,17,183
3117,66,16,67,17,166
3118,67,33,66,18,184
3119,66,16,66,18,166
3121,66,17,67,17,167
3122,67,32,70,16,185
3123,67,15,70,16,168
3125,67,17,51,15,150
3126,67,35,82,16,200
3127,67,18,82,16,183
3128,52,18,82,16,168
3129,68,15,67,16,166
3130,51,15,67,16,149
3132,82,16,66,17,181
3133,66,16,66,17,165
3134,67,35,81,18,201
3136,70,31,68,17,186
3138,66,33,67,17,183
3139,67,16,67,17,167
3140,81,18,66,18,183
3142,68,32,69,17,186
3146,66,35,64,17,182
3147,67,17,64,17,165
3149,69,14,68,17,168
3150,66,33,52,16,167
3151,67,14,52,16,149
3152,64,35,67,16,182
3153,64,18,67,16,165
3155,66,16,67,18,167
3157,68,17,65,19,169
3158,67,33,51,17,168
3159,83,32,69,16,200
3161,82,36,64,18,200
3164,51,17,64,18,150
3165,66,17,66,16,165
3167,66,15,68,16,165
3168,64,35,66,16,181
3169,83,33,67,16,199
3170,66,33,67,16,182
3172,68,33,66,18,185
3175,66,18,50,16,150
3176,67,32,68,17,184
3177,67,16,68,17,168
3178,66,34,67,16,183
3180,66,34,66,17,183
3182,68,33,67,17,185
3183,67,16,67,17,167
3184,51,16,67,17,151
3185,66,17,51,17,151
3187,66,17,67,17,167
3188,67,34,66,16,183
3189,68,17,66,16,167
3192,67,33,66,17,183
3193,67,16,66,17,166
3196,65,34,67,16,182
3199,67,17,66,18,168
3201,84,33,66,16,199
3202,67,33,66,16,182
3203,66,17,66,16,165
3204,66,35,81,19,201
3206,68,31,69,16,184
3207,68,15,69,16,168
3208,66,34,65,20,185
3211,84,30,68,18,200
3212,69,30,68,18,185
3214,51,14,68,18,151
3216,66,32,52,15,165
3217,66,16,52,15,149
3218,68,34,66,17,185
3219,66,16,66,17,165
3220,66,33,67,16,182
3221,68,15,67,16,166
3222,52,15,67,16,150
3224,66,34,67,16,183
3225,82,34,64,17,197
3226,67,34,64,17,182
3227,84,33,66,17,200
3228,68,33,66,17,184
3229,66,18,66,17,167
3231,67,15,68,19,169
3232,64,35,52,13,164
3233,66,18,52,13,149
3234,66,33,67,18,184
3235,67,16,67,18,168
3236,68,32,69,17,186
3238,52,13,69,17,151
3239,67,16,67,16,166
3241,66,16,65,19,166
3242,69,33,65,18,185
3243,67,16,65,18,166
3244,51,16,65,18,150
3245,65,16,51,16,148
3247,81,34,85,16,216
3249,67,16,85,16,184
3250,51,16,85,16,168
3252,84,18,65,19,186
3256,68,32,67,17,184
3258,65,34,67,17,183
3259,82,33,68,15,198
3262,67,34,67,15,183
3263,65,17,67,15,164
3265,66,17,66,17,166
3267,66,18,68,17,169
3269,65,18,52,14,149
3270,66,35,64,17,182
3271,68,18,64,17,167
3272,68,31,68,17,184
3273,70,14,68,17,169
3274,52,14,68,17,151
3275,66,16,67,17,166
3277,64,18,67,16,165
3278,68,32,68,17,185
3279,68,15,68,17,168
3280,67,35,67,16,185
3281,67,18,67,16,168
3282,67,33,66,14,180
3283,66,17,66,14,163
3284,68,34,64,17,183
3286,67,32,68,15,182
3287,67,16,68,15,166
3288,66,32,67,17,182
3289,81,36,66,15,198
3290,64,36,66,15,181
3291,84,31,68,15,198
3293,69,16,68,15,168
3294,67,35,66,16,184
3295,67,18,66,16,167
3296,66,33,66,16,181
3297,66,18,66,16,166
3298,68,33,67,15,183
3299,66,18,67,15,166
3300,66,33,67,16,182
3301,67,17,67,16,167
3304,67,33,51,15,166
3306,67,33,67,17,184
3307,67,17,67,17,168
3309,69,15,69,16,169
3310,51,15,69,16,151
3311,50,34,67,16,167
3312,67,35,64,18,184
3314,69,32,67,16,184
3315,52,32,67,16,167
3316,67,32,69,15,183
3317,66,16,69,15,166
3318,64,35,68,13,180
3319,66,17,68,13,164
3321,67,18,66,17,168
3322,69,34,65,17,185
3324,68,32,65,18,183
3326,66,33,68,15,182
3327,68,16,68,15,167
3328,65,32,66,20,183
3330,65,36,66,16,183
3331,66,18,66,16,166
3332,68,30,69,18,185
3333,81,36,68,15,200
3334,66,36,68,15,185
3335,68,16,68,15,167
3336,66,33,62,21,182
3342,62,38,65,18,183
3343,65,17,65,18,165
3344,65,34,67,14,180
3345,84,31,68,15,198
3346,72,31,68,15,186
3348,65,36,64,17,182
3349,68,18,64,17,167
3350,67,32,68,16,183
3352,68,32,68,17,185
3353,65,17,68,17,167
3354,64,36,66,15,181
3355,67,19,66,15,167
3356,68,32,67,18,185
3357,69,16,67,18,170
3358,68,34,66,16,184
3360,66,33,67,16,182
3362,67,33,68,16,184
3364,51,15,68,16,150
3366,67,34,64,19,184
3367,83,31,69,16,199
3368,68,31,69,16,184
3369,68,15,69,16,168
3370,65,33,68,16,182
3371,67,15,68,16,166
3372,64,36,66,17,183
3373,67,17,66,17,167
3374,69,32,67,15,183
3376,68,34,67,16,185
3377,65,18,67,16,166
3378,66,33,66,16,181
3379,67,16,66,16,165
3381,66,19,66,16,167
3383,66,16,67,18,167
3384,66,34,66,18,184
3385,67,18,66,18,169
3386,66,33,67,16,182
3387,66,17,67,16,166
3388,67,33,68,15,183
3393,65,18,65,18,166
3396,65,34,69,16,184
3397,83,33,52,17,185
3398,65,33,52,17,167
3399,68,15,52,17,152
3400,67,36,81,16,200
3401,65,18,81,16,180
3402,69,33,64,19,185
3403,67,17,64,19,167
3404,52,17,64,19,152
3406,81,16,67,19,183
3407,81,35,68,14,198
3408,64,35,68,14,181
3409,68,16,68,14,166
3410,67,32,67,19,185
3411,69,14,67,19,169
3413,67,17,64,17,165
3415,64,17,68,16,165
3417,67,14,51,14,146
3419,67,18,82,17,184
3420,68,30,69,18,185
3421,65,14,69,18,166
3422,51,14,69,18,152
3423,66,17,52,16,151
3424,82,17,67,16,182
3425,66,17,67,16,166
3427,69,16,67,17,169
3428,52,16,67,17,152
3430,67,34,65,18,184
3431,65,18,65,18,166
3432,67,32,68,17,184
3434,66,33,66,19,184
3435,68,15,66,19,168
3436,65,35,65,16,181
3438,51,17,65,16,149
3439,67,14,68,16,165
3441,67,15,67,17,166
3442,50,15,67,17,149
3443,82,33,67,18,200
3444,68,33,67,18,186
3445,65,17,67,18,167
3447,68,19,63,20,170
3448,69,31,66,19,185
3450,67,32,69,15,183
3451,68,14,69,15,166
3452,63,34,68,15,180
3453,71,14,68,15,168
3454,66,35,65,17,183
3455,83,33,65,17,198
3456,69,33,65,17,184
3458,68,32,67,16,183
3459,64,17,67,16,164
3460,65,33,69,15,182
3461,67,16,69,15,167
3462,65,34,66,18,183
3463,67,17,66,18,168
3464,67,35,66,16,184
3465,66,19,66,16,167
3466,69,31,69,16,185
3467,67,16,69,16,168
3468,66,35,65,16,182
3469,68,17,65,16,166
3470,66,34,65,16,181
3473,67,15,67,19,168
3474,65,34,66,16,181
3475,65,18,66,16,165
3477,82,33,67,16,198
3478,67,33,67,16,183
3479,70,14,67,16,167
3480,66,36,64,16,182
3484,67,33,69,15,184
3485,67,17,69,15,168
3489,68,18,64,17,167
3490,69,32,68,15,184
3491,68,17,68,15,168
3492,66,32,51,16,165
3493,66,16,51,16,149
3494,64,36,65,18,183
3495,66,19,65,18,168
3496,68,31,68,18,185
3498,67,34,67,15,183
3500,65,34,66,18,183
3502,68,33,51,17,169
3505,64,18,67,15,164
3506,66,35,64,17,182
3508,51,17,64,17,149
3509,70,15,66,18,169
3510,67,32,69,16,184
3511,64,17,69,16,166
3513,81,35,67,16,199
3515,69,17,67,16,169
3520,67,31,68,15,181
3524,67,32,66,17,182
3527,64,19,66,18,167
3529,66,17,52,17,152
3530,66,34,83,16,199
3532,66,35,64,17,182
3533,69,17,64,17,167
3534,52,17,64,17,150
3537,65,16,67,17,165
3538,64,34,66,17,181
3541,66,17,66,18,167
3542,67,33,68,16,184
3543,67,16,68,16,167
3545,83,35,68,16,202
3546,66,35,68,16,185
3547,84,32,68,17,201
3550,67,36,65,16,184
3551,67,18,65,16,166
3553,68,16,66,15,165
3554,68,33,65,17,183
3555,67,16,65,17,165
3556,65,33,66,17,181
3557,82,32,67,17,198
3558,66,32,67,17,182
3559,64,17,67,17,165
3560,65,34,67,16,182
3561,66,17,67,16,166
3563,68,16,67,18,169
3564,51,16,67,18,152
3565,67,17,66,17,167
3566,67,33,68,17,185
3567,83,33,52,17,185
3568,67,33,52,17,169
3569,68,15,52,17,152
3570,66,35,65,17,183
3571,67,18,65,17,167
3572,68,34,65,18,185
3573,67,17,65,18,167
3574,52,17,65,18,152
3575,52,31,70,15,168
3576,65,34,67,17,183
3577,65,17,67,17,166
3578,65,36,65,16,182
3579,69,18,65,16,168
3582,67,34,65,18,184
3583,66,17,65,18,166
3584,65,33,66,17,181
3586,67,32,67,19,185
3587,69,13,67,19,168
3588,65,34,52,15,166
3589,67,16,52,15,150
3590,66,33,67,17,183
3594,52,15,67,17,151
3595,68,15,66,17,166
3596,67,34,65,18,184
3597,82,32,51,18,183
3598,67,32,51,18,168
3599,81,33,70,16,200
3600,66,33,70,16,185
3601,66,16,70,16,168
3602,65,36,67,16,184
3603,66,18,67,16,167
3607,68,17,65,17,167
3608,67,33,66,17,183
3609,69,17,66,17,169
3610,66,32,66,18,182
3612,65,34,66,16,181
3613,83,32,68,15,198
3615,68,15,68,15,166
3619,83,34,66,15,198
3620,68,34,66,15,183
3621,65,19,66,15,165
3622,68,33,65,16,182
3624,67,33,67,17,184
3625,67,18,67,17,169
3627,65,17,68,17,167
3629,66,19,64,18,167
3630,67,33,65,17,182
3632,68,31,67,18,184
3633,69,14,67,18,168
3635,81,33,68,16,198
3636,65,33,68,16,182
3637,65,16,68,16,165
3638,67,34,68,16,185
3640,67,34,50,17,168
3641,66,18,50,17,151
3643,66,18,66,16,166
3644,68,33,66,19,186
3645,68,17,66,19,170
3647,51,33,65,19,168
3649,66,17,67,17,167
3650,66,32,69,17,184
3651,81,35,66,18,200
3652,65,35,66,18,184
3655,65,17,66,18,166
3657,67,15,66,18,166
3658,66,34,68,17,185
3660,66,32,53,15,166
3661,67,14,53,15,149
3663,84,32,66,17,199
3664,68,32,66,17,183
3665,67,15,66,17,165
3666,53,15,66,17,151
3667,67,17,66,16,166
3668,66,32,68,16,182
3669,65,16,68,16,165
3670,66,34,67,16,183
3671,66,17,67,16,166
3672,66,34,66,17,183
3676,67,33,66,18,184
3678,66,34,65,16,181
3679,84,32,67,17,200
3680,67,32,67,17,183
3681,66,17,67,17,167
3682,66,33,67,18,184
3683,67,15,67,18,167
3684,65,34,68,16,183
3686,67,33,68,16,184
3688,67,35,66,17,185
3689,69,17,66,17,169
3690,51,17,66,17,151
3691,67,17,68,14,166
3692,68,33,66,16,183
3693,66,17,66,16,165
3696,68,31,66,17,182
3701,66,17,67,18,168
3702,66,35,65,18,184
3703,67,18,65,18,168
3704,67,32,68,17,184
3705,69,15,68,17,169
3707,83,35,83,15,216
3708,65,35,83,15,198
3713,66,18,67,15,166
3714,83,15,69,15,182
3715,66,15,69,15,165
3716,66,36,65,16,183
3717,67,18,65,16,166
3718,67,33,66,17,183
3722,65,34,68,16,183
3723,66,18,68,16,168
3724,66,31,69,17,183
3726,51,14,69,17,151
3727,68,18,66,17,169
3729,67,16,67,15,165
3731,67,17,66,16,166
3733,83,33,67,15,198
3735,65,18,67,15,165
3737,65,18,67,16,166
3739,68,17,69,12,166
3740,67,34,81,18,200
3742,67,35,64,15,181
3743,67,19,64,15,165
3744,69,31,67,15,182
3745,66,19,67,15,167
3746,66,33,64,19,182
3749,67,19,65,17,168
3752,64,35,67,17,183
3756,70,32,67,17,186
3758,67,34,67,17,185
3759,67,17,67,17,168
3760,66,33,67,15,181
3761,65,19,67,15,166
3762,67,34,65,19,185
3763,67,17,65,19,168
3764,67,33,51,15,166
3765,70,16,51,15,152
3766,67,32,67,18,184
3767,65,17,67,18,167
3768,65,34,68,14,181
3769,67,15,68,14,164
3773,66,17,66,17,166
3774,68,31,67,17,183
3778,66,32,68,16,182
3780,67,34,68,16,185
3782,66,34,65,18,183
3783,83,34,66,15,198
3784,68,34,66,15,183
3786,68,31,68,16,183
3788,65,35,66,16,182
3789,67,17,66,16,166
3790,66,33,67,17,183
3792,68,33,68,15,184
3793,83,34,66,16,199
3794,66,34,66,16,182
3795,85,34,81,17,217
3796,67,34,81,17,199
3798,68,32,66,17,183
3799,52,32,66,17,167
3800,66,33,66,17,182
3801,65,17,66,17,165
3802,81,17,68,16,182
3803,66,17,68,16,167
3804,66,33,68,18,185
3805,50,33,68,18,169
3806,66,35,66,16,183
3807,67,18,66,16,167
3808,68,33,67,17,185
3809,67,17,67,17,168
3810,68,33,66,18,185
3812,51,15,66,18,150
3813,66,18,67,16,167
3814,67,32,68,16,183
3815,81,35,66,17,199
3816,66,35,66,17,184
3817,85,33,65,18,201
3821,66,17,67,18,168
3822,66,32,68,17,183
3823,67,15,68,17,167
3825,67,17,65,18,167
3827,68,15,67,17,167
3828,68,32,67,18,185
3830,65,35,66,17,183
3832,67,32,51,18,168
3833,67,15,51,18,151
3834,67,34,68,15,184
3836,66,35,65,17,183
3837,66,18,65,17,166
3838,51,18,65,17,151
3839,67,17,66,17,167
3841,66,17,68,16,167
3843,66,17,66,17,166
3844,66,34,66,16,182
3846,68,32,67,17,184
3847,67,16,67,17,167
3849,66,17,66,18,167
3853,67,16,68,16,167
3854,66,33,66,19,184
3855,68,15,66,19,168
3856,66,35,65,18,184
3857,68,16,65,18,167
3859,66,15,67,17,165
3860,66,34,67,16,183
3861,66,15,67,16,164
3865,65,17,52,17,151
3867,65,17,66,18,166
3868,67,36,65,16,184
3869,69,17,65,16,167
3870,52,17,65,16,150
3871,67,16,68,15,166
3873,82,33,67,18,200
3875,67,17,67,18,169
3876,68,34,65,18,185
3877,65,19,65,18,167
3879,67,17,66,16,166
3880,67,32,68,18,185
3881,70,14,68,18,170
3882,65,34,69,14,182
3884,66,34,67,17,184
3885,64,18,67,17,166
3887,68,17,64,18,167
3888,69,32,66,17,184
3889,67,18,66,17,168
3890,67,32,51,16,166
3891,81,34,67,16,198
3892,64,34,67,16,181
3894,66,33,68,16,183
3895,66,16,68,16,166
3897,67,16,66,17,166
3898,67,34,68,13,182
3899,66,18,68,13,165
3900,68,32,66,18,184
3901,66,16,66,18,166
3902,66,36,64,17,183
3903,67,19,64,17,167
3904,68,30,69,16,183
3905,65,17,69,16,167
3907,67,16,66,17,166
3911,67,15,67,17,166
3912,66,35,65,18,184
3913,66,18,65,18,167
3914,66,32,68,15,181
3915,65,17,68,15,165
3916,67,33,67,16,183
3918,65,35,66,16,182
3919,68,17,66,16,167
3921,66,17,66,17,166
3924,66,32,67,17,182
3925,67,16,67,17,167
3927,67,17,66,18,168
3928,66,33,68,18,185
3929,67,16,68,18,169
3930,67,33,53,17,170
3931,67,16,53,17,153
3932,66,35,82,19,202
3933,67,17,82,19,185
3934,68,35,66,14,183
3935,69,17,66,14,166
3936,53,17,66,14,150
3937,65,17,68,16,166
3939,83,32,68,16,199
3940,66,32,68,16,182
3941,67,18,68,16,169
3942,68,33,68,15,184
3943,67,17,68,15,167
3945,68,18,64,19,169
3946,68,33,64,17,182
3947,68,17,64,17,166
3949,66,16,69,16,167
3950,64,33,52,17,166
3951,67,14,52,17,150
3952,64,36,83,17,200
3953,66,19,83,17,185
3955,66,17,67,16,166
3956,52,17,67,16,152
3957,67,18,68,18,171
3959,67,17,65,17,166
3961,68,18,64,17,167
3962,68,31,67,18,184
3963,82,33,67,16,198
3964,65,33,67,16,181
3965,82,34,66,19,201
3966,64,34,66,19,183
3967,63,17,66,19,165
3969,68,15,68,16,167
3972,66,35,66,17,184
3974,68,31,68,16,183
3976,66,35,67,15,183
3977,64,18,67,15,164
3978,66,33,66,17,182
3979,67,16,66,17,166
3980,68,34,67,17,186
3981,67,18,67,17,169
3982,67,32,68,16,183
3984,66,35,68,15,184
3986,67,33,65,18,183
3987,69,16,65,18,168
3990,68,30,69,16,183
3991,66,15,69,16,166
3994,64,35,67,15,181
3995,84,32,67,16,199
3997,67,16,67,16,166
3999,66,19,65,17,167
4000,67,32,66,18,183
4001,51,32,66,18,167
4002,67,33,51,16,167
4003,67,17,51,16,151
4004,65,33,67,18,183
4005,67,16,67,18,168
4006,66,34,66,16,182
4008,51,16,66,16,149
4009,67,16,67,17,167
4010,67,33,51,16,167
4011,67,15,51,16,149
4013,65,18,68,19,170
4015,66,16,67,16,165
4020,67,35,66,17,185
4021,85,32,67,17,201
4022,67,32,67,17,183
4024,67,34,65,18,184
4026,66,33,66,15,180
4027,69,16,66,15,166
4029,67,15,68,15,165
4031,82,34,65,17,198
4032,66,34,65,17,182
4033,64,19,65,17,165
4035,65,20,63,17,165
4036,69,30,67,16,182
4038,65,33,68,17,183
4040,63,34,69,16,182
4041,66,17,69,16,168
4042,67,34,51,17,169
4043,66,18,51,17,152
4045,68,18,82,15,183
4046,69,33,64,19,185
4047,69,17,64,19,169
4048,51,17,64,19,151
4049,65,19,65,17,166
4050,82,15,68,18,183
4051,81,34,52,14,181
4052,64,34,52,14,164
4053,69,15,52,14,150
4054,65,34,84,17,200
4055,66,17,84,17,184
4056,68,32,69,15,184
4058,52,14,69,15,150
4060,84,17,66,17,184
4061,83,32,67,15,197
4062,69,32,67,15,183
4063,52,32,67,15,166
4064,66,34,67,16,183
4065,66,17,67,16,166
4066,66,33,67,17,183
4068,67,34,67,16,184
4071,66,17,66,17,166
4072,67,34,65,20,186
4076,66,33,66,17,182
4077,82,35,66,16,199
4079,69,15,66,16,166
4081,68,14,68,17,167
4083,81,33,67,17,198
4085,65,17,67,17,166
4086,51,17,67,17,152
4087,68,17,67,15,167
4089,67,17,67,17,168
4093,66,18,67,16,167
4095,67,15,68,16,166
4096,65,35,66,16,182
4097,66,19,66,16,167
4099,83,33,66,18,200
4100,68,33,66,18,185
4101,68,17,66,18,169
4103,66,18,50,15,149
4104,67,32,68,17,184
4105,67,16,68,17,168
4106,66,33,68,17,184
4107,68,15,68,17,168
4108,50,15,68,17,150
4109,67,17,66,16,166
4110,68,33,67,15,183
4111,67,16,67,15,165
4112,68,33,65,17,183
4113,67,16,65,17,165
4115,65,18,83,17,183
4116,67,31,69,15,182
4117,65,16,69,15,165
4118,65,34,66,19,184
4120,65,35,66,16,182
4122,69,31,66,18,184
4123,67,16,66,18,167
4124,66,35,67,16,184
4126,66,31,52,15,164
4127,67,15,52,15,149
4128,66,36,66,17,185
4129,83,31,69,16,199
4130,67,31,69,16,183
4131,67,15,69,16,167
4132,52,15,69,16,152
4133,67,17,67,18,169
4134,66,34,66,17,183
4135,67,17,66,17,167
4136,69,33,66,17,185
4137,67,17,66,17,167
4138,67,33,65,18,183
4141,67,16,67,17,167
4143,65,15,52,17,149
4145,66,17,66,16,165
4147,67,17,67,17,168
4148,52,17,67,17,153
4149,66,17,66,18,167
4150,66,35,66,17,184
4151,84,31,68,17,200
4154,66,35,67,16,184
4155,68,17,67,16,168
4157,66,16,67,17,166
4159,67,17,66,17,167
4160,67,33,66,18,184
4162,67,33,65,17,182
4163,83,33,66,18,200
4164,66,33,66,18,183
4165,67,16,66,18,167
4166,66,32,67,19,184
4167,67,14,67,19,167
4168,65,34,67,16,182
4169,65,17,67,16,165
4170,66,33,68,17,184
4171,66,15,68,17,166
4174,67,34,51,15,167
4175,65,18,51,15,149
4177,66,17,67,16,166
4179,69,15,68,15,167
4180,51,15,68,15,149
4181,67,17,65,17,166
4183,66,17,65,17,165
4184,68,32,66,18,184
4185,82,33,68,15,198
4187,66,16,68,15,165
4190,66,35,66,16,183
4191,67,17,66,16,166
4192,68,33,66,16,183
4194,68,33,67,16,184
4195,66,17,67,16,166
4196,66,33,67,17,183
4197,67,17,67,17,168
4199,66,18,67,17,168
4200,67,33,68,15,183
4203,68,17,67,16,168
4204,67,34,66,17,184
4205,68,17,66,17,168
4206,68,33,67,16,184
4208,67,33,67,17,184
4209,66,17,67,17,167
4210,66,34,65,18,183
4211,68,17,65,18,168
4213,67,17,66,16,166
4214,67,32,67,17,183
4215,82,34,66,18,200
4217,83,33,66,17,199
4218,66,33,66,17,182
4219,65,17,66,17,165
4221,66,16,66,17,165
4222,66,33,70,14,183
4223,68,15,70,14,167
4225,66,16,51,16,149
4226,66,37,80,18,201
4227,65,20,80,18,183
4228,70,30,68,17,185
4229,67,16,68,17,168
4230,51,16,68,17,152
4231,69,16,65,18,168
4232,80,18,67,15,180
4236,65,35,65,17,182
4237,85,33,66,18,202
4239,83,32,67,16,198
4240,68,32,67,16,183
4243,67,17,68,14,166
4244,66,33,67,17,183
4245,68,15,67,17,167
4246,67,35,66,17,185
4247,66,19,66,17,168
4249,82,34,65,18,199
4250,67,34,65,18,184
4251,68,17,65,18,168
4252,66,32,68,15,181
4253,69,15,68,15,167
4254,66,33,68,17,184
4255,67,15,68,17,167
4256,65,35,65,17,182
4257,83,33,67,15,198
4259,83,32,69,17,201
4260,68,32,69,17,186
4262,65,35,66,18,184
4265,65,19,64,19,167
4267,69,15,67,17,168
4268,66,32,69,15,182
4269,69,14,69,15,167
4270,64,35,69,14,182
4271,82,34,66,17,199
4272,67,34,66,17,184
4274,52,17,66,17,152
4276,69,31,66,17,183
4278,66,32,51,16,165
4280,80,17,68,16,181
4281,66,17,68,16,167
4283,66,16,68,15,165
4284,51,16,68,15,150
4286,68,33,65,17,183
4287,67,17,65,17,166
4288,68,33,67,16,184
4289,64,18,67,16,165
4290,66,32,69,16,183
4293,67,18,67,17,169
4295,67,18,66,16,167
4296,69,33,65,17,184
4297,68,17,65,17,167
4298,67,33,67,14,181
4300,66,32,68,15,181
4301,82,35,65,18,200
4303,83,33,67,17,200
4308,65,35,66,16,182
4309,69,17,66,16,168
4311,69,15,68,15,167
4312,52,15,68,15,150
4315,83,32,67,18,200
4316,68,32,67,18,185
4317,66,17,67,18,168
4318,66,35,66,17,184
4320,67,32,68,16,183
4321,67,17,68,16,168
4323,69,16,65,17,167
4324,66,34,67,15,182
4326,68,31,67,15,181
4327,66,15,67,15,163
4328,65,36,81,17,199
4329,84,31,67,16,198
4331,66,16,67,16,165
4332,67,34,68,16,185
4336,67,35,65,17,184
4337,68,19,65,17,169
4338,68,33,66,18,185
4339,68,17,66,18,169
4340,68,32,69,14,183
4342,65,34,67,17,183
4343,66,17,67,17,167
4345,69,17,64,17,167
4347,66,18,66,16,166
4348,67,32,66,19,184
4349,81,34,67,16,198
4350,64,34,67,16,181
4351,84,32,51,17,184
4354,66,35,67,17,185
4357,67,17,68,15,167
4358,51,17,68,15,151
4360,67,34,82,17,200
4361,68,17,82,17,184
4362,68,32,67,17,184
4363,66,17,67,17,167
4364,84,16,66,18,184
4365,67,16,66,18,167
4366,82,17,67,17,183
4367,67,17,67,17,168
4368,67,33,69,14,183
4370,66,34,68,14,182
4371,68,16,68,14,166
4374,69,33,65,16,183
4376,68,32,65,17,182
4379,68,16,68,15,167
4380,65,32,68,16,181
4381,67,16,68,16,167
4382,65,36,66,17,184
4383,84,32,65,17,198
4385,67,17,65,17,166
4386,68,34,66,16,184
4387,67,18,66,16,167
4389,68,14,68,17,167
4390,65,35,50,15,165
4391,84,33,68,16,201
4392,66,33,68,16,183
4394,68,32,68,17,185
4397,68,17,66,16,167
4398,68,32,50,17,167
4400,68,34,82,19,203
4401,66,17,82,19,184
4404,50,17,68,14,149
4405,66,16,67,19,168
4406,82,19,64,18,183
4407,66,19,64,18,167
4408,68,31,69,15,183
4411,69,14,67,19,169
4412,64,36,64,19,183
4413,68,18,64,19,169
4414,69,31,68,16,184
4415,65,16,68,16,165
4417,82,35,65,18,200
4419,68,16,65,18,167
4420,68,32,68,17,185
4421,65,16,68,17,166
4422,67,33,67,18,185
4424,65,35,65,18,183
4425,84,32,51,16,183
4427,67,15,51,16,149
4428,67,33,68,16,184
4429,67,15,68,16,166
4430,65,34,67,16,182
4431,66,16,67,16,165
4432,67,34,66,17,184
4434,68,33,66,16,183
4435,66,17,66,16,165
4437,65,17,65,19,166
4438,66,33,51,18,168
4439,83,32,68,17,200
4442,65,37,65,16,183
4443,67,18,65,16,166
4444,51,18,65,16,150
4445,67,17,67,17,168
4446,68,34,65,20,187
4448,65,33,68,15,181
4449,84,32,68,17,201
4450,67,32,68,17,184
4451,67,15,68,17,167
4452,65,36,67,15,183
4453,69,16,67,15,167
4454,68,32,69,16,185
4455,66,17,69,16,168
4457,65,18,67,16,166
4458,67,34,64,18,183
4460,69,33,66,17,185
4461,52,33,66,17,168
4465,66,17,64,19,166
4467,67,17,65,17,166
4468,69,30,68,17,184
4469,71,10,68,17,166
4470,64,35,67,16,182
4471,66,16,67,16,165
4472,65,33,69,15,182
4473,62,16,69,15,162
4474,68,34,68,15,185
4475,66,17,68,15,166
4477,66,19,65,16,166
4480,68,32,67,17,184
4481,67,17,67,17,168
4482,65,32,68,16,181
4483,82,35,66,16,199
4484,64,35,66,16,181
4485,67,17,66,16,166
4486,67,33,66,17,183
4487,68,16,66,17,167
4488,68,33,69,15,185
4489,66,17,69,15,167
4490,66,33,66,17,182
4491,65,17,66,17,165
4492,66,36,80,18,200
4493,67,19,80,18,184
4495,68,15,68,16,167
4497,66,17,66,17,166
4498,80,18,68,15,181
4499,83,32,68,16,199
4500,68,32,68,16,184
4501,67,16,68,16,167
4502,66,36,84,14,200
4503,67,19,84,14,184
4504,68,32,66,17,183
4505,67,17,66,17,167
4506,68,35,64,18,185
4507,67,19,64,18,168
4508,84,14,68,17,183
4509,69,14,68,17,168
4510,66,33,67,19,185
4512,64,35,65,19,183
4513,82,32,68,17,199
4517,68,14,68,17,167
4518,65,35,67,15,182
4520,52,16,67,15,150
4521,82,34,65,18,199
4522,68,34,65,18,185
4523,83,30,53,17,183
4524,67,30,53,17,167
4525,65,15,53,17,150
4526,64,35,83,17,199
4527,66,16,83,17,182
4528,65,35,65,16,181
4530,53,17,65,16,151
4533,82,35,50,17,184
4536,69,33,82,20,204
4538,68,34,68,15,185
4540,50,17,68,15,150
4542,82,20,80,19,201
4543,65,20,80,19,184
4545,68,16,83,17,184
4546,65,33,67,15,180
4547,67,17,67,15,166
4548,80,19,66,16,181
4549,65,19,66,16,166
4550,83,17,67,18,185
4551,67,17,67,18,169
4552,67,34,67,15,183
4553,51,34,67,15,167
4554,66,33,66,16,181
4555,84,34,66,15,199
4556,67,34,66,15,182
4557,70,16,66,15,167
4559,83,34,66,18,201
4560,66,34,66,18,184
4561,64,18,66,18,166
4562,66,34,65,17,182
4565,68,16,68,15,167
4566,66,33,67,19,185
4567,69,15,67,19,170
4568,65,35,67,16,183
4569,66,18,67,16,167
4571,65,17,66,19,167
4572,67,35,66,16,184
4573,69,16,66,16,167
4574,51,16,66,16,149
4575,68,15,68,16,167
4576,66,35,65,21,187
4577,66,16,65,21,168
4578,66,33,53,14,166
4581,81,35,68,15,199
4582,65,35,68,15,183
4583,70,14,68,15,167
4584,53,14,68,15,150
4585,68,16,66,16,166
4587,62,20,79,20,181
4588,68,31,82,19,200
4589,66,16,82,19,183
4590,66,34,67,14,181
4591,67,18,67,14,166
4593,64,20,65,16,165
4594,82,19,65,17,183
4595,66,19,65,17,167
4596,67,32,66,18,183
4597,67,18,66,18,169
4599,67,17,68,18,170
4601,68,16,67,17,168
4603,68,17,68,15,168
4605,69,14,67,19,169
4606,67,36,65,17,185
4607,66,19,65,17,167
4608,68,31,68,15,182
4609,81,34,84,16,215
4610,67,34,84,16,201
4611,69,15,84,16,184
4612,65,34,84,17,200
4613,67,17,84,17,185
4614,68,32,69,14,183
4615,64,17,69,14,164
4616,84,16,66,17,183
4621,65,17,67,18,167
4623,82,33,67,19,201
4624,65,33,67,19,184
4625,67,17,67,19,170
4628,65,35,65,20,185
4629,67,17,65,20,169
4630,67,32,67,19,185
4631,68,13,67,19,167
4632,67,33,70,14,184
4633,67,15,70,14,166
4634,65,34,67,18,184
4635,66,14,67,18,165
4636,67,36,67,13,183
4638,70,31,68,15,184
4641,66,18,80,18,182
4642,67,32,66,18,183
4644,68,34,66,18,186
4645,65,19,66,18,168
4646,80,18,67,15,180
4647,67,18,67,15,167
4648,66,34,65,17,182
4649,51,34,65,17,167
4650,66,33,66,17,182
4652,67,32,68,17,184
4653,81,34,66,16,197
4654,65,34,66,16,181
4656,66,34,66,16,182
4657,68,17,66,16,167
4658,68,32,66,18,184
4659,68,15,66,18,167
4660,66,34,67,17,184
4662,66,32,69,17,184
4663,65,16,69,17,167
4664,66,35,68,15,184
4666,67,34,66,17,184
4667,68,17,66,17,168
4668,69,34,66,17,186
4669,68,17,66,17,168
4670,68,32,66,19,185
4671,66,17,66,19,168
4673,66,17,66,18,167
4674,66,32,66,18,182
4675,68,15,66,18,167
4676,66,34,68,17,185
4677,68,15,68,17,168
4678,66,32,53,14,165
4679,67,14,53,14,148
4680,66,36,66,15,183
4682,68,31,67,18,184
4683,67,14,67,18,166
4684,53,14,67,18,152
4686,66,32,68,17,183
4687,81,33,67,17,198
4688,67,33,67,17,184
4689,82,35,67,15,199
4690,65,35,67,15,182
4691,66,19,67,15,167
4692,68,32,67,18,185
4694,67,35,67,16,185
4695,86,32,67,13,198
4696,67,32,67,13,179
4697,65,17,67,13,162
4698,67,35,82,17,201
4701,68,16,67,18,169
4702,67,33,66,18,184
4703,62,20,66,18,166
4704,82,17,67,15,181
4705,66,17,67,15,165
4708,66,35,81,18,200
4710,67,33,66,17,183
4711,64,18,66,17,165
4714,81,18,69,13,181
4716,66,32,67,17,182
4718,51,15,67,17,150
4719,69,18,66,14,167
4721,65,17,67,18,167
4723,65,19,65,16,165
4724,66,31,68,17,182
4725,67,17,68,17,169
4726,67,34,67,20,188
4727,68,16,67,20,171
4728,65,34,65,18,182
4729,67,18,65,18,168
4731,67,16,65,17,165
4732,51,16,65,17,149
4733,71,12,69,16,168
4735,66,15,70,14,165
4737,62,19,65,17,163
4741,67,17,67,15,166
4742,65,34,67,16,182
4743,66,17,67,16,166
4745,66,18,66,17,167
4750,66,34,67,17,184
4753,66,20,63,18,167
4754,70,31,67,17,185
4759,68,17,67,16,168
4760,67,32,68,16,183
4761,67,15,68,16,166
4762,52,15,68,16,151
4763,66,18,64,18,166
4766,51,17,65,18,151
4768,64,34,69,16,183
4770,65,33,69,15,182
4771,67,15,69,15,166
4772,67,36,64,18,185
4773,67,18,64,18,167
4774,69,33,68,17,187
4775,67,17,68,17,169
4776,69,31,54,15,169
4777,66,16,54,15,151
4778,64,37,66,15,182
4779,66,19,66,15,166
4780,68,32,65,19,184
4783,68,17,63,19,167
4784,66,31,68,15,180
4785,64,16,68,15,163
4787,67,13,69,18,167
4788,63,36,65,17,181
4789,67,17,65,17,166
4791,64,18,71,11,164
4792,69,32,67,18,186
4793,82,39,62,16,199
4794,65,39,62,16,182
4795,67,22,62,16,167
4796,71,28,67,16,182
4797,64,17,67,16,164
4799,68,16,67,17,168
4804,67,35,81,18,201
4805,68,18,81,18,185
4806,69,32,67,15,183
4808,67,32,69,14,182
4810,81,18,65,17,181
4811,66,18,65,17,166
4814,69,31,67,17,184
4815,52,31,67,17,167
4816,65,34,67,17,183
4818,65,33,68,17,183
4820,67,34,66,16,183
4821,67,17,66,16,166
4823,68,17,65,18,168
4825,68,15,67,17,167
4826,66,33,66,18,183
4827,82,34,66,18,200
4828,65,34,66,18,183
4829,66,16,66,18,166
4831,68,15,67,18,168
4833,66,16,68,17,167
4834,66,33,67,16,182
4835,67,15,67,16,165
4836,67,35,65,17,184
4837,67,17,65,17,166
4838,68,32,67,18,185
4840,67,33,67,17,184
4841,65,17,67,17,166
4842,65,34,67,17,183
4845,69,15,67,16,167
4847,67,17,65,19,168
4849,66,16,51,16,149
4850,51,16,51,16,134
4853,67,16,67,17,167
4855,67,18,65,19,169
4856,69,33,66,16,184
4857,65,18,66,16,165
4859,68,15,67,16,166
4861,69,15,67,15,166
4862,66,33,68,17,184
4864,67,34,51,15,167
4867,66,19,67,16,168
4868,68,32,66,18,184
4870,66,35,68,15,184
4871,69,17,68,15,169
4872,67,31,67,18,183
4873,66,15,67,18,166
4874,66,37,65,17,185
4877,52,30,69,16,167
4881,84,33,65,17,199
4882,69,33,65,17,184
4883,67,17,65,17,166
4884,67,31,68,17,183
4885,65,16,68,17,166
4887,66,16,51,16,149
4888,65,34,67,16,182
4889,67,17,67,16,167
4890,68,33,67,18,186
4892,51,16,67,18,152
4893,67,17,67,15,166
4894,67,33,66,17,183
4895,66,17,66,17,166
4896,67,34,66,18,185
4898,67,32,69,15,183
4899,66,17,69,15,167
4900,66,34,66,17,183
4902,66,35,65,16,182
4903,69,17,65,16,167
4904,69,31,66,18,184
4906,66,34,50,18,168
4907,82,32,68,17,199
4909,66,16,68,17,167
4911,67,18,64,19,168
4912,50,18,64,19,151
4913,67,17,66,17,167
4914,68,32,68,16,184
4915,67,15,68,16,166
4917,83,34,68,14,199
4918,66,34,68,14,182
4919,66,17,68,14,165
4920,68,33,68,16,185
4921,65,17,68,16,166
4922,67,35,66,16,184
4923,85,33,66,15,199
4924,68,33,66,15,182
4925,66,19,66,15,166
4927,68,17,65,17,167
4930,66,32,68,15,181
4931,65,17,68,15,165
4932,65,35,65,16,181
4933,66,18,65,16,165
4934,67,33,66,16,182
4935,85,32,69,16,202
4937,66,17,69,16,168
4939,66,18,51,15,150
4940,66,35,66,16,183
4942,69,31,68,18,186
4943,69,15,68,18,170
4945,67,18,65,18,168
4946,66,33,66,18,183
4949,69,14,52,15,150
4951,67,16,68,16,167
4952,66,33,66,20,185
4954,52,15,66,20,153
4955,66,18,65,18,167
4956,68,31,68,17,184
4957,81,34,68,15,198
4958,66,34,68,15,183
4960,65,34,66,19,184
4962,68,34,65,17,184
4964,68,32,67,16,183
4965,65,17,67,16,165
4966,66,33,68,16,183
4967,68,14,68,16,166
4968,65,34,69,13,181
4969,67,17,69,13,166
4970,67,34,65,17,183
4972,68,35,82,17,202
4973,67,19,82,17,185
4974,69,30,69,17,185
4976,65,35,51,15,166
4977,84,34,82,17,217
4978,65,34,82,17,198
4980,69,32,82,18,201
4981,69,15,82,18,184
4982,51,15,82,18,166
4985,65,17,67,17,166
4987,65,18,68,16,167
4988,65,34,66,16,181
4989,67,17,66,16,166
4992,68,32,68,16,184
4996,83,17,65,18,183
4997,67,17,65,18,167
4998,68,32,68,15,183
4999,52,32,68,15,167
5000,67,33,67,17,184
5001,82,35,65,16,198
5002,65,35,65,16,181
5004,51,17,65,16,149
5006,67,33,66,19,185
5007,66,16,66,19,167
5010,68,31,69,15,183
5011,66,16,69,15,166
5013,69,15,68,17,169
5014,65,35,50,15,165
5018,68,32,51,17,168
5019,69,15,51,17,152
5020,50,15,51,17,133
5021,67,18,65,17,167
5022,67,33,66,17,183
5024,51,17,66,17,151
5025,66,17,51,16,150
5026,65,34,65,18,182
5027,66,17,65,18,166
5029,68,16,68,16,168
5032,65,36,83,15,199
5034,68,32,66,17,183
5035,66,16,66,17,165
5036,68,33,66,18,185
5038,83,15,70,15,183
5039,67,15,70,15,167
5040,51,15,70,15,151
5041,67,16,52,17,152
5042,66,37,63,19,185
5043,85,32,67,16,200
5044,70,32,67,16,185
5045,68,17,67,16,168
5048,63,36,64,17,180
5049,67,17,64,17,165
5050,67,31,67,16,181
5053,66,15,69,15,165
5054,64,34,67,17,182
5055,82,35,66,17,200
5056,67,35,66,17,185
5060,67,34,66,19,186
5061,68,17,66,19,170
5062,66,32,68,18,184
5064,66,34,68,15,183
5065,66,17,68,15,166
5066,66,34,67,17,184
5067,68,15,67,17,167
5068,68,34,67,15,184
5070,68,33,65,18,184
5073,66,17,65,16,164
5076,65,34,67,18,184
5077,66,16,67,18,167
5078,65,34,66,17,182
5079,66,18,66,17,167
5082,67,33,68,16,184
5083,69,15,68,16,168
5084,66,34,65,19,184
5085,66,17,65,19,167
5086,67,34,65,18,184
5087,65,18,65,18,166
5088,68,31,69,15,183
5095,65,18,67,15,165
5096,68,33,67,17,185
5098,66,34,65,18,183
5099,66,19,65,18,168
5102,67,32,68,15,182
5103,69,15,68,15,167
5104,65,35,66,16,182
5105,68,17,66,16,167
5108,68,33,66,18,185
5109,65,18,66,18,167
5110,66,34,67,17,184
5112,67,32,52,15,166
5114,66,35,65,17,183
5115,68,17,65,17,167
5116,67,32,65,18,182
5119,65,17,68,16,166
5120,65,32,68,17,182
5121,80,36,65,19,200
5122,65,36,65,19,185
5123,67,18,65,19,169
5124,50,18,65,19,152
5125,67,16,66,17,166
5126,68,33,68,16,185
5127,67,16,68,16,167
5128,65,33,51,16,165
5129,82,35,82,19,218
5131,84,32,86,16,218
5132,68,32,86,16,202
5137,66,19,65,17,167
5138,86,16,65,16,183
5139,69,16,65,16,166
5140,69,32,68,15,184
5141,68,16,68,15,167
5144,65,35,65,19,184
5145,65,19,65,19,168
5146,68,32,66,16,182
5148,67,33,67,17,184
5149,69,15,67,17,168
5150,65,33,66,19,183
5151,69,14,66,19,168
5152,66,34,66,17,183
5153,82,32,67,18,199
5154,67,32,67,18,184
5157,69,15,70,14,168
5158,66,33,68,15,182
5159,66,16,68,15,165
5160,67,37,64,17,185
5161,85,31,66,18,200
5162,70,31,66,18,185
5163,67,17,66,18,168
5164,68,33,67,15,183
5165,65,18,67,15,165
5167,67,16,67,15,165
5168,66,34,67,15,182
5169,69,16,67,15,167
5172,67,34,66,18,185
5176,67,33,67,16,183
5177,69,16,67,16,168
5178,66,32,69,14,181
5179,69,14,69,14,166
5181,67,16,65,17,165
5182,67,34,65,19,185
5183,65,18,65,19,167
5184,69,31,67,17,184
5185,64,17,67,17,165
5187,66,17,67,16,166
5188,65,33,70,14,182
5190,67,34,68,16,185
5191,67,17,68,16,168
5192,67,36,65,17,185
5193,64,20,65,17,166
5196,68,33,68,16,185
5197,68,17,68,16,169
5198,65,33,51,17,166
5199,68,16,51,17,152
5201,65,20,66,17,168
5202,68,33,66,16,183
5203,67,17,66,16,166
5205,66,20,66,15,167
5206,66,33,65,18,182
5207,67,16,65,18,166
5208,66,33,66,15,180
5209,69,17,66,15,167
5210,66,32,68,15,181
5211,64,17,68,15,164
5212,65,34,67,17,183
5215,66,19,65,16,166
5218,67,32,71,14,184
5219,69,15,71,14,169
5220,65,33,67,17,182
5221,66,17,67,17,167
5222,65,38,82,14,199
5223,86,29,53,14,182
5224,71,29,53,14,167
5225,55,29,53,14,151
5227,66,18,66,15,165
5230,53,14,68,16,151
5232,66,34,67,16,183
5233,63,19,67,16,165
5237,69,17,65,17,168
5239,67,18,65,18,168
5240,69,31,66,17,183
5241,67,15,66,17,165
5242,65,34,66,17,182
5244,65,32,69,16,182
5245,67,14,69,16,166
5246,66,34,68,16,184
5247,66,17,68,16,167
5248,66,35,66,19,186
5249,65,18,66,19,168
5251,68,17,65,18,168
5252,68,33,65,18,184
5253,67,17,65,18,167
5254,66,32,68,17,183
5256,65,33,52,18,168
5257,67,15,52,18,152
5258,65,35,67,16,183
5259,64,17,67,16,164
5260,68,35,64,17,184
5261,67,18,64,17,166
5262,52,18,64,17,151
5263,67,17,66,18,168
5266,64,34,82,18,198
5267,83,33,67,16,199
5268,66,33,67,16,182
5269,68,15,67,16,166
5271,66,18,66,17,167
5272,82,18,67,17,184
5273,64,18,67,17,166
5274,67,33,68,16,184
5275,67,17,68,16,168
5279,68,17,66,16,167
5280,68,33,68,16,185
5281,67,17,68,16,168
5285,66,19,82,15,182
5286,68,33,81,18,200
5287,68,17,81,18,184
5288,68,33,82,16,199
5289,68,17,82,16,183
5291,66,15,67,17,165
5292,81,18,66,17,182
5293,65,18,66,17,166
5295,66,16,67,17,166
5297,67,17,66,19,169
5298,66,33,52,15,166
5299,67,16,52,15,150
5302,66,34,67,17,184
5303,68,15,67,17,167
5304,52,15,67,17,151
5305,67,15,68,16,166
5306,83,18,66,18,185
5307,82,33,68,16,199
5308,67,33,68,16,184
5314,68,32,66,18,184
5315,68,16,66,18,168
5316,67,32,69,15,183
5317,65,16,69,15,165
5318,64,34,67,16,181
5319,65,17,67,16,165
5321,68,17,66,16,167
5322,69,32,68,15,184
5323,52,32,68,15,167
5324,67,34,66,18,185
5325,65,18,66,18,167
5327,67,18,66,16,167
5329,67,17,66,18,168
5331,68,16,66,16,166
5332,66,32,67,17,182
5333,67,16,67,17,167
5334,66,34,68,16,184
5338,67,35,65,19,186
5339,84,31,53,16,184
5340,68,31,53,16,168
5342,66,34,85,16,201
5343,67,16,85,16,184
5345,68,16,66,16,166
5346,53,16,66,16,151
5347,67,18,66,15,166
5349,66,16,66,17,165
5350,66,34,65,16,181
5351,66,18,65,16,165
5353,65,17,68,17,167
5354,66,33,68,15,182
5355,67,16,68,15,166
5356,65,35,66,15,181
5357,66,19,66,15,166
5358,68,33,67,16,184
5359,68,16,67,16,167
5360,68,33,65,18,184
5361,67,18,65,18,168
5362,66,34,66,16,182
5363,83,31,68,17,199
5365,68,15,68,17,168
5367,68,17,65,19,169
5368,66,33,66,17,182
5369,66,17,66,17,166
5370,68,32,68,17,185
5371,67,15,68,17,167
5373,83,34,67,16,200
5374,66,34,67,16,183
5375,83,33,67,15,198
5376,68,33,67,15,183
5378,51,16,67,15,149
5380,67,33,50,17,167
5381,66,17,50,17,150
5383,65,17,68,16,166
5384,65,35,67,14,181
5385,67,17,67,14,165
5387,52,33,66,17,168
5388,68,34,65,18,185
5390,67,32,68,15,182
5391,65,18,68,15,166
5394,65,35,67,17,184
5395,69,17,67,17,170
5397,66,18,66,17,167
5399,65,19,64,17,165
5401,69,15,66,17,167
5403,68,15,69,15,167
5406,66,35,65,19,185
5407,84,32,67,18,201
5408,69,32,67,18,186
5409,67,17,67,18,169
5412,65,34,68,16,183
5413,69,15,68,16,168
5414,67,34,67,15,183
5415,69,16,67,15,167
5416,68,34,65,16,183
5417,64,19,65,16,164
5418,68,33,65,18,184
5421,67,17,51,16,151
5422,65,33,67,18,183
5423,65,17,67,18,167
5424,65,34,68,16,183
5427,68,16,66,18,168
5428,67,35,65,16,183
5429,67,17,65,16,165
5432,66,34,67,17,184
5433,66,16,67,17,166
5434,65,34,66,18,183
5435,65,18,66,18,167
5437,66,17,66,17,166
5438,67,33,68,17,185
5439,68,16,68,17,169
5440,66,33,52,16,167
5441,68,15,52,16,151
5443,66,18,66,16,166
5444,68,33,67,16,184
5446,52,16,67,16,151
5447,68,16,67,16,167
5448,66,34,65,17,182
5449,65,18,65,17,165
5450,67,33,67,16,183
5451,83,32,69,15,199
5452,67,32,69,15,183
5453,67,16,69,15,167
5454,65,35,68,14,182
5455,66,18,68,14,166
5456,67,34,65,16,182
5457,67,18,65,16,166
5458,69,34,66,14,183
5459,67,19,66,14,166
5460,68,31,66,18,183
5461,66,17,66,18,167
5462,65,35,63,18,181
5463,66,19,63,18,166
5464,66,31,67,17,181
5465,66,17,67,17,167
5466,66,32,52,16,166
5468,63,35,69,16,183
5469,67,17,69,16,169
5470,67,33,67,16,183
5471,66,16,67,16,165
5472,52,16,67,16,151
5475,68,15,66,18,167
5476,67,35,66,17,185
5477,65,19,66,17,167
5478,66,31,52,15,164
5479,66,15,52,15,148
5480,66,35,66,17,184
5482,66,32,68,17,183
5483,67,15,68,17,167
5484,52,15,68,17,152
5485,67,16,51,15,149
5487,66,17,67,17,167
5489,67,15,52,15,149
5490,51,15,52,15,133
5491,67,17,67,17,168
5492,67,32,66,18,183
5493,50,32,66,18,166
5494,52,15,66,18,151
5495,70,14,65,18,167
5497,67,14,67,17,165
5498,52,14,67,17,150
5500,65,33,52,15,165
5502,67,34,67,16,184
5503,66,17,67,16,166
5504,67,33,68,16,184
5505,67,15,68,16,166
5506,52,15,68,16,151
5507,67,17,66,18,168
5508,67,34,66,17,184
5511,67,16,51,14,148
5512,66,34,83,17,200
5513,68,16,83,17,184
5514,66,31,69,18,184
5518,83,17,65,18,183
5519,83,33,67,18,201
5520,69,33,67,18,187
5522,68,32,53,14,167
5523,66,16,53,14,149
5524,65,35,66,18,184
5526,67,32,67,17,183
5531,81,35,65,16,197
5533,67,18,65,16,166
5534,68,33,66,17,184
5535,66,17,66,17,166
5536,51,17,66,17,151
5537,66,17,68,17,168
5538,65,34,66,17,182
5539,83,34,65,18,200
5540,66,34,65,18,183
5541,68,17,65,18,168
5543,69,15,51,16,151
5544,66,33,67,17,183
5547,66,16,70,12,164
5548,51,16,70,12,149
5551,86,29,52,16,183
5553,65,17,52,16,150
5555,67,17,84,17,185
5556,64,33,84,15,196
5557,69,16,84,15,184
5558,52,16,84,15,167
5559,67,16,66,20,169
5560,84,17,66,17,184
5561,67,17,66,17,167
5562,84,15,68,18,185
5563,67,15,68,18,168
5564,66,35,65,18,184
5567,67,16,66,18,167
5568,68,32,67,18,185
5570,65,34,68,17,184
5572,66,33,52,16,167
5573,81,35,65,16,197
5575,84,33,67,14,198
5576,68,33,67,14,182
5579,50,32,68,15,165
5580,65,35,67,14,181
5581,64,19,67,14,164
5582,67,33,66,18,184
5583,63,19,66,18,166
5584,68,34,64,18,184
5592,66,35,67,15,183
5594,69,33,65,19,186
5595,66,18,65,19,168
5596,68,34,67,15,184
5598,67,31,67,16,181
5599,67,16,67,16,166
5600,65,36,81,18,200
5601,69,17,81,18,185
5602,67,31,68,17,183
5603,67,16,68,17,168
5604,67,34,68,15,184
5605,64,18,68,15,165
5609,69,17,65,16,167
5610,68,32,67,19,186
5611,67,17,67,19,170
5613,66,16,53,15,150
5614,65,34,66,17,182
5615,66,18,66,17,167
5616,67,34,65,17,183
5617,69,15,65,17,166
5618,53,15,65,17,150
5619,66,18,66,17,167
5620,66,33,69,15,183
5621,80,33,66,18,197
5622,65,33,66,18,182
5623,68,16,66,18,168
5625,66,19,66,16,167
5626,69,30,52,17,168
5627,67,15,52,17,151
5628,66,36,83,15,200
5629,85,33,83,15,216
5630,66,33,83,15,197
5631,67,17,83,15,182
5632,52,17,83,15,167
5633,66,17,66,19,168
5634,83,15,67,17,182
5635,67,15,67,17,166
5637,68,15,67,20,170
5638,66,34,66,18,184
5639,67,15,66,18,166
5640,52,15,66,18,151
5641,66,16,68,16,166
5642,67,33,70,16,186
5643,68,13,70,16,167
5644,66,35,65,19,185
5645,67,17,65,19,168
5646,68,35,65,15,183
5647,64,19,65,15,163
5648,70,30,69,14,183
5650,51,14,69,14,148
5651,68,16,67,15,166
5652,65,34,67,15,181
5653,83,33,84,14,214
5654,69,33,84,14,200
5655,64,19,84,14,181
5656,67,34,64,20,185
5659,68,18,68,16,170
5661,69,14,53,15,151
5663,69,17,80,19,185
5664,68,31,81,19,199
5666,53,15,81,19,168
5667,83,33,66,17,199
5668,80,19,66,17,182
5669,64,19,66,17,166
5671,65,19,66,16,166
5673,69,16,66,17,168
5674,66,32,70,15,183
5675,70,15,70,15,170
5677,82,36,81,15,214
5678,66,36,81,15,198
5679,66,19,81,15,181
5680,70,31,65,18,184
5682,67,34,66,16,183
5684,81,15,69,15,180
5686,65,35,66,18,184
5687,67,17,66,18,168
5689,66,18,66,18,168
5690,69,32,68,15,184
5691,66,17,68,15,166
5692,66,34,66,18,184
5693,68,16,66,18,168
5695,69,16,67,17,169
5697,82,35,66,17,200
5698,66,35,66,17,184
5700,67,33,68,13,181
5701,69,16,68,13,166
5702,52,16,68,13,149
5703,68,15,65,19,167
5706,68,30,68,15,181
5707,80,35,65,18,198
5708,65,35,65,18,183
5710,65,33,67,16,181
5711,68,17,67,16,168
5712,68,32,68,18,186
5715,67,17,66,18,168
5716,67,33,67,17,184
5717,68,17,67,17,169
5718,68,33,67,16,184
5721,68,16,65,18,167
5723,66,16,50,18,150
5724,51,16,50,18,135
5726,65,36,66,15,182
5727,66,18,66,15,165
5728,50,18,66,15,149
5730,69,33,66,15,183
5731,66,18,66,15,165
5733,66,18,67,17,168
5734,66,33,66,18,183
5736,66,34,50,17,167
5737,66,19,50,17,152
5739,68,15,85,16,184
5741,69,17,66,18,170
5742,67,32,66,17,182
5743,66,16,66,17,165
5744,67,34,66,18,185
5745,67,16,66,18,167
5747,68,14,68,17,167
5748,66,34,67,16,183
5749,65,17,67,16,165
5750,66,34,68,16,184
5751,66,16,68,16,166
5752,68,33,51,15,167
5753,68,16,51,15,150
5754,67,35,83,13,198
5755,65,19,83,13,180
5758,66,35,68,15,184
5759,68,17,68,15,168
5760,83,13,70,16,182
5761,67,13,70,16,166
5762,65,38,63,19,185
5763,65,20,63,19,167
5765,66,17,67,15,165
5766,70,31,67,19,187
5767,68,15,67,19,169
5769,67,17,67,15,166
5770,67,31,68,16,182
5771,66,16,68,16,166
5772,67,36,65,16,184
5773,67,17,65,16,165
5774,67,32,66,17,182
5775,67,17,66,17,167
5776,68,33,68,14,183
5777,65,17,68,14,164
5778,65,33,67,16,181
5779,66,17,67,16,166
5781,67,18,65,19,169
5782,68,32,52,17,169
5783,52,32,52,17,153
5784,67,33,68,17,185
5785,66,17,68,17,168
5786,65,36,66,14,181
5788,52,17,66,14,149
5789,53,32,65,17,167
5790,68,34,64,20,186
5791,66,17,64,20,167
5793,66,17,68,16,167
5794,65,33,67,17,182
5795,81,35,67,15,198
5796,64,35,67,15,181
5797,70,15,67,15,167
5798,68,32,66,19,185
5799,67,16,66,19,168
5803,82,35,52,15,184
5804,66,35,52,15,168
5805,84,33,84,15,216
5806,66,33,84,15,198
5807,68,16,84,15,183
5809,68,15,83,16,182
5813,65,15,69,15,164
5814,65,34,68,16,183
5815,72,16,68,16,172
5816,67,35,65,19,186
5817,65,19,65,19,168
5819,66,18,51,14,149
5820,68,32,52,15,167
5821,68,16,52,15,151
5825,68,15,68,17,168
5826,52,15,68,17,152
5827,65,18,64,19,166
5828,69,33,67,14,183
5832,64,36,67,16,183
5833,68,17,67,16,168
5834,67,34,63,19,183
5835,64,20,63,19,166
5836,70,33,64,19,186
5838,67,30,70,14,181
5840,63,34,68,16,181
5841,69,15,68,16,168
5842,64,36,66,16,182
5844,70,32,66,17,185
5847,83,32,68,16,199
5848,66,32,68,16,182
5849,68,16,68,16,168
5850,66,34,65,19,184
5852,66,34,66,16,182
5853,67,17,66,16,166
5854,68,31,51,16,166
5855,67,15,51,16,149
5856,65,35,67,16,183
5857,67,16,67,16,166
5859,66,16,68,16,166
5860,51,16,68,16,151
5862,67,33,66,16,182
5863,67,17,66,16,166
5864,68,34,66,15,183
5865,66,18,66,15,165
5866,67,32,66,18,183
5867,66,17,66,18,167
5868,66,34,67,16,183
5869,84,32,67,18,201
5870,66,32,67,18,183
5871,66,17,67,18,168
5872,66,35,68,14,183
5873,68,17,68,14,167
5874,67,32,68,15,182
5875,68,16,68,15,167
5876,67,36,64,18,185
5877,67,18,64,18,167
5880,68,32,65,18,183
5881,65,17,65,18,165
5882,64,35,65,16,180
5884,67,30,51,18,166
5885,69,13,51,18,151
5887,65,17,67,16,165
5888,65,34,67,15,181
5890,51,18,67,15,151
5892,67,34,65,17,183
5895,66,17,68,16,167
5896,66,33,69,15,183
5897,68,15,69,15,167
5898,65,35,67,15,182
5899,67,18,67,15,167
5900,68,34,67,15,184
5901,66,18,67,15,166
5902,69,33,65,17,184
5903,67,18,65,17,167
5904,67,34,67,13,181
5906,67,31,68,14,180
5908,65,36,64,17,182
5909,67,19,64,17,167
5910,67,32,65,20,184
5911,65,19,65,20,169
5915,68,16,69,16,169
5916,65,33,68,15,181
5917,71,13,68,15,167
5918,53,13,68,15,149
5919,67,18,65,17,167
5920,69,32,65,18,184
5921,65,16,65,18,164
5922,68,33,69,14,184
5923,65,18,69,14,166
5924,65,32,69,17,183
5925,66,15,69,17,167
5927,68,19,65,15,167
5928,69,32,67,16,184
5930,69,33,65,19,186
5931,68,16,65,19,168
5932,65,34,65,18,182
5934,67,31,67,18,183
5935,81,34,67,16,198
5937,69,15,67,16,167
5939,67,15,67,17,166
5941,66,16,66,17,165
5942,67,33,66,19,185
5943,65,17,66,19,167
5944,67,33,67,16,183
5945,66,16,67,16,165
5946,66,33,67,16,182
5947,83,34,68,18,203
5948,66,34,68,18,186
5949,83,33,68,15,199
5950,67,33,68,15,183
5951,66,17,68,15,166
5953,64,19,66,14,163
5954,68,33,67,16,184
5955,70,15,67,16,168
5956,68,33,66,19,186
5958,66,34,66,17,183
5960,67,32,66,18,183
5962,66,34,66,17,183
5963,71,15,66,17,169
5965,67,15,67,18,167
5966,66,34,68,17,185
5967,81,33,67,17,198
5970,51,16,67,17,151
5971,67,17,66,16,166
5972,68,32,67,17,184
5973,51,32,67,17,167
5974,67,34,67,17,185
5975,66,17,67,17,167
5977,65,17,66,16,164
5978,67,34,70,13,184
5979,67,17,70,13,167
5980,67,32,68,15,182
5981,68,15,68,15,166
5982,66,38,80,15,199
5983,87,30,65,19,201
5984,70,30,65,19,184
5988,80,15,53,16,164
5990,65,34,84,16,199
5991,69,15,84,16,184
5992,52,15,84,16,167
5995,50,32,68,14,164
5998,81,19,65,16,181
