序号,发送->接收,接收->转发,转发->接收,接收->处理,总计
2,31,35,15,15,96
3,18,35,15,15,83
4,16,19,15,15,65
5,34,15,18,15,82
7,15,33,19,14,81
8,0,33,19,14,66
9,15,33,18,16,82
11,0,14,18,16,48
12,34,34,18,15,101
13,16,34,18,15,83
14,34,33,167,17,251
16,33,34,133,17,217
17,15,34,133,17,199
20,33,35,65,17,150
21,52,31,34,17,134
22,35,31,34,17,117
23,20,31,34,17,102
24,0,31,34,17,82
25,34,16,17,16,83
26,18,16,17,16,67
27,16,33,16,17,82
30,16,17,18,16,67
31,17,34,35,15,101
33,16,35,15,19,85
35,18,34,15,15,82
36,34,30,36,16,116
39,15,36,16,16,83
40,18,18,16,16,68
41,18,32,16,17,83
42,16,16,16,17,65
43,16,33,33,17,99
44,16,17,33,17,83
45,17,33,83,18,151
46,0,33,83,18,134
47,15,34,49,18,116
48,17,17,49,18,101
49,0,17,49,18,84
50,17,17,15,18,67
52,15,18,16,17,66
53,0,18,16,17,51
55,34,16,18,15,83
56,33,33,34,17,117
57,34,15,34,17,100
58,18,15,34,17,84
59,87,28,18,17,150
61,54,28,18,17,117
64,0,28,18,17,63
66,35,31,18,16,100
67,17,31,18,16,82
68,15,16,18,16,65
70,18,16,35,15,84
71,16,35,15,18,84
73,19,33,34,16,102
74,15,18,34,16,83
75,34,18,16,16,84
76,16,18,16,16,66
77,34,16,17,16,83
78,16,16,17,16,65
80,17,16,18,15,66
81,16,33,18,17,84
83,15,35,32,17,99
86,81,18,34,17,150
87,66,18,34,17,135
89,32,18,34,17,101
90,16,18,34,17,85
91,0,18,34,17,69
92,16,18,32,17,83
94,17,15,85,16,133
95,15,33,52,16,116
97,101,15,18,17,151
100,50,15,18,17,100
101,33,15,18,17,83
102,17,15,18,17,67
103,83,32,18,17,150
106,49,16,18,17,100
107,33,16,18,17,84
108,16,16,18,17,67
109,16,35,16,16,83
110,35,32,16,18,101
111,17,32,16,18,83
112,16,16,16,18,66
115,85,32,17,17,151
117,67,16,17,17,117
118,50,16,17,17,100
119,32,16,17,17,82
120,16,16,17,17,66
121,16,34,18,16,84
123,17,34,17,16,84
127,16,34,16,17,83
128,34,33,34,16,117
129,99,16,17,16,148
130,83,16,17,16,132
131,67,16,17,16,116
132,50,16,17,16,99
133,34,16,17,16,83
135,16,33,16,17,82
136,33,33,34,16,116
137,16,33,34,16,99
138,16,17,34,16,83
140,34,32,18,16,100
141,32,16,18,16,82
142,66,33,87,13,199
143,50,33,87,13,183
144,34,33,87,13,167
146,18,15,87,13,133
151,17,32,18,16,83
152,19,13,18,16,66
153,13,34,83,17,147
154,18,16,83,17,134
156,33,34,16,17,100
157,16,34,16,17,83
158,17,17,16,17,67
159,17,33,17,17,84
161,34,17,17,16,84
162,34,33,32,20,119
163,17,33,32,20,102
164,33,32,20,15,100
165,16,32,20,15,83
166,17,15,20,15,67
167,15,35,16,18,84
169,15,34,16,16,81
170,16,18,16,16,66
171,87,32,32,17,168
172,69,32,32,17,150
173,53,32,32,17,134
175,20,32,32,17,101
176,13,19,32,17,81
177,19,32,33,17,101
181,33,15,19,15,82
182,17,15,19,15,66
183,83,33,17,17,150
185,49,33,17,17,116
186,34,33,17,17,101
189,0,17,17,17,51
190,17,17,17,15,66
191,17,32,17,18,84
192,17,15,17,18,67
193,15,35,16,21,87
194,17,18,16,21,72
196,37,28,34,17,116
198,11,17,34,17,79
199,17,34,17,16,84
201,16,33,16,18,83
203,16,34,33,16,99
204,34,33,16,18,101
205,18,33,16,18,85
206,16,17,16,18,67
207,17,34,15,18,84
208,16,18,15,18,67
209,18,33,17,17,85
210,15,18,17,17,67
211,18,34,17,15,84
212,17,17,17,15,66
214,17,15,17,17,66
216,0,34,33,17,84
220,34,32,18,15,99
221,17,32,18,15,82
223,17,33,17,18,85
224,18,15,17,18,68
225,15,35,15,17,82
226,17,18,15,17,67
228,0,32,18,15,65
229,35,15,17,17,84
231,49,33,19,15,116
232,34,33,19,15,101
234,17,16,19,15,67
235,16,34,17,15,82
237,32,15,84,18,149
239,15,34,50,18,117
241,17,33,17,18,85
242,18,15,17,18,68
243,15,35,17,18,85
245,18,35,15,17,85
246,17,18,15,17,67
247,18,32,15,17,82
249,17,32,18,16,83
251,17,34,16,18,85
254,67,33,17,18,135
255,51,33,17,18,119
256,33,33,17,18,101
257,16,33,17,18,84
258,16,17,17,18,68
260,35,31,18,15,99
263,15,33,18,16,82
264,18,15,18,16,67
265,15,34,18,15,82
267,67,16,50,16,149
269,33,16,50,16,115
270,18,16,50,16,100
271,16,33,17,16,82
272,16,17,17,16,66
274,17,16,18,15,66
277,15,35,17,15,82
278,35,32,16,17,100
280,0,32,16,17,65
281,15,33,18,16,82
282,16,17,18,16,67
283,17,34,84,15,150
284,0,34,84,15,133
285,16,33,85,15,149
289,83,34,15,17,149
290,65,34,15,17,131
293,15,34,15,17,81
294,66,35,82,19,202
295,50,35,82,19,186
296,50,17,82,19,168
297,35,17,82,19,153
298,18,17,82,19,136
299,17,32,50,19,118
301,15,34,35,16,100
302,18,16,35,16,85
303,16,35,16,17,84
306,16,17,15,17,65
309,17,34,32,17,100
310,17,17,32,17,83
311,84,32,85,16,217
312,67,32,85,16,200
313,50,32,85,16,183
314,35,32,85,16,168
315,18,32,85,16,151
318,16,17,52,16,101
319,17,35,17,16,85
320,18,17,17,16,68
321,17,33,16,18,84
322,116,17,34,15,182
324,83,17,34,15,149
325,67,17,34,15,133
326,49,17,34,15,115
327,85,32,18,15,150
328,68,32,18,15,133
329,51,32,18,15,116
331,19,32,18,15,84
333,17,33,16,17,83
334,33,33,19,16,101
335,15,33,19,16,83
337,17,35,16,17,85
339,32,17,17,16,82
343,16,34,82,16,148
344,34,34,48,16,132
345,18,34,48,16,116
346,15,19,48,16,98
347,35,17,15,16,83
348,16,17,15,16,64
350,31,35,17,17,100
351,35,16,17,17,85
354,82,17,18,15,132
355,65,17,18,15,115
358,15,17,18,15,65
360,18,15,17,17,67
362,34,33,84,17,168
365,17,34,50,17,118
366,16,18,50,17,101
367,18,35,15,17,85
369,33,17,34,16,100
372,15,19,16,16,66
373,35,16,33,17,101
374,16,16,33,17,82
375,16,33,17,16,82
376,0,33,17,16,66
377,16,33,18,16,83
378,17,16,18,16,67
381,16,33,18,16,83
382,0,33,18,16,67
385,84,40,94,15,233
386,68,40,94,15,217
390,14,26,94,15,149
393,17,35,35,15,102
394,0,35,35,15,85
397,18,33,15,17,83
398,33,32,16,17,98
401,17,33,34,16,100
402,0,33,34,16,83
403,17,34,84,17,152
404,84,18,33,16,151
405,67,18,33,16,134
406,50,18,33,16,117
407,34,18,33,16,101
409,34,17,35,13,99
410,16,17,35,13,81
412,0,35,30,16,81
413,0,19,30,16,65
415,17,33,34,18,102
416,16,17,34,18,85
417,0,17,34,18,69
418,34,32,17,17,100
419,16,32,17,17,82
420,18,14,17,17,66
421,0,14,17,17,48
422,17,17,18,15,67
424,0,33,20,13,66
425,35,13,19,15,82
427,13,34,20,17,84
429,52,31,33,16,132
430,37,31,33,16,117
431,17,31,33,16,97
433,18,33,16,16,83
434,14,19,16,16,65
435,35,16,18,18,87
437,34,18,16,14,82
438,18,18,16,14,66
439,18,30,18,20,86
442,18,20,16,15,69
444,0,31,16,18,65
445,15,34,14,18,81
446,16,18,14,18,66
447,82,34,49,19,184
448,64,34,49,19,166
450,32,34,49,19,134
451,15,34,49,19,117
453,17,34,34,15,100
456,15,19,15,16,65
457,19,31,19,16,85
460,0,35,34,16,85
461,16,34,16,16,82
462,18,16,16,16,66
463,16,32,16,18,82
464,0,32,16,18,66
467,18,32,17,16,83
468,32,33,36,16,117
469,18,33,36,16,103
470,69,46,8,16,139
471,52,46,8,16,122
472,36,46,8,16,106
473,18,46,8,16,88
474,16,30,8,16,70
475,38,16,33,18,105
476,8,16,33,18,75
477,16,33,18,16,83
478,19,14,18,16,67
479,14,34,19,15,82
480,18,16,19,15,68
482,19,15,84,16,134
483,15,35,49,16,115
484,35,32,17,16,100
485,18,32,17,16,83
486,0,32,17,16,65
488,17,16,35,13,81
490,35,31,18,17,101
492,0,31,18,17,66
493,18,35,16,17,86
494,18,17,16,17,68
495,33,17,18,14,82
497,35,14,84,19,152
499,14,36,48,19,117
500,0,36,48,19,103
502,15,17,35,14,81
503,17,35,14,16,82
504,16,19,14,16,65
506,14,16,34,17,81
508,0,34,17,17,68
509,17,34,17,16,84
511,17,33,18,14,82
514,18,14,35,16,83
515,33,16,16,17,82
516,19,16,16,17,68
517,16,33,34,18,101
518,16,17,34,18,85
519,84,35,49,15,183
523,15,35,49,15,114
524,17,18,49,15,99
525,18,33,16,15,82
526,33,31,34,16,114
527,17,31,34,16,98
528,16,15,34,16,81
529,15,34,16,18,83
531,16,34,17,16,83
532,16,18,17,16,67
533,35,16,34,16,101
534,17,16,34,16,83
536,16,18,16,17,67
538,16,17,16,18,67
539,17,34,15,17,83
541,18,32,100,19,169
542,32,34,66,19,151
544,51,18,50,16,135
545,33,18,50,16,117
546,17,18,50,16,101
548,17,49,16,15,97
552,31,36,33,15,115
553,33,18,33,15,99
554,18,18,33,15,84
555,33,18,15,17,83
556,15,18,15,17,65
558,15,17,17,16,65
559,0,17,17,16,50
560,17,16,34,18,85
563,17,33,16,17,83
565,15,33,83,17,148
566,16,17,83,17,133
567,35,17,48,17,117
568,18,17,48,17,100
569,33,16,16,17,82
570,16,16,16,17,65
571,16,33,17,17,83
574,17,17,16,16,66
575,17,32,19,15,83
576,16,16,19,15,66
577,16,34,82,18,150
578,0,34,82,18,134
579,15,35,47,18,115
581,17,33,14,18,82
582,15,18,14,18,65
583,32,18,34,16,100
584,14,18,34,16,82
587,17,33,16,17,83
588,85,14,33,18,150
589,69,14,33,18,134
590,52,14,33,18,117
591,36,14,33,18,101
594,33,34,17,17,101
595,15,34,17,17,83
596,18,16,17,17,68
597,83,33,17,16,149
598,67,33,17,16,133
599,50,33,17,16,116
600,33,33,17,16,99
601,16,33,17,16,82
603,17,33,19,16,85
604,17,16,19,16,68
605,35,16,16,16,83
606,19,16,16,16,67
607,16,32,18,16,82
608,0,32,18,16,66
609,16,34,16,16,82
610,34,32,18,16,100
612,0,32,18,16,66
613,16,34,16,19,85
614,18,16,16,19,69
615,16,35,18,30,99
616,16,19,18,30,83
619,15,33,16,18,82
620,15,18,16,18,67
622,34,33,16,17,100
624,16,17,16,17,66
626,33,33,15,17,98
627,17,33,15,17,82
628,33,32,19,19,103
630,15,17,19,19,70
631,17,38,46,18,119
632,84,18,16,16,134
633,83,32,17,16,148
636,35,32,17,16,100
638,16,16,17,16,65
639,16,33,18,17,84
640,17,16,18,17,68
641,34,17,16,17,84
642,18,17,16,17,68
643,17,33,17,15,82
645,17,32,18,17,84
646,17,15,18,17,67
647,15,35,33,17,100
649,17,33,17,14,81
650,0,33,17,14,64
653,14,35,34,17,100
655,16,34,117,17,184
656,17,17,117,17,168
658,17,16,84,17,134
660,16,16,52,17,101
661,34,17,17,17,85
662,35,34,17,14,100
666,0,31,18,15,64
667,14,33,35,18,100
668,18,15,35,18,86
669,15,35,18,15,83
672,33,35,33,16,117
674,18,17,33,16,84
676,0,33,16,15,64
677,18,31,35,15,99
678,0,31,35,15,81
679,15,35,15,17,82
680,17,18,15,17,67
684,0,34,17,18,69
686,0,35,15,17,67
687,18,32,16,18,84
688,0,32,16,18,66
690,0,34,82,18,134
691,18,34,48,18,118
692,15,19,48,18,100
693,19,32,16,18,85
694,15,17,16,18,66
695,17,34,16,18,85
698,16,18,16,17,67
699,18,33,16,16,83
700,0,33,16,16,65
701,17,32,17,19,85
702,16,16,17,19,68
703,33,19,15,16,83
705,19,31,18,15,83
707,16,33,16,19,84
708,0,33,16,19,68
709,31,19,14,17,81
710,35,31,18,16,100
714,18,16,17,17,68
717,17,32,18,15,82
718,15,17,18,15,65
719,17,33,19,16,85
720,0,33,19,16,68
721,34,16,16,18,84
722,35,34,15,16,100
723,32,18,15,16,81
724,34,31,19,17,101
725,18,31,19,17,85
726,0,31,19,17,67
728,19,17,15,17,68
729,32,17,17,17,83
730,32,34,15,18,99
731,100,17,17,15,149
732,83,17,17,15,132
734,49,17,17,15,98
735,34,17,17,15,83
737,34,15,18,17,84
738,32,35,16,17,100
739,15,35,16,17,83
741,17,33,17,17,84
742,33,34,15,18,100
743,34,17,15,18,84
744,17,17,15,18,67
745,17,33,17,16,83
746,15,18,17,16,66
747,35,16,15,18,84
748,17,16,15,18,66
749,16,33,16,17,82
751,18,33,17,16,84
753,17,33,33,18,101
754,17,16,33,18,84
755,16,33,18,16,83
757,15,34,18,16,83
758,34,34,15,19,102
759,16,34,15,19,84
760,18,16,15,19,68
761,16,34,16,21,87
762,34,37,10,18,99
764,16,21,10,18,65
766,0,28,18,17,63
768,18,17,16,16,67
769,33,16,17,17,83
770,84,16,16,16,132
771,68,16,16,16,116
772,52,16,16,16,100
774,18,16,16,16,66
776,16,16,17,16,65
777,16,33,17,17,83
778,33,34,33,17,117
779,33,17,33,17,100
780,118,18,16,15,167
783,68,18,16,15,117
784,51,18,16,15,100
785,34,18,16,15,83
786,18,18,16,15,67
787,18,31,18,15,82
788,31,33,17,18,99
789,15,33,17,18,83
790,0,33,17,18,68
791,15,35,16,15,81
793,34,15,18,17,84
794,49,17,17,15,98
795,33,17,17,15,82
796,18,17,17,15,67
797,17,32,34,17,100
798,17,15,34,17,83
800,19,15,17,18,69
801,15,35,16,16,82
803,18,32,17,18,85
804,16,16,17,18,67
805,16,35,47,17,115
806,0,35,47,17,99
808,15,16,16,17,64
809,101,15,18,18,152
810,85,15,18,18,136
812,52,15,18,18,103
814,18,15,18,18,69
816,0,36,165,18,219
817,66,17,100,18,201
818,48,17,100,18,183
819,31,17,100,18,166
820,17,17,100,18,152
822,16,16,68,18,118
823,16,35,33,18,102
825,17,33,18,15,83
826,15,18,18,15,66
827,18,33,16,18,85
828,0,33,16,18,67
830,16,18,17,17,68
831,18,34,15,18,85
832,17,17,15,18,67
833,17,33,16,17,83
836,16,17,17,16,66
837,66,18,84,15,183
839,32,18,84,15,149
840,16,18,84,15,133
843,34,15,19,15,83
844,17,15,19,15,66
845,15,34,16,18,83
847,49,33,34,15,131
848,34,33,34,15,116
850,15,18,34,15,82
851,18,34,15,18,85
852,16,18,15,18,67
854,33,34,15,17,99
855,18,34,15,17,84
858,15,17,18,15,65
859,17,33,19,15,84
860,33,34,34,16,117
861,15,34,34,16,99
862,19,15,34,16,84
863,15,34,33,18,100
864,17,17,33,18,85
866,16,17,18,31,82
867,17,18,16,15,66
868,18,47,18,18,101
870,15,16,18,18,67
871,16,36,33,15,100
872,18,18,33,15,84
873,33,18,15,16,82
875,84,33,16,18,151
876,66,33,16,18,133
877,51,33,16,18,118
879,20,33,16,18,87
881,17,34,16,17,84
883,18,33,17,15,83
885,17,32,19,33,101
887,15,19,15,18,67
888,19,49,32,17,117
889,15,34,32,17,98
891,0,16,32,17,65
893,16,34,16,16,82
894,34,32,19,16,101
897,35,16,33,17,101
898,19,16,33,17,85
902,17,16,116,18,167
903,0,16,116,18,150
904,18,15,83,18,134
905,15,34,49,18,116
906,18,16,49,18,101
908,17,17,15,18,67
913,32,17,32,18,99
914,17,17,32,18,84
915,17,32,35,16,100
916,16,16,35,16,83
917,34,17,16,17,84
921,17,32,34,16,99
922,134,32,33,16,215
923,117,32,33,16,198
925,84,32,33,16,165
926,68,32,33,16,149
927,52,32,33,16,133
928,33,32,33,16,114
929,18,32,33,16,99
930,15,17,33,16,81
931,17,33,16,18,84
932,0,33,16,18,67
935,34,17,84,17,152
936,16,17,84,17,134
939,17,33,17,17,84
940,83,18,32,17,150
942,50,18,32,17,117
944,16,18,32,17,83
945,18,32,17,16,83
946,15,17,17,16,65
948,17,16,17,17,67
949,16,34,16,17,83
950,0,34,16,17,67
951,17,33,16,16,82
954,16,16,35,15,82
955,16,35,32,17,100
956,0,35,32,17,84
957,17,32,84,17,150
958,15,17,84,17,133
960,0,35,49,17,101
962,0,33,16,17,66
963,17,33,15,17,82
964,99,34,16,17,166
965,83,34,16,17,150
966,66,34,16,17,133
967,51,34,16,17,118
968,34,34,16,17,101
969,33,18,16,17,84
970,34,33,32,19,118
971,34,17,32,19,102
973,17,32,19,16,84
974,17,15,19,16,67
978,16,18,16,16,66
980,16,16,17,16,65
983,16,34,16,18,84
984,17,17,16,18,68
986,34,32,52,18,136
989,33,16,18,18,85
990,18,16,18,18,70
991,82,35,34,17,168
992,66,35,34,17,152
993,48,35,34,17,134
994,30,35,34,17,116
995,85,32,16,18,151
996,86,15,16,18,135
999,35,15,16,18,84
1001,0,15,16,18,49
1002,16,18,17,17,68
1003,18,34,32,17,101
1005,17,32,17,16,82
1006,15,17,17,16,65
1007,17,33,33,16,99
1008,17,16,33,16,82
1010,18,15,16,17,66
1012,16,17,18,16,67
1013,0,17,18,16,51
1014,18,16,17,16,67
1015,33,16,18,15,82
1016,17,16,18,15,66
1017,16,33,19,14,82
1018,0,33,19,14,66
1019,34,14,85,15,148
1020,19,14,85,15,133
1022,34,34,32,18,118
1023,17,34,32,18,101
1024,34,32,34,18,118
1025,17,32,34,18,101
1026,17,15,34,18,84
1027,15,34,18,17,84
1028,18,16,18,17,69
1029,16,35,15,17,83
1030,18,17,15,17,67
1031,17,32,17,17,83
1032,15,17,17,17,66
1033,34,17,50,15,116
1034,34,31,19,15,99
1035,17,31,19,15,82
1036,0,31,19,15,65
1037,16,34,33,20,103
1038,34,33,20,31,118
1039,15,33,20,31,99
1040,33,20,31,16,100
1041,15,20,31,16,82
1042,20,47,36,15,118
1043,15,32,36,15,98
1046,17,19,15,17,68
1048,15,17,16,18,66
1049,17,34,15,19,85
1051,18,34,16,16,84
1052,15,19,16,16,66
1053,19,32,16,19,86
1054,0,32,16,19,67
1055,32,19,32,16,99
1056,16,19,32,16,83
1057,19,32,16,15,82
1061,15,34,18,16,83
1062,18,16,18,16,68
1064,18,16,35,16,85
1066,18,17,32,18,85
1068,32,35,49,17,133
1069,34,17,49,17,117
1070,35,34,15,17,101
1071,17,34,15,17,83
1072,15,19,15,17,66
1074,15,17,15,17,64
1075,17,32,18,16,83
1076,15,17,18,16,66
1078,18,16,17,16,67
1079,16,33,32,17,98
1080,17,16,32,17,82
1082,0,32,35,18,85
1083,14,35,18,15,82
1084,17,18,18,15,68
1085,18,33,16,19,86
1086,33,35,15,16,99
1087,15,35,15,16,81
1088,16,19,15,16,66
1090,15,16,35,16,82
1094,16,15,17,18,66
1095,15,35,17,15,82
1096,35,32,36,15,118
1098,32,36,15,18,101
1101,19,33,16,16,84
1102,15,18,16,16,65
1103,34,16,82,19,151
1104,16,16,82,19,133
1105,16,34,48,19,117
1106,0,34,48,19,101
1107,16,34,14,19,83
1108,17,17,14,19,67
1109,17,33,17,15,82
1110,33,32,18,17,100
1113,15,35,15,17,82
1114,0,35,15,17,67
1115,17,32,50,17,116
1116,15,17,50,17,99
1117,17,31,19,17,84
1119,16,36,16,17,85
1120,36,33,17,16,102
1121,33,17,17,16,83
1122,16,17,17,16,66
1123,34,16,18,16,84
1124,17,16,18,16,67
1125,16,34,167,16,233
1126,18,16,167,16,217
1128,17,17,133,16,183
1129,17,32,101,16,166
1130,15,17,101,16,149
1133,17,33,35,16,101
1134,33,35,32,18,118
1135,14,35,32,18,99
1137,17,32,18,17,84
1139,0,16,18,17,51
1140,35,32,16,18,101
1142,17,15,16,18,66
1143,15,34,16,17,82
1144,34,33,16,17,100
1145,18,33,16,17,84
1146,16,17,16,17,66
1147,33,17,17,18,85
1154,17,15,18,16,66
1157,199,18,34,16,267
1158,183,18,34,16,251
1159,166,18,34,16,234
1160,148,18,34,16,216
1161,131,18,34,16,199
1164,82,18,34,16,150
1168,16,18,34,16,84
1171,33,16,17,17,83
1173,0,16,17,17,50
1176,32,34,50,16,132
1177,16,34,50,16,116
1178,19,15,50,16,100
1179,15,33,17,16,81
1180,84,15,17,18,134
1182,51,15,17,18,101
1183,34,15,17,18,84
1185,32,18,15,19,84
1187,18,34,17,16,85
1189,36,16,15,19,86
1191,16,34,33,16,99
1192,0,34,33,16,83
1193,19,33,16,15,83
1195,83,34,32,16,165
1196,117,15,16,18,166
1197,101,15,16,18,150
1198,86,15,16,18,135
1199,67,15,16,18,116
1201,34,15,16,18,83
1202,17,15,16,18,66
1203,15,34,17,16,82
1204,34,33,16,18,101
1205,18,33,16,18,85
1206,17,16,16,18,67
1208,0,34,15,17,66
1209,18,32,18,15,83
1210,15,17,18,15,65
1211,17,33,19,14,83
1213,83,32,18,17,150
1216,35,32,18,17,102
1217,16,32,18,17,83
1218,0,32,18,17,67
1219,33,17,32,16,98
1220,18,17,32,16,83
1221,32,17,16,18,83
1223,17,34,16,16,83
1224,16,18,16,16,66
1225,18,32,17,17,84
1226,16,16,17,17,66
1228,0,34,34,17,85
1229,17,34,17,15,83
1230,17,17,17,15,66
1231,17,32,18,18,85
1232,17,15,18,18,68
1233,15,36,116,17,184
1235,18,31,85,17,151
1236,17,14,85,17,133
1239,16,33,18,17,84
1240,17,16,18,17,68
1242,0,35,50,15,100
1243,17,31,19,15,82
1244,31,34,18,15,98
1245,16,34,18,15,83
1246,19,15,18,15,67
1247,15,33,17,18,83
1249,15,35,32,17,99
1250,17,18,32,17,84
1251,18,32,17,16,83
1252,0,32,17,16,65
1253,168,15,18,16,217
1257,100,15,18,16,149
1258,84,15,18,16,133
1259,100,16,18,15,149
1260,83,16,18,15,132
1263,33,16,18,15,82
1264,18,16,18,15,67
1265,34,15,17,18,84
1266,18,15,17,18,68
1267,15,35,17,16,83
1268,17,18,17,16,68
1269,35,16,16,19,86
1270,17,16,16,19,68
1273,33,16,17,18,84
1274,47,18,16,17,98
1277,18,33,18,15,84
1278,33,33,33,17,116
1281,15,33,17,18,83
1283,31,18,34,14,97
1284,17,18,34,14,83
1285,18,34,14,19,85
1286,15,19,14,19,67
1287,19,33,16,15,83
1288,33,31,18,16,98
1289,84,34,17,20,155
1293,16,34,17,20,87
1297,49,34,18,14,115
1298,29,34,18,14,95
1299,15,34,18,14,81
1300,0,34,18,14,66
1301,16,32,35,16,99
1302,18,14,35,16,83
1303,14,35,16,17,82
1304,85,16,16,17,134
1306,50,16,16,17,99
1307,34,16,16,17,83
1309,32,17,34,17,100
1310,16,17,34,17,84
1311,17,34,17,16,84
1316,66,38,13,16,133
1317,50,38,13,16,117
1318,33,38,13,16,100
1319,15,38,13,16,82
1322,0,29,17,19,65
1323,16,36,16,17,85
1325,35,17,33,15,100
1327,17,33,15,18,83
1328,16,17,15,18,66
1330,15,18,15,17,65
1331,18,32,17,16,83
1332,0,32,17,16,65
1335,16,35,16,16,83
1336,0,35,16,16,67
1337,18,32,17,16,83
1338,16,16,17,16,65
1339,16,33,85,17,151
1340,0,33,85,17,135
1341,16,34,51,17,118
1343,18,36,15,17,86
1344,16,20,15,17,68
1346,32,32,16,19,99
1347,17,32,16,19,84
1348,0,32,16,19,67
1349,18,35,14,19,86
1350,16,19,14,19,68
1352,14,19,32,17,82
1354,15,17,17,16,65
1355,17,33,16,17,83
1356,33,33,18,16,100
1357,16,33,18,16,83
1359,17,34,34,15,100
1360,83,18,19,16,136
1361,83,19,16,32,150
1362,86,48,117,16,267
1364,52,48,117,16,233
1366,19,48,117,16,200
1367,16,32,117,16,181
1368,15,17,117,16,165
1369,17,32,85,16,150
1371,34,17,50,16,117
1373,0,17,50,16,83
1374,17,15,18,16,66
1375,15,34,17,17,83
1376,18,16,17,17,68
1378,0,34,16,16,66
1379,17,32,17,18,84
1380,16,16,17,18,67
1381,16,35,17,31,99
1382,17,18,17,31,83
1384,17,49,16,15,97
1385,16,33,16,15,80
1386,83,17,16,17,133
1388,50,17,16,17,100
1389,34,17,16,17,84
1391,33,17,16,17,83
1392,33,33,17,18,101
1393,33,17,17,18,85
1394,16,17,17,18,68
1395,68,15,17,18,118
1396,51,15,17,18,101
1397,34,15,17,18,84
1398,16,15,17,18,66
1399,32,18,15,17,82
1400,17,18,15,17,67
1402,15,17,16,18,66
1403,33,18,32,18,101
1405,83,34,16,17,150
1407,49,34,16,17,116
1408,33,34,16,17,100
1409,15,34,16,17,82
1410,18,16,16,17,67
1411,32,17,16,18,83
1412,16,17,16,18,67
1413,51,32,19,15,117
1414,34,32,19,15,100
1415,18,32,19,15,84
1416,17,15,19,15,66
1418,0,34,18,16,68
1419,15,34,16,17,82
1421,32,17,18,17,84
1422,16,17,18,17,68
1423,17,35,16,16,84
1424,18,17,16,16,67
1428,32,34,85,16,167
1429,16,34,85,16,151
1430,18,16,85,16,135
1431,32,17,52,16,117
1432,16,17,52,16,101
1433,17,34,84,18,153
1434,19,15,84,18,136
1436,34,18,32,18,102
1438,0,18,32,18,68
1440,62,34,83,17,196
1441,49,34,83,17,183
1442,31,34,83,17,165
1443,17,34,83,17,151
1444,34,18,65,17,134
1446,18,49,16,17,100
1447,14,35,16,17,82
1448,35,33,18,16,102
1449,16,33,18,16,83
1451,17,34,15,18,84
1453,31,18,17,16,82
1454,33,33,33,18,117
1455,18,33,33,18,102
1456,17,16,33,18,84
1457,16,33,33,19,101
1460,18,15,19,18,70
1461,15,37,13,17,82
1462,19,18,13,17,67
1464,0,30,17,17,64
1465,17,34,18,31,100
1469,16,32,18,17,83
1471,17,35,15,17,84
1475,17,32,19,15,83
1477,15,34,18,15,82
1478,19,15,18,15,67
1480,0,33,17,17,67
1481,15,34,16,17,82
1482,17,17,16,17,67
1483,17,33,17,16,83
1484,0,33,17,16,66
1487,16,35,17,16,84
1488,35,33,83,17,168
1489,34,16,83,17,150
1490,17,16,83,17,133
1491,16,33,50,17,116
1492,15,18,50,17,100
1493,33,19,33,15,100
1494,15,19,33,15,82
1495,19,33,33,15,100
1496,0,33,33,15,81
1497,32,18,32,19,101
1499,33,17,85,17,152
1500,15,17,85,17,134
1501,17,35,50,17,119
1502,19,16,50,17,102
1503,16,35,15,17,83
1505,19,32,16,17,84
1507,17,33,18,14,82
1508,16,17,18,14,65
1509,17,32,19,31,99
1512,19,47,19,17,102
1513,31,16,19,17,83
1514,33,36,16,15,100
1515,16,36,16,15,83
1516,19,17,16,15,67
1518,31,33,34,18,116
1520,33,34,18,16,101
1521,14,34,18,16,82
1523,33,16,17,18,84
1524,18,16,17,18,69
1525,83,32,19,16,150
1526,67,32,19,16,134
1528,83,16,15,17,131
1529,68,16,15,17,116
1531,65,17,19,15,116
1533,31,17,19,15,82
1534,15,17,19,15,66
1535,69,15,34,17,135
1536,52,15,34,17,118
1538,18,15,34,17,84
1540,34,32,19,17,102
1542,0,32,19,17,68
1543,0,15,19,17,51
1544,0,36,33,15,84
1545,33,17,34,15,99
1546,16,17,34,15,82
1548,15,19,15,17,66
1549,19,32,15,19,85
1550,15,17,15,19,66
1552,34,32,17,17,100
1553,19,32,17,17,85
1554,0,32,17,17,66
1556,17,17,18,30,82
1557,17,18,15,15,65
1558,0,18,15,15,48
1560,15,17,84,17,133
1561,0,17,84,17,118
1563,16,36,15,17,84
1564,18,18,15,17,68
1565,18,32,16,17,83
1566,116,18,14,18,166
1568,84,18,14,18,134
1569,68,18,14,18,118
1570,51,18,14,18,101
1571,34,18,14,18,84
1572,16,18,14,18,66
1573,18,32,16,17,83
1576,0,33,82,18,133
1579,17,33,34,17,101
1582,16,18,17,19,70
1583,18,36,15,15,84
1585,19,30,17,16,82
1586,15,15,17,16,63
1590,17,16,17,18,68
1591,16,35,17,17,85
1592,17,18,17,17,69
1593,18,34,33,17,102
1596,0,33,17,18,68
1597,17,35,16,32,100
1600,16,49,182,17,264
1601,16,33,182,17,248
1603,0,17,182,17,216
1604,33,32,117,17,199
1606,32,32,85,17,166
1607,34,14,85,17,150
1608,32,34,51,17,134
1609,14,34,51,17,116
1611,14,35,16,17,82
1613,17,33,16,16,82
1615,17,32,84,17,150
1616,0,32,84,17,133
1617,16,35,49,17,117
1618,18,17,49,17,101
1619,17,34,15,17,83
1621,84,33,82,18,217
1623,51,33,82,18,184
1624,117,17,33,17,184
1625,100,17,33,17,167
1626,150,15,18,16,199
1629,101,15,18,16,150
1630,83,15,18,16,132
1632,50,15,18,16,99
1633,35,15,18,16,84
1634,17,15,18,16,66
1635,15,34,19,16,84
1636,18,16,19,16,69
1637,85,33,15,18,151
1639,50,33,15,18,116
1640,34,33,15,18,100
1641,19,33,15,18,85
1642,48,18,15,18,99
1643,32,18,15,18,83
1644,15,18,15,18,66
1645,33,18,16,17,84
1647,34,17,17,16,84
1648,16,17,17,16,66
1649,101,15,18,16,150
1653,34,15,18,16,83
1654,16,15,18,16,65
1655,0,15,18,16,49
1657,16,34,33,18,101
1658,0,34,33,18,85
1659,17,33,18,15,83
1660,15,18,18,15,66
1661,18,33,32,18,101
1662,18,15,32,18,83
1664,17,15,36,17,85
1665,15,36,31,17,99
1667,18,31,17,17,83
1668,31,34,18,17,100
1669,14,34,18,17,83
1670,0,34,18,17,69
1672,86,47,34,16,183
1674,82,16,34,16,148
1675,67,16,34,16,133
1677,31,16,34,16,97
1678,17,16,34,16,83
1679,35,15,16,18,84
1681,15,34,15,18,82
1683,18,33,17,16,84
1684,33,33,18,14,98
1685,35,16,18,14,83
1686,17,16,18,14,65
1689,14,36,31,18,99
1690,17,19,31,18,85
1692,16,15,35,17,83
1695,17,33,34,16,100
1696,17,16,34,16,83
1697,0,16,34,16,66
1698,18,16,16,16,66
1700,0,32,17,16,65
1701,16,33,33,18,100
1702,0,33,33,18,84
1703,67,18,49,17,151
1704,51,18,49,17,135
1705,34,18,49,17,118
1707,18,31,18,17,84
1708,0,31,18,17,66
1709,16,35,15,18,84
1710,18,17,15,18,68
1711,17,33,82,17,149
1712,0,33,82,17,132
1713,18,33,49,17,117
1714,0,33,49,17,99
1715,18,34,32,16,100
1716,16,18,32,16,82
1717,18,32,16,18,84
1718,15,17,16,18,66
1719,33,18,17,16,84
1720,51,16,16,19,102
1721,35,16,16,19,86
1722,17,16,16,19,68
1724,35,34,16,14,99
1726,34,30,19,16,99
1727,18,30,19,16,83
1728,0,30,19,16,65
1731,16,33,16,18,83
1732,15,18,16,18,67
1734,16,18,15,18,67
1737,18,33,15,19,85
1738,33,34,16,18,101
1739,16,34,16,18,84
1740,15,19,16,18,68
1741,35,18,16,16,85
1742,16,18,16,16,66
1743,18,32,17,17,84
1745,16,34,16,16,82
1746,50,16,16,19,101
1747,33,16,16,19,84
1748,16,16,16,19,67
1749,32,19,16,15,82
1751,19,31,35,17,102
1753,15,35,32,16,98
1754,17,18,32,16,83
1755,50,34,17,16,117
1756,32,34,17,16,99
1757,15,34,17,16,82
1758,16,18,17,16,67
1759,18,33,17,17,85
1760,0,33,17,17,67
1763,17,33,17,17,84
1764,16,17,17,17,67
1765,34,17,83,16,150
1766,17,17,83,16,133
1767,17,34,49,16,116
1768,49,17,17,16,99
1769,33,17,17,16,83
1770,15,17,17,16,65
1772,0,33,16,18,67
1774,0,34,18,16,68
1775,36,16,15,18,85
1777,16,33,16,18,83
1778,0,33,16,18,67
1779,18,34,33,16,101
1781,18,33,33,16,100
1782,15,18,33,16,82
1783,18,33,34,16,101
1785,17,34,16,18,85
1786,16,18,16,18,68
1787,18,34,17,31,100
1789,35,47,19,15,116
1791,31,16,19,15,81
1793,16,34,17,16,83
1794,19,15,17,16,67
1795,32,16,18,16,82
1797,0,16,18,16,50
1798,18,16,17,17,68
1799,16,34,15,18,83
1800,17,17,15,18,67
1801,32,18,17,16,83
1802,15,18,17,16,66
1803,35,16,17,14,82
1806,50,18,15,17,100
1807,33,18,15,17,83
1808,19,18,15,17,69
1810,15,17,17,15,64
1811,17,32,35,16,100
1812,17,15,35,16,83
1813,15,35,16,18,84
1814,35,34,17,34,120
1817,18,17,15,19,69
1818,32,19,15,16,82
1819,34,47,85,15,181
1823,16,34,51,15,116
1825,16,33,18,15,82
1826,17,16,18,15,66
1828,18,15,17,17,67
1829,32,17,16,17,82
1830,17,17,16,17,67
1832,16,17,19,15,67
1833,17,34,17,15,83
1834,19,15,17,15,66
1835,15,32,118,16,181
1838,0,37,81,16,134
1839,33,17,50,16,116
1840,14,17,50,16,97
1842,34,32,18,16,100
1843,17,32,18,16,83
1844,16,16,18,16,66
1847,16,32,50,19,117
1848,15,17,50,19,101
1850,17,18,34,15,84
1851,18,34,33,16,101
1852,15,19,33,16,83
1854,0,33,33,15,81
1855,18,33,15,17,83
1856,16,17,15,17,65
1857,0,17,15,17,49
1858,15,17,33,19,84
1859,17,33,19,14,83
1860,18,15,19,14,66
1861,15,33,19,16,83
1862,19,14,19,16,68
1863,14,35,16,18,83
1864,0,35,16,18,69
1865,16,34,33,17,100
1866,34,33,17,16,100
1867,18,33,17,16,84
1868,16,17,17,16,66
1869,17,33,17,15,82
1870,17,16,17,15,65
1872,32,36,16,17,101
1873,15,36,16,17,84
1875,18,33,15,18,84
1876,16,17,15,18,66
1878,65,33,118,16,232
1879,50,33,118,16,217
1880,32,33,118,16,199
1881,17,33,118,16,184
1882,51,17,83,16,167
1883,34,17,83,16,150
1884,18,17,83,16,134
1885,17,19,64,16,116
1886,19,47,17,16,99
1887,13,34,17,16,80
1888,16,18,17,16,67
1889,18,33,12,23,86
1890,17,16,12,23,68
1891,51,31,50,19,151
1892,51,15,50,19,135
1893,39,15,50,19,123
1894,16,15,50,19,100
1895,15,33,17,19,84
1896,0,33,17,19,69
1897,15,36,14,17,82
1899,19,31,19,15,84
1900,0,31,19,15,65
1901,17,34,18,16,85
1902,19,15,18,16,68
1904,18,16,16,17,67
1905,32,17,16,18,83
1906,16,17,16,18,67
1907,33,18,48,18,117
1908,16,18,48,18,100
1909,18,31,17,18,84
1911,15,35,18,16,84
1912,17,18,18,16,69
1913,18,34,16,17,85
1914,0,34,16,17,67
1915,16,33,15,18,82
1917,17,33,17,17,84
1918,33,34,16,16,99
1919,18,34,16,16,84
1923,32,17,83,19,151
1924,16,17,83,19,135
1926,18,16,49,19,102
1927,16,34,34,15,99
1928,16,18,34,15,83
1930,15,19,15,17,66
1932,0,32,16,19,67
1933,17,35,14,18,84
1934,16,19,14,18,67
1936,14,18,17,16,65
1938,33,33,17,16,99
1940,33,33,18,16,100
1944,52,15,18,17,102
1945,34,15,18,17,84
1946,18,15,18,17,68
1948,18,17,33,17,85
1949,17,33,17,16,83
1951,18,33,16,16,83
1955,16,34,16,20,86
1957,16,36,12,20,84
1958,16,20,12,20,68
1959,20,32,16,18,86
1960,12,20,16,18,66
1961,36,18,14,17,85
1962,16,18,14,17,65
1964,31,35,33,16,115
1965,85,33,34,15,167
1967,52,33,34,15,134
1969,18,33,34,15,100
1970,16,17,34,15,82
1971,17,34,15,16,82
1972,0,34,15,16,65
1974,15,16,19,15,65
1975,35,15,16,17,83
1976,19,15,16,17,67
1978,0,33,17,17,67
1980,17,17,117,17,168
1981,17,33,84,17,151
1982,17,16,84,17,134
1985,18,33,16,17,84
1986,49,17,17,15,98
1987,33,17,17,15,82
1988,16,17,17,15,65
1989,17,32,19,17,85
1990,17,15,19,17,68
1991,34,17,16,16,83
1992,19,17,16,16,68
1993,33,16,15,17,81
1994,16,16,15,17,64
1997,17,35,17,15,84
1999,16,32,18,16,82
2000,17,15,18,16,66
2001,15,34,16,16,81
2002,0,34,16,16,66
2003,16,32,18,18,84
2004,50,18,15,17,100
2005,34,18,15,17,84
2006,18,18,15,17,68
2007,18,32,17,15,82
2008,0,32,17,15,64
2009,17,32,18,17,84
2010,32,35,16,16,99
2011,15,35,16,16,82
2013,17,32,16,19,84
2014,16,16,16,19,67
2015,16,35,16,17,84
2016,16,19,16,17,68
2018,0,33,34,15,82
2025,16,34,34,16,100
2026,18,16,34,16,84
2027,16,34,16,16,82
2028,16,18,16,16,66
2029,34,16,17,16,83
2030,16,16,17,16,65
2031,33,16,18,15,82
2033,16,33,37,31,117
2034,0,33,37,31,101
2035,15,37,13,18,83
2036,19,18,13,18,68
2037,18,31,17,16,82
2039,35,16,16,17,84
2040,17,16,16,17,66
2043,17,33,18,17,85
2045,17,35,34,16,102
2046,35,34,16,16,101
2047,35,16,16,16,83
2049,0,16,16,16,48
2050,32,33,18,15,98
2052,17,16,18,15,66
2053,16,33,83,16,148
2054,33,33,50,16,132
2055,15,33,50,16,114
2056,33,33,17,16,99
2058,16,17,17,16,66
2059,34,16,18,18,86
2060,17,16,18,18,69
2061,34,18,34,31,117
2062,18,18,34,31,101
2063,18,34,15,16,83
2064,34,31,17,17,99
2067,16,34,17,17,84
2068,34,34,16,16,100
2069,17,34,16,16,83
2070,17,17,16,16,66
2071,17,32,18,16,83
2072,16,16,18,16,66
2073,16,34,18,16,84
2074,18,16,18,16,68
2075,34,16,15,17,82
2078,15,17,17,17,66
2080,0,34,18,14,66
2081,17,32,34,16,99
2082,18,14,34,16,82
2083,32,16,16,19,83
2084,18,16,16,19,69
2085,16,35,16,16,83
2086,35,32,18,15,100
2087,19,32,18,15,84
2088,16,16,18,15,65
2090,0,33,33,18,84
2092,0,33,35,17,85
2093,34,17,17,17,85
2094,18,17,17,17,69
2095,17,34,15,17,83
2096,17,17,15,17,66
2097,17,32,33,16,98
2098,15,17,33,16,81
2100,85,15,16,19,135
2102,52,15,16,19,102
2103,36,15,16,19,86
2104,18,15,16,19,68
2105,15,35,32,16,98
2106,0,35,32,16,83
2107,19,32,16,16,83
2108,15,17,16,16,64
2111,34,17,16,16,83
2112,18,17,16,16,67
2113,17,32,18,15,82
2114,16,16,18,15,65
2115,34,15,20,31,100
2116,18,15,20,31,84
2117,15,20,13,18,66
2119,13,34,118,17,182
2121,0,16,118,17,151
2122,0,33,85,17,135
2123,15,34,51,17,117
2124,17,17,51,17,102
2125,17,34,17,17,85
2127,18,34,15,17,84
2128,34,32,17,17,100
2130,0,32,17,17,66
2131,34,17,17,16,84
2132,17,17,17,16,67
2133,17,33,16,17,83
2134,17,16,16,17,66
2135,16,33,17,16,82
2137,17,33,35,16,101
2138,0,33,35,16,84
2139,16,35,16,15,82
2140,18,17,16,15,66
2141,33,15,35,15,98
2144,18,17,150,17,202
2145,32,17,118,17,184
2146,15,17,118,17,167
2148,34,34,50,17,135
2149,33,18,50,17,118
2151,18,33,17,17,85
2152,17,16,17,17,67
2154,17,17,15,18,67
2155,0,17,15,18,50
2156,15,18,17,15,65
2157,35,15,18,16,84
2160,0,34,16,18,68
2161,16,34,17,16,83
2162,0,34,17,16,67
2163,18,33,17,14,82
2164,17,16,17,14,64
2165,33,14,18,18,83
2166,17,14,18,18,67
2167,14,36,16,16,82
2169,18,32,18,17,85
2170,16,16,18,17,67
2171,0,16,18,17,51
2172,18,17,32,17,84
2173,17,32,17,16,82
2176,17,16,20,30,83
2177,16,20,47,17,100
2178,0,20,47,17,84
2179,13,34,34,17,98
2180,34,34,17,17,102
2181,34,17,17,17,85
2182,17,17,17,17,68
2183,17,34,16,15,82
2184,34,31,19,17,101
2185,33,15,19,17,84
2186,16,15,19,17,67
2187,34,17,34,16,101
2188,19,17,34,16,86
2190,83,17,16,16,132
2191,68,17,16,16,117
2192,49,17,16,16,98
2193,33,17,16,16,82
2194,81,17,16,17,131
2195,66,17,16,17,116
2197,33,17,16,17,83
2198,17,17,16,17,67
2199,17,33,16,14,80
2200,16,17,16,14,63
2202,0,30,35,17,82
2203,33,16,17,17,83
2204,19,16,17,17,69
2205,16,34,17,17,84
2206,34,34,33,18,119
2207,17,34,33,18,102
2208,17,17,33,18,85
2209,17,33,18,15,83
2211,17,33,17,17,84
2212,0,33,17,17,67
2213,0,15,17,17,49
2215,34,16,34,16,100
2216,17,16,34,16,83
2217,16,34,16,19,85
2220,16,19,16,16,67
2221,19,32,33,19,103
2222,16,16,33,19,84
2224,0,33,19,31,83
2225,16,19,13,18,66
2226,19,47,17,16,99
2227,13,34,17,16,80
2228,18,16,17,16,67
2230,33,33,17,19,102
2231,16,33,17,19,85
2232,0,33,17,19,69
2233,32,19,16,15,82
2234,36,31,18,14,99
2235,35,15,18,14,82
2237,15,32,18,16,81
2238,32,34,19,15,100
2239,32,16,19,15,82
2240,68,35,15,18,136
2242,34,35,15,18,102
2243,15,35,15,18,83
2248,16,17,20,29,82
2249,17,20,46,18,101
2250,20,46,34,16,116
2251,46,34,83,17,180
2252,32,34,83,17,166
2253,17,34,83,17,151
2254,18,16,83,17,134
2256,32,36,15,17,100
2257,16,36,15,17,84
2259,18,32,17,16,83
2260,15,17,17,16,65
2261,17,33,18,15,83
2262,17,16,18,15,66
2268,33,33,16,16,98
2269,17,33,16,16,82
2271,34,16,18,15,83
2272,16,16,18,15,65
2273,49,35,34,16,134
2274,33,35,34,16,118
2275,15,35,34,16,100
2276,0,35,34,16,85
2277,35,17,32,17,101
2278,98,35,18,15,166
2279,81,35,18,15,149
2280,64,35,18,15,132
2281,48,35,18,15,116
2284,35,33,33,17,118
2287,15,33,33,18,99
2288,33,33,18,16,100
2289,16,33,18,16,83
2290,0,33,18,16,67
2291,34,16,18,15,83
2292,18,16,18,15,67
2293,16,33,34,15,98
2294,18,15,34,15,82
2295,15,34,0,15,64
2296,18,16,0,15,49
2297,16,32,19,15,82
2298,15,17,19,15,66
2299,17,34,17,18,86
2300,0,34,17,18,69
2301,32,18,31,17,98
2302,17,18,31,17,83
2303,18,31,17,16,82
2308,34,35,16,15,100
2310,83,17,16,17,133
2311,66,17,16,17,116
2312,48,17,16,17,98
2313,32,17,16,17,82
2314,17,17,16,17,67
2315,17,33,16,17,83
2316,16,17,16,17,66
2317,17,33,34,16,100
2318,0,33,34,16,83
2319,17,34,16,17,84
2322,16,17,18,16,67
2323,0,17,18,16,51
2326,33,33,18,16,100
2327,15,33,18,16,82
2328,0,33,18,16,67
2329,35,16,18,15,84
2330,18,16,18,15,67
2331,49,35,16,17,117
2332,33,35,16,17,101
2333,15,35,16,17,83
2334,0,35,16,17,68
2335,19,33,15,17,84
2336,0,33,15,17,65
2339,17,33,18,17,85
2340,0,33,18,17,68
2341,15,35,17,16,83
2342,18,17,17,16,68
2343,34,16,17,17,84
2344,17,16,17,17,67
2346,17,17,15,17,66
2347,17,32,19,15,83
2348,15,17,19,15,66
2349,17,34,33,16,100
2352,33,35,133,17,218
2353,16,35,133,17,201
2354,0,35,133,17,185
2355,19,32,101,17,169
2356,32,33,68,17,150
2357,17,33,68,17,135
2358,16,17,68,17,118
2360,18,16,34,17,85
2363,19,33,34,15,101
2364,17,16,34,15,82
2365,0,16,34,15,65
2366,15,19,15,17,66
2367,19,32,16,17,84
2372,0,36,14,18,68
2373,18,32,15,18,83
2374,14,18,15,18,65
2375,18,33,15,17,83
2376,0,33,15,17,65
2377,66,17,16,18,117
2378,48,17,16,18,99
2379,33,17,16,18,84
2380,16,17,16,18,67
2381,17,34,33,18,102
2382,16,18,33,18,85
2384,17,16,34,17,84
2385,16,34,17,15,82
2387,82,34,84,17,217
2388,83,17,84,17,201
2390,51,17,84,17,169
2391,33,17,84,17,151
2392,17,17,84,17,135
2394,17,15,52,17,101
2395,15,34,18,17,84
2396,18,16,18,17,69
2397,16,35,83,15,149
2398,0,35,83,15,133
2399,17,32,51,15,115
2400,32,34,17,15,98
2401,16,34,17,15,82
2404,32,32,34,18,116
2405,32,15,34,18,99
2407,15,34,18,16,83
2408,20,14,18,16,68
2411,33,18,15,16,82
2412,35,31,35,16,117
2413,18,31,35,16,100
2414,31,35,16,19,101
2415,16,35,16,19,86
2417,17,35,16,17,85
2418,16,19,16,17,68
2419,19,33,49,16,117
2420,0,33,49,16,98
2421,17,30,19,16,82
2422,15,15,19,16,65
2423,15,35,18,17,85
2424,19,16,18,17,70
2425,16,35,15,16,82
2427,17,31,33,17,98
2428,31,33,17,19,100
2429,16,33,17,19,85
2430,33,36,32,16,117
2431,32,19,32,16,99
2432,17,19,32,16,84
2433,19,32,16,17,84
2434,15,17,16,17,65
2435,17,33,17,17,84
2436,16,17,17,17,67
2437,17,34,15,16,82
2438,17,17,15,16,65
2439,32,16,17,18,83
2440,82,19,48,18,167
2441,67,19,48,18,152
2443,34,19,48,18,119
2444,16,19,48,18,101
2445,19,31,17,18,85
2446,14,17,17,18,66
2447,17,35,32,16,100
2448,0,35,32,16,83
2449,18,32,16,18,84
2450,16,16,16,18,66
2451,16,34,16,18,84
2453,18,34,16,17,85
2454,134,32,83,18,267
2456,100,32,83,18,233
2457,84,32,83,18,217
2458,67,32,83,18,200
2459,51,32,83,18,184
2462,15,17,83,18,133
2463,17,33,50,18,118
2464,33,33,17,18,101
2465,15,33,17,18,83
2466,17,16,17,18,68
2468,35,33,17,17,102
2469,18,33,17,17,85
2471,17,34,31,19,101
2475,35,16,16,17,84
2476,19,16,16,17,68
2479,34,16,83,17,150
2481,16,33,50,17,116
2482,0,33,50,17,100
2483,16,35,15,17,83
2484,16,19,15,17,67
2485,19,32,17,16,84
2486,0,32,17,16,65
2487,17,33,18,16,84
2488,0,33,18,16,67
2489,16,34,34,16,100
2490,18,16,34,16,84
2492,34,34,15,17,100
2493,17,34,15,17,83
2494,16,18,15,17,66
2495,0,18,15,17,50
2496,15,17,16,17,65
2497,17,33,34,18,102
2498,33,34,18,16,101
2499,35,16,18,16,85
2500,18,16,18,16,68
2501,16,34,17,16,83
2502,84,17,16,16,133
2503,66,17,16,16,115
2504,83,16,33,18,150
2506,50,16,33,18,117
2508,16,16,33,18,83
2509,16,33,33,18,100
2510,0,33,33,18,84
2511,33,15,33,18,99
2512,18,15,33,18,84
2513,100,16,32,17,165
2516,52,16,32,17,117
2518,19,16,32,17,84
2520,17,15,17,19,68
2521,32,19,83,15,149
2522,17,19,83,15,134
2523,0,19,83,15,117
2524,15,18,50,15,98
2525,34,15,34,16,99
2526,16,15,34,16,81
2527,15,34,16,18,83
2529,15,34,17,15,81
2530,16,18,17,15,66
2533,117,32,19,15,183
2534,102,32,19,15,168
2535,84,32,19,15,150
2536,69,32,19,15,135
2537,51,32,19,15,117
2538,65,34,18,15,132
2539,50,34,18,15,117
2541,16,34,18,15,83
2542,19,15,18,15,67
2543,15,33,16,18,82
2544,18,15,16,18,67
2545,15,34,32,17,98
2548,15,17,17,17,66
2550,17,17,18,16,68
2552,50,17,17,16,100
2553,32,17,17,16,82
2554,16,17,17,16,66
2556,17,16,18,16,67
2557,100,16,16,17,149
2559,66,16,16,17,115
2561,48,33,17,18,116
2562,31,33,17,18,99
2563,16,33,17,18,84
2564,16,17,17,18,68
2566,0,35,16,17,68
2567,51,33,50,17,151
2568,33,33,50,17,133
2569,17,33,50,17,117
2570,17,16,50,17,100
2573,18,34,16,17,85
2574,34,33,17,16,100
2575,83,32,50,18,183
2577,50,32,50,18,150
2578,33,32,50,18,133
2580,18,14,50,18,100
2581,14,34,16,18,82
2582,34,34,17,17,102
2583,17,34,17,17,85
2584,34,34,18,16,102
2586,17,17,18,16,68
2587,35,48,17,15,115
2588,18,48,17,15,98
2589,16,32,17,15,80
2590,0,32,17,15,64
2591,16,32,35,16,99
2592,17,15,35,16,83
2593,15,35,16,17,83
2594,17,18,16,17,68
2595,34,17,16,17,84
2596,16,17,16,17,66
2597,17,33,35,16,101
2598,16,17,35,16,84
2599,17,35,32,17,101
2600,0,35,32,17,84
2601,17,32,17,16,82
2602,32,33,18,14,97
2603,16,33,18,14,81
2604,17,16,18,14,65
2606,0,32,18,17,67
2608,18,17,16,17,68
2609,17,33,17,17,84
2611,17,34,34,18,103
2612,17,17,34,18,86
2613,17,18,34,31,100
2614,18,34,16,15,83
2615,0,34,16,15,65
2617,16,33,13,20,82
2618,15,18,13,20,66
2619,31,20,16,16,83
2622,16,16,17,18,67
2623,16,35,33,14,98
2624,17,18,33,14,82
2625,18,33,48,17,116
2626,0,33,48,17,98
2627,18,31,17,17,83
2628,14,17,17,17,65
2629,0,17,17,17,51
2632,19,17,16,16,68
2633,33,16,15,19,83
2635,16,34,50,32,132
2637,36,15,18,32,101
2638,17,15,18,32,82
2639,15,18,15,17,65
2640,18,47,17,20,102
2641,15,32,17,20,84
2642,17,15,17,20,69
2644,17,20,14,18,69
2645,20,32,16,17,85
2647,34,17,33,18,102
2648,16,17,33,18,84
2649,17,33,18,15,83
2650,16,17,18,15,66
2651,101,16,51,17,185
2652,84,16,51,17,168
2654,51,16,51,17,135
2655,35,16,51,17,119
2656,17,16,51,17,101
2657,16,33,35,16,100
2658,33,35,34,32,134
2659,35,17,34,32,118
2661,17,34,32,17,100
2663,32,18,17,17,84
2664,14,18,17,17,66
2665,18,34,17,16,85
2666,17,17,17,16,67
2669,16,33,51,34,134
2671,18,34,17,34,103
2672,66,19,13,17,115
2673,49,19,13,17,98
2675,15,19,13,17,64
2678,17,18,15,19,69
2679,0,18,15,19,52
2680,67,34,16,15,132
2681,52,34,16,15,117
2683,17,34,16,15,82
2684,65,35,15,19,134
2685,49,35,15,19,118
2687,15,35,15,19,84
2688,50,19,15,17,101
2689,33,19,15,17,84
2690,15,19,15,17,66
2691,19,32,16,18,85
2692,32,34,15,18,99
2694,16,18,15,18,67
2695,18,33,15,19,85
2696,15,18,15,19,67
2697,18,34,16,17,85
2698,15,19,16,17,67
2700,16,17,16,17,66
2701,17,33,34,16,100
2702,16,17,34,16,83
2703,17,34,16,16,83
2704,50,16,84,17,167
2705,34,16,84,17,151
2706,16,16,84,17,133
2707,0,16,84,17,117
2710,15,20,46,17,98
2711,35,17,14,17,83
2712,32,31,19,17,99
2713,31,17,19,17,84
2714,50,17,15,18,100
2716,19,17,15,18,69
2717,17,33,15,19,84
2718,15,18,15,19,67
2719,18,34,14,19,85
2722,33,33,16,18,100
2723,19,33,16,18,86
2724,15,18,16,18,67
2726,16,18,15,16,65
2727,18,31,33,18,100
2729,16,33,33,19,101
2730,17,16,33,19,85
2731,16,33,19,16,84
2732,18,15,19,16,68
2734,19,16,35,14,84
2735,16,35,14,19,84
2736,35,33,16,14,98
2737,33,19,16,14,82
2738,14,19,16,14,63
2739,19,30,103,17,169
2741,82,35,17,16,150
2742,68,35,17,16,136
2743,49,35,17,16,117
2745,17,35,17,16,85
2746,35,33,32,17,117
2747,17,33,32,17,99
2749,16,32,17,16,81
2750,14,18,17,16,65
2751,18,33,16,18,85
2752,17,16,16,18,67
2754,16,18,16,16,66
2755,18,32,19,16,85
2756,0,32,19,16,67
2757,16,35,18,15,84
2758,0,35,18,15,68
2759,16,33,17,16,82
2760,0,33,17,16,66
2761,15,33,33,17,98
2763,16,33,35,17,101
2767,18,32,18,17,85
2768,17,15,18,17,67
2770,18,17,99,15,149
2771,17,31,68,15,131
2772,16,15,68,15,114
2774,83,20,16,14,133
2775,65,20,16,14,115
2776,48,20,16,14,98
2780,81,18,38,28,165
2782,69,38,12,16,135
2783,52,38,12,16,118
2784,34,38,12,16,100
2785,18,38,12,16,84
2786,15,23,12,16,66
2787,0,23,12,16,51
2788,12,16,17,15,60
2789,16,32,35,15,98
2790,17,15,35,15,82
2791,15,35,15,17,82
2792,35,32,83,19,169
2793,18,32,83,19,152
2794,15,17,83,19,134
2798,15,18,15,19,67
2799,18,34,16,17,85
2800,15,19,16,17,67
2802,0,33,16,16,65
2803,33,16,34,17,100
2804,16,16,34,17,83
2805,16,34,34,15,99
2806,0,34,34,15,83
2807,16,34,15,21,86
2808,17,17,15,21,70
2810,15,21,47,17,100
2811,21,30,17,17,85
2812,0,30,17,17,64
2813,17,34,15,18,84
2814,17,17,15,18,67
2815,50,33,16,18,117
2816,33,33,16,18,100
2817,18,33,16,18,85
2819,33,18,16,17,84
2821,18,33,115,19,185
2822,16,17,115,19,167
2823,17,33,82,19,151
2827,17,33,16,19,85
2828,17,16,16,19,68
2829,16,35,16,15,82
2830,16,19,16,15,66
2831,19,31,18,16,84
2832,0,31,18,16,65
2833,49,33,34,17,133
2834,34,33,34,17,118
2835,16,33,34,17,100
2836,16,17,34,17,84
2837,36,15,17,16,84
2838,34,33,17,17,101
2839,15,33,17,17,82
2841,16,34,16,16,82
2842,17,17,16,16,66
2844,0,32,17,17,66
2845,16,34,16,17,83
2849,17,34,16,17,84
2850,0,34,16,17,67
2851,17,33,17,17,84
2852,0,33,17,17,67
2855,34,17,84,15,150
2856,17,17,84,15,133
2857,17,33,51,15,116
2858,33,33,83,18,167
2859,17,33,83,18,151
2860,15,18,83,18,134
2861,18,33,50,18,119
2863,15,34,16,18,83
2865,17,34,14,18,83
2866,0,34,14,18,66
2867,18,32,17,17,84
2869,35,17,48,20,120
2870,17,17,48,20,102
2871,17,32,16,20,85
2872,32,36,14,18,100
2873,17,36,14,18,85
2874,16,20,14,18,68
2875,20,32,31,18,101
2876,0,32,31,18,81
2879,15,35,16,18,84
2880,18,17,16,18,69
2881,17,34,32,18,101
2882,16,18,32,18,84
2883,18,32,18,15,83
2885,16,33,35,15,99
2886,18,15,35,15,83
2887,15,35,15,17,82
2888,18,17,15,17,67
2889,17,32,18,16,83
2890,15,17,18,16,66
2891,17,34,34,16,101
2892,18,16,34,16,84
2893,16,34,16,16,82
2895,18,32,19,15,84
2896,16,16,19,15,66
2897,16,34,34,17,101
2899,0,15,34,17,66
2901,18,33,16,18,85
2903,16,34,33,16,99
2904,16,18,33,16,83
2905,33,18,16,18,85
2906,15,18,16,18,67
2907,18,34,16,17,85
2908,34,33,16,14,97
2909,18,33,16,14,81
2910,16,17,16,14,63
2911,17,30,20,17,84
2912,0,30,20,17,67
2913,14,37,16,17,84
2914,20,17,16,17,70
2916,16,17,16,18,67
2917,17,34,15,16,82
2918,0,34,15,16,65
2922,16,17,84,17,134
2924,118,17,100,16,251
2926,82,17,100,16,215
2927,67,17,100,16,200
2928,49,17,100,16,182
2930,34,33,67,16,150
2932,100,36,13,17,166
2934,67,36,13,17,133
2936,32,36,13,17,98
2937,17,36,13,17,83
2939,0,20,13,17,50
2942,17,16,17,16,66
2943,16,33,17,18,84
2945,16,35,17,15,83
2946,35,32,35,14,116
2947,18,32,35,14,99
2949,15,35,14,18,82
2951,17,32,17,17,83
2952,0,32,17,17,66
2954,34,33,17,17,101
2955,17,33,17,17,84
2957,35,17,84,16,152
2959,17,32,83,17,149
2960,16,16,83,17,132
2962,18,15,50,17,100
2963,15,35,82,17,149
2964,35,32,50,17,134
2967,0,17,50,17,84
2968,201,33,83,17,334
2972,134,33,83,17,267
2973,117,33,83,17,250
2975,84,33,83,17,217
2976,67,33,83,17,200
2977,50,33,83,17,183
2978,34,33,83,17,167
2979,17,33,83,17,150
2980,0,33,83,17,133
2981,17,33,50,17,117
2984,17,18,15,17,67
2987,17,32,18,17,84
2988,15,17,18,17,67
2989,17,35,16,16,84
2990,0,35,16,16,67
2993,16,35,16,17,84
2995,18,33,17,16,84
2996,0,33,17,16,66
2999,34,48,18,17,117
3000,18,48,18,17,101
3002,18,16,18,17,69
3003,67,15,17,18,117
3004,51,15,17,18,101
3005,33,15,17,18,83
3006,16,15,17,18,66
3008,17,18,17,17,69
3010,34,33,16,16,99
3011,31,19,16,16,82
3012,14,19,16,16,65
3014,16,16,34,15,81
3015,16,34,15,18,83
3016,49,18,16,18,101
3017,32,18,16,18,84
3018,15,18,16,18,67
3019,34,18,16,18,86
3021,18,34,31,19,102
3022,16,18,31,19,84
3023,18,31,19,16,84
3024,17,14,19,16,66
3027,16,34,15,17,82
3031,17,34,16,17,84
3032,17,17,16,17,67
3033,17,33,17,18,85
3034,33,35,14,19,101
3037,18,33,16,15,82
3039,19,31,19,15,84
3040,0,31,19,15,65
3042,19,15,16,17,67
3043,31,17,16,18,82
3044,16,17,16,18,67
3047,18,33,18,16,85
3051,16,32,18,16,82
3053,15,34,17,16,82
3054,18,16,17,16,67
3055,16,33,16,18,83
3056,0,33,16,18,67
3057,16,34,16,18,84
3060,16,18,16,18,68
3062,16,18,15,18,67
3063,33,18,17,15,83
3064,15,18,17,15,65
3065,18,32,16,17,83
3066,17,15,16,17,65
3067,15,33,18,16,82
3070,34,34,15,18,101
3071,16,34,15,18,83
3073,17,33,16,17,83
3074,15,18,16,17,66
3075,18,33,16,19,86
3077,33,19,15,17,84
3078,16,19,15,17,67
3080,0,32,15,18,65
3082,15,18,16,18,67
3083,18,34,16,16,84
3084,0,34,16,16,66
3085,18,32,17,17,84
3086,32,34,16,17,99
3089,17,33,18,15,83
3090,16,17,18,15,66
3091,17,33,118,15,183
3092,18,15,118,15,166
3093,32,16,85,15,148
3096,35,32,18,15,100
3097,17,32,18,15,82
3098,15,17,18,15,65
3099,17,33,17,18,85
3100,33,35,15,19,102
3103,18,34,16,16,84
3106,0,32,33,16,81
3108,17,16,16,17,66
3109,16,33,16,19,84
3110,33,35,15,18,101
3113,19,33,15,19,86
3116,166,34,16,16,232
3120,101,34,16,16,167
3121,83,34,16,16,149
3123,51,34,16,16,117
3124,35,34,16,16,101
3125,17,34,16,16,83
3126,17,17,16,16,66
3127,17,32,17,16,82
3129,16,33,35,15,99
3130,17,16,35,15,83
3131,16,35,15,16,82
3132,66,35,16,19,136
3134,31,35,16,19,101
3135,16,35,16,19,86
3136,18,17,16,19,70
3137,83,35,16,15,149
3138,66,35,16,15,132
3140,31,35,16,15,97
3141,16,35,16,15,82
3142,0,35,16,15,66
3143,34,15,18,15,82
3144,16,15,18,15,64
3145,15,33,84,18,150
3146,33,34,50,18,135
3147,15,34,50,18,117
3148,19,15,50,18,102
3149,15,34,34,17,100
3150,34,34,17,16,101
3151,17,34,17,16,84
3155,16,33,16,18,83
3156,16,17,16,18,67
3159,34,17,49,17,117
3160,16,17,49,17,99
3162,0,31,18,17,66
3164,18,17,17,18,70
3165,34,18,15,18,85
3166,35,33,17,15,100
3167,18,33,17,15,83
3168,15,18,17,15,65
3169,35,15,18,16,84
3170,17,15,18,16,66
3171,15,34,17,16,82
3172,0,34,17,16,67
3175,16,32,18,17,83
3177,16,35,18,14,83
3178,18,17,18,14,67
3179,35,14,19,15,83
3180,18,14,19,15,66
3181,33,15,17,16,81
3186,83,19,33,16,151
3187,65,19,33,16,133
3191,19,33,32,18,102
3193,18,32,18,16,84
3195,16,34,16,17,83
3197,16,33,17,17,83
3200,17,17,17,17,68
3202,0,34,32,16,82
3204,82,18,15,16,131
3205,65,18,15,16,114
3206,50,18,15,16,99
3207,34,18,15,16,83
3208,16,18,15,16,65
3211,16,20,16,15,67
3212,20,49,165,16,250
3213,16,33,165,16,230
3215,0,18,165,16,199
3217,16,33,100,16,165
3219,17,33,67,16,133
3220,18,15,67,16,116
3221,15,34,33,16,98
3222,34,33,16,17,100
3223,16,33,16,17,82
3224,17,16,16,17,66
3225,16,33,17,17,83
3226,16,17,17,17,67
3227,0,17,17,17,51
3228,17,17,18,16,68
3229,17,34,16,17,84
3230,18,16,16,17,67
3232,33,34,36,30,133
3234,34,36,14,16,100
3235,18,36,14,16,84
3236,16,20,14,16,66
3237,68,16,17,16,117
3238,48,16,17,16,97
3239,83,32,17,18,150
3240,67,32,17,18,134
3241,49,32,17,18,116
3244,15,17,17,18,67
3247,18,33,50,16,117
3248,83,16,50,18,167
3252,17,16,50,18,101
3253,16,32,18,18,84
3254,18,14,18,18,68
3256,0,36,16,17,69
3257,18,33,83,17,151
3258,0,33,83,17,133
3259,32,17,51,17,117
3260,15,17,51,17,100
3261,17,34,17,17,85
3263,17,34,15,17,83
3265,17,32,83,16,148
3267,17,33,50,16,116
3268,17,16,50,16,99
3269,35,16,15,16,82
3270,19,16,15,16,66
3272,15,16,17,18,66
3273,16,35,18,16,85
3277,16,31,51,18,116
3278,0,31,51,18,100
3279,16,34,17,18,85
3280,17,17,17,18,69
3281,17,35,18,31,101
3282,17,18,18,31,84
3283,67,16,18,15,116
3285,31,16,18,15,80
3286,16,16,18,15,65
3287,16,33,17,17,83
3288,18,15,17,17,67
3289,15,34,32,18,99
3296,16,16,18,16,66
3297,34,16,19,16,85
3298,34,35,16,15,100
3299,16,35,16,15,82
3300,19,16,16,15,66
3301,16,31,19,15,81
3302,16,15,19,15,65
3303,34,15,18,16,83
3304,19,15,18,16,68
3305,33,16,17,16,82
3306,18,16,17,16,67
3307,16,33,35,16,100
3308,17,16,35,16,84
3309,16,35,50,16,117
3310,0,35,50,16,101
3312,16,15,19,16,66
3313,15,35,16,16,82
3314,67,34,34,17,152
3315,48,34,34,17,133
3316,32,34,34,17,117
3317,84,33,34,16,167
3318,68,33,34,16,151
3319,52,33,34,16,135
3321,35,16,34,16,101
3322,17,16,34,16,83
3323,0,16,34,16,66
3324,34,33,16,17,100
3325,16,33,16,17,82
3326,66,34,32,18,150
3327,50,34,32,18,134
3328,33,34,32,18,117
3329,34,17,32,18,101
3330,17,17,32,18,84
3331,17,32,85,14,148
3332,16,16,85,14,131
3334,18,15,52,14,99
3337,0,16,17,14,47
3339,14,34,17,18,83
3341,33,18,16,16,83
3343,18,32,35,15,100
3344,32,35,15,18,100
3345,16,35,15,18,84
3346,17,18,15,18,68
3347,18,33,15,19,85
3351,19,32,82,18,151
3354,34,33,15,18,100
3356,17,16,15,18,66
3357,16,33,17,16,82
3358,15,18,17,16,66
3359,18,33,35,19,105
3360,0,33,35,19,87
3361,16,35,19,29,99
3362,18,17,19,29,83
3364,19,47,32,16,114
3366,19,18,32,16,85
3367,83,34,18,17,152
3369,68,15,18,17,118
3370,52,15,18,17,102
3372,19,15,18,17,69
3373,165,17,16,17,215
3375,132,17,16,17,182
3376,115,17,16,17,165
3378,84,17,16,17,134
3379,66,17,16,17,116
3380,49,17,16,17,99
3382,15,17,16,17,65
3384,16,17,18,15,66
3389,17,17,18,30,82
3390,17,48,17,17,99
3391,33,15,17,17,82
3392,15,15,17,17,64
3393,15,34,18,14,81
3395,35,14,20,30,99
3396,32,20,14,16,82
3397,14,20,14,16,64
3398,20,48,16,17,101
3399,14,34,16,17,81
3401,0,18,16,17,51
3403,34,17,16,18,85
3404,68,33,33,16,150
3406,34,33,33,16,116
3407,18,33,33,16,100
3410,17,16,16,18,67
3411,98,17,17,17,149
3412,82,17,17,17,133
3414,48,17,17,17,99
3415,32,17,17,17,83
3416,17,17,17,17,68
3418,83,18,48,19,168
3420,49,18,48,19,134
3421,99,19,16,16,150
3423,66,19,16,16,117
3424,48,19,16,16,99
3425,31,19,16,16,82
3426,16,19,16,16,67
3427,19,32,16,18,85
3428,0,32,16,18,66
3432,32,34,18,16,100
3433,32,17,18,16,83
3434,17,17,18,16,68
3435,17,34,17,16,84
3437,16,33,18,15,82
3439,16,33,18,16,83
3440,18,15,18,16,67
3441,33,16,18,14,81
3442,18,16,18,14,66
3445,14,35,17,17,83
3447,18,34,16,17,85
3448,0,34,16,17,67
3450,33,34,48,16,131
3451,33,18,48,16,115
3453,18,17,31,16,82
3454,17,47,19,16,99
3456,16,16,19,16,67
3457,0,16,19,16,51
3458,0,35,16,17,68
3459,32,17,17,15,81
3461,17,32,17,17,83
3462,17,15,17,17,66
3463,15,34,16,19,84
3464,0,34,16,19,69
3465,17,35,32,20,104
3466,16,19,32,20,87
3467,34,17,20,31,102
3468,32,20,14,17,83
3469,17,20,14,17,68
3470,20,47,15,17,99
3471,14,33,15,17,79
3472,33,32,35,17,117
3473,16,32,35,17,100
3474,15,17,35,17,84
3475,17,35,17,15,84
3476,35,32,85,16,168
3478,17,15,85,16,133
3480,18,15,52,16,101
3481,15,35,17,16,83
3482,35,33,82,17,167
3483,18,33,82,17,150
3486,16,17,49,17,99
3487,17,33,33,17,100
3488,17,16,33,17,83
3492,17,16,17,17,67
3493,0,16,17,17,50
3494,0,34,18,17,69
3495,17,35,16,16,84
3496,18,17,16,16,67
3497,17,32,17,18,84
3499,16,35,16,16,83
3500,0,35,16,16,67
3501,18,32,17,15,82
3502,16,16,17,15,64
3504,82,17,17,17,133
3505,65,17,17,17,116
3507,32,17,17,17,83
3508,15,17,17,17,66
3509,34,17,16,18,85
3510,17,17,16,18,68
3511,17,34,17,16,84
3512,16,18,17,16,67
3513,18,33,33,16,100
3517,151,33,16,17,217
3518,134,33,16,17,200
3522,68,33,16,17,134
3523,117,34,32,16,199
3525,84,34,32,16,166
3526,66,34,32,16,148
3527,51,34,32,16,133
3530,15,19,32,16,82
3531,19,32,16,19,86
3533,50,32,35,16,133
3537,17,35,16,16,84
3538,16,19,16,16,67
3539,19,32,16,17,84
3540,16,16,16,17,65
3541,16,33,35,17,101
3542,33,35,17,14,99
3543,17,35,17,14,83
3546,50,17,14,19,100
3547,33,17,14,19,83
3548,19,17,14,19,69
3549,31,19,16,16,82
3551,19,32,216,18,285
3553,16,34,182,18,250
3554,17,17,182,18,234
3555,17,32,150,18,217
3556,32,35,115,18,200
3559,35,16,82,18,151
3561,16,32,50,18,116
3562,15,17,50,18,100
3563,17,33,35,15,100
3564,18,15,35,15,83
3565,15,35,15,18,83
3566,17,18,15,18,68
3569,18,34,16,18,86
3571,18,34,16,16,84
3572,34,32,49,18,133
3573,34,16,49,18,117
3574,16,16,49,18,99
3575,16,34,15,18,83
3576,0,34,15,18,67
3577,19,33,17,15,84
3578,15,18,17,15,65
3582,18,15,17,17,67
3583,15,34,17,16,82
3584,17,17,17,16,67
3587,16,34,83,17,150
3588,0,34,83,17,134
3590,17,17,49,17,100
3591,17,32,17,17,83
3592,16,16,17,17,66
3593,16,34,19,32,101
3595,51,35,14,17,117
3596,34,35,14,17,100
3597,15,35,14,17,81
3598,17,18,14,17,66
3599,32,17,16,19,84
3602,16,19,15,17,67
3603,19,32,15,18,84
3604,32,33,16,19,100
3605,17,33,16,19,85
3606,15,18,16,19,68
3608,35,32,34,16,117
3609,35,16,34,16,101
3610,16,16,34,16,82
3611,16,34,16,16,82
3612,16,18,16,16,66
3614,16,16,18,15,65
3615,16,33,18,15,82
3616,66,34,117,16,233
3617,48,34,117,16,215
3618,33,34,117,16,200
3622,19,48,50,16,133
3623,17,31,50,16,114
3624,0,31,50,16,97
3626,17,15,18,16,66
3627,33,16,34,16,99
3629,117,32,51,17,217
3630,101,32,51,17,201
3631,85,32,51,17,185
3633,51,32,51,17,151
3635,16,32,51,17,116
3636,18,14,51,17,100
3637,82,32,18,16,148
3638,68,32,18,16,134
3639,49,32,18,16,115
3641,17,32,18,16,83
3642,15,17,18,16,66
3643,17,34,19,14,84
3644,18,16,19,14,67
3645,16,33,17,17,83
3646,0,33,17,17,67
3647,14,34,17,16,81
3648,0,34,17,16,67
3650,33,33,34,17,117
3651,16,33,34,17,100
3652,33,34,17,16,100
3653,16,34,17,16,83
3654,17,17,17,16,67
3658,34,33,17,16,100
3661,0,17,17,16,50
3664,33,34,19,30,116
3669,16,31,18,15,80
3672,18,15,35,16,84
3673,15,35,16,18,84
3674,0,35,16,18,69
3675,17,34,16,15,82
3676,84,16,16,18,134
3678,50,16,16,18,100
3682,0,34,16,15,65
3684,65,33,17,16,131
3685,49,33,17,16,115
3686,34,33,17,16,100
3688,17,16,17,16,66
3689,33,16,18,18,85
3691,16,36,14,20,86
3692,0,36,14,20,70
3693,18,34,31,16,99
3694,34,31,118,16,199
3697,32,18,84,16,150
3698,16,18,84,16,134
3699,18,32,52,16,118
3700,16,16,52,16,100
3702,18,16,18,16,68
3703,16,34,17,15,82
3705,33,15,17,17,82
3708,0,34,15,19,68
3709,17,34,17,16,84
3710,15,19,17,16,67
3711,19,33,17,16,85
3712,17,16,17,16,66
3713,16,33,35,15,99
3714,0,33,35,15,83
3715,34,17,15,17,83
3716,18,17,15,17,67
3717,17,32,36,30,115
3718,32,36,46,18,132
3719,17,36,46,18,117
3720,17,19,46,18,100
3722,0,30,16,18,64
3723,17,34,49,17,117
3724,16,18,49,17,100
3725,18,33,16,17,84
3726,0,33,16,17,66
3727,16,33,117,16,182
3728,33,34,83,16,166
3729,17,34,83,16,150
3731,17,35,48,16,116
3735,17,33,17,17,84
3736,0,33,17,17,67
3737,33,17,33,18,101
3739,17,33,33,16,99
3740,33,33,16,18,100
3741,15,33,16,18,82
3742,18,15,16,18,67
3744,16,18,18,15,67
3745,0,18,18,15,51
3746,18,15,0,18,51
3750,16,16,17,19,68
3751,16,36,16,15,83
3752,36,31,84,18,169
3753,35,15,84,18,152
3754,48,18,49,18,133
3755,32,18,49,18,117
3756,17,18,49,18,102
3757,18,32,17,18,85
3758,0,32,17,18,67
3760,17,18,84,32,151
3761,166,19,33,15,233
3762,148,19,33,15,215
3763,133,19,33,15,200
3766,83,19,33,15,150
3768,51,19,33,15,118
3769,32,19,33,15,99
3770,17,19,33,15,84
3771,34,18,15,19,86
3772,15,18,15,19,67
3774,15,19,48,15,97
3775,19,31,17,15,82
3777,32,15,84,19,150
3780,34,35,15,19,103
3781,13,35,15,19,82
3782,18,17,15,19,69
3783,0,17,15,19,51
3784,15,19,15,16,65
3785,19,31,18,16,84
3786,15,16,18,16,65
3788,0,34,34,17,85
3789,16,34,17,17,84
3791,17,34,17,15,83
3792,17,17,17,15,66
3793,17,32,19,33,101
3794,17,15,19,33,84
3795,15,19,13,20,67
3796,0,19,13,20,52
3797,13,20,15,18,66
3798,20,50,16,17,103
3800,18,17,16,17,68
3801,17,33,15,18,83
3802,16,17,15,18,66
3803,32,18,16,16,82
3804,15,18,16,16,65
3806,16,16,18,17,67
3807,34,17,67,16,134
3808,35,34,33,16,118
3809,17,34,33,16,100
3810,0,34,33,16,83
3811,17,17,16,16,66
3812,17,49,17,17,100
3814,16,17,17,17,67
3816,17,17,15,18,67
3817,17,33,83,15,148
3818,15,18,83,15,131
3819,18,31,52,15,116
3822,19,16,17,15,67
3827,34,17,33,16,100
3829,17,33,16,17,83
3830,0,33,16,17,66
3831,17,33,34,15,99
3832,0,33,34,15,82
3833,17,34,15,18,84
3834,16,18,15,18,67
3835,33,18,16,19,86
3836,15,18,16,19,68
3837,86,33,14,19,152
3838,68,33,14,19,134
3839,66,19,14,19,118
3841,31,19,14,19,83
3842,14,19,14,19,66
3843,33,19,16,17,85
3844,33,33,16,16,98
3845,19,33,16,16,84
3846,0,33,16,16,65
3847,17,32,16,19,84
3850,0,35,15,16,66
3851,19,31,36,16,102
3852,31,36,16,16,99
3853,16,36,16,16,84
3854,0,36,16,16,68
3855,18,32,17,17,84
3857,16,34,100,17,167
3860,15,18,67,17,117
3861,18,33,34,17,102
3864,19,47,16,17,99
3865,15,32,16,17,80
3866,17,15,16,17,65
3867,15,33,17,16,81
3868,16,17,17,16,66
3870,0,33,19,15,67
3871,35,15,183,20,253
3873,32,20,146,20,218
3874,17,20,146,20,203
3876,14,18,114,20,166
3878,16,15,83,20,134
3879,15,19,84,30,148
3880,34,33,36,30,133
3881,15,33,36,30,114
3882,17,16,36,30,99
3883,32,20,15,15,82
3885,20,30,16,19,85
3886,30,35,15,16,96
3888,0,35,15,16,66
3890,31,35,16,17,99
3892,0,35,16,17,68
3893,17,33,17,17,84
3894,16,17,17,17,67
3896,0,34,15,19,68
3897,32,19,14,18,83
3899,19,32,17,18,86
3900,0,32,17,18,67
3901,18,35,15,16,84
3903,18,31,17,18,84
3905,16,35,16,16,83
3907,18,32,17,19,86
3909,16,36,16,33,101
3910,36,16,33,16,101
3911,19,16,33,16,84
3912,16,49,15,18,98
3914,17,16,15,18,66
3915,31,18,17,16,82
3917,35,16,16,17,84
3918,17,16,16,17,66
3919,32,17,33,18,100
3920,16,17,33,18,84
3922,33,34,50,18,135
3923,15,34,50,18,117
3925,37,47,81,19,184
3926,21,47,81,19,168
3927,10,37,81,19,147
3928,19,18,81,19,137
3929,0,18,81,19,118
3930,0,32,49,19,100
3931,17,33,85,16,151
3932,16,17,85,16,134
3933,17,35,116,16,184
3935,19,34,82,16,151
3937,18,32,50,16,116
3939,16,32,18,16,82
3942,18,16,16,18,68
3943,16,34,34,15,99
3944,0,34,34,15,83
3945,18,34,15,16,83
3946,34,31,19,15,99
3947,32,16,19,15,82
3950,19,15,18,14,66
3951,15,32,34,17,98
3952,0,32,34,17,83
3953,14,34,17,17,82
3955,15,34,17,18,84
3956,34,35,16,18,103
3957,17,35,16,18,86
3958,17,18,16,18,69
3959,18,34,15,17,84
3960,16,18,15,17,66
3961,18,32,17,15,82
3962,15,17,17,15,64
3964,84,16,17,17,134
3966,52,16,17,17,102
3967,36,16,17,17,86
3970,17,17,15,18,67
3973,84,34,13,19,150
3974,66,34,13,19,132
3975,49,34,13,19,115
3976,32,34,13,19,98
3978,34,32,18,15,99
3980,13,19,18,15,65
3981,0,19,18,15,52
3983,15,34,17,16,82
3984,18,16,17,16,67
3986,17,16,19,16,68
3987,16,35,16,16,83
3988,0,35,16,16,67
3990,32,33,17,18,100
3991,33,16,17,18,84
3992,17,16,17,18,68
3993,16,35,32,17,100
3994,17,18,32,17,84
3995,18,32,34,17,101
3996,16,16,34,17,83
3997,16,34,17,16,83
3999,34,16,17,17,84
4000,17,16,17,17,67
4002,17,17,48,19,101
4005,16,34,15,17,82
4006,15,19,15,17,66
4007,19,32,33,16,100
4008,0,32,33,16,81
4010,0,33,16,17,66
4011,84,32,18,17,151
4012,67,32,18,17,134
4014,34,32,18,17,101
4016,17,15,18,17,67
4019,33,18,83,18,152
4020,16,18,83,18,135
4021,18,32,51,18,119
4022,0,32,51,18,101
4023,17,34,17,18,86
4024,18,16,17,18,69
4026,17,18,16,15,66
4027,84,33,15,18,150
4028,66,33,15,18,132
4029,50,33,15,18,116
4030,35,33,15,18,101
4031,17,33,15,18,83
4032,0,33,15,18,66
4033,19,33,34,16,102
4034,0,33,34,16,83
4035,18,34,16,16,84
4036,15,19,16,16,66
4037,19,32,16,17,84
4042,35,33,33,17,118
4043,17,33,33,17,100
4045,67,16,34,15,132
4046,50,16,34,15,115
4047,34,16,34,15,99
4048,33,34,15,19,101
4049,16,34,15,19,84
4051,18,34,14,18,84
4052,66,35,34,29,164
4053,51,35,34,29,149
4055,18,35,34,29,116
4057,18,34,14,15,81
4058,34,29,18,17,98
4060,29,35,34,16,114
4061,15,35,34,16,100
4062,0,35,34,16,85
4063,17,34,16,17,84
4064,17,17,16,17,67
4065,17,33,17,15,82
4066,16,17,17,15,65
4067,34,15,17,18,84
4068,32,35,17,16,100
4069,15,35,17,16,83
4070,17,18,17,16,68
4071,18,33,16,18,85
4072,33,34,16,16,99
4073,16,34,16,16,82
4074,16,18,16,16,66
4075,18,32,18,15,83
4076,16,16,18,15,65
4077,16,33,184,17,250
4081,18,30,118,17,183
4082,0,30,118,17,165
4083,16,35,83,17,151
4084,18,17,83,17,135
4085,32,17,51,17,117
4087,17,33,18,17,85
4089,16,35,17,16,84
4090,18,17,17,16,68
4093,32,17,16,17,82
4094,16,17,16,17,66
4095,17,33,35,16,101
4096,33,35,16,18,102
4098,17,18,16,18,69
4100,34,32,15,19,100
4101,84,32,17,17,150
4103,52,32,17,17,118
4104,34,32,17,17,100
4105,19,32,17,17,85
4106,17,15,17,17,66
4107,32,17,15,18,82
4108,34,33,16,18,101
4109,17,33,16,18,84
4110,33,34,34,15,116
4111,18,34,34,15,101
4112,100,33,18,15,166
4114,66,33,18,15,132
4115,50,33,18,15,116
4116,32,33,18,15,98
4117,17,33,18,15,83
4119,16,33,17,18,84
4120,33,35,16,16,100
4121,66,16,19,15,116
4122,51,16,19,15,101
4123,34,16,19,15,84
4124,16,16,19,15,66
4127,48,19,82,15,164
4128,33,19,82,15,149
4129,17,19,82,15,133
4130,84,17,15,16,132
4131,65,17,15,16,113
4133,35,17,15,16,83
4135,32,16,35,16,99
4137,16,35,16,18,85
4138,0,35,16,18,69
4139,16,34,32,19,101
4140,85,15,32,17,149
4142,51,15,32,17,115
4144,19,15,32,17,83
4146,17,15,117,18,167
4147,15,35,82,18,150
4148,35,32,50,18,135
4149,18,32,50,18,118
4150,15,17,50,18,100
4152,18,15,17,18,68
4153,15,35,15,19,84
4154,35,34,15,17,101
4155,33,19,15,17,84
4158,0,32,17,17,66
4161,17,33,17,15,82
4162,16,17,17,15,65
4164,17,15,19,15,66
4165,15,34,18,15,82
4166,34,33,86,14,167
4168,18,15,86,14,133
4169,84,31,17,17,149
4170,69,31,17,17,134
4173,19,31,17,17,84
4175,14,34,16,17,81
4177,17,33,51,16,117
4178,16,17,51,16,100
4179,17,33,18,16,84
4180,16,17,18,16,67
4181,51,34,15,17,117
4182,34,34,15,17,100
4183,16,34,15,17,82
4186,0,32,19,15,66
4187,17,34,17,17,85
4188,19,15,17,17,68
4189,15,34,16,17,82
4190,17,17,16,17,67
4191,33,17,16,19,85
4193,17,35,32,17,101
4195,85,34,14,18,151
4196,66,34,14,18,132
4197,50,34,14,18,116
4198,34,34,14,18,100
4199,17,34,14,18,83
4201,33,18,16,17,84
4202,14,18,16,17,65
4203,34,17,16,16,83
4204,16,17,16,16,65
4206,32,35,16,16,99
4207,16,35,16,16,83
4208,18,17,16,16,67
4209,17,32,35,16,100
4212,0,35,16,16,67
4213,35,16,19,17,87
4214,16,16,19,17,68
4216,19,47,17,17,100
4217,31,16,17,17,81
4218,14,16,17,17,64
4220,0,34,17,16,67
4223,32,19,17,16,84
4225,19,33,17,15,84
4226,17,16,17,15,65
4227,16,32,35,15,98
4228,0,32,35,15,82
4229,15,35,15,19,84
4231,19,34,16,17,86
4232,34,33,14,17,98
4233,19,33,14,17,83
4234,16,17,14,17,64
4235,17,31,17,17,82
4236,14,17,17,17,65
4237,34,17,16,19,86
4238,17,17,16,19,69
4239,17,35,15,17,84
4242,32,34,35,32,133
4244,0,34,35,32,101
4245,69,16,16,15,116
4247,36,16,16,15,83
4248,16,16,16,15,63
4249,16,31,18,16,81
4250,0,31,18,16,65
4251,15,34,17,17,83
4253,16,34,16,18,84
4255,17,34,16,18,85
4257,18,34,33,16,101
4259,18,33,16,19,86
4260,0,33,16,19,68
4263,19,31,17,15,82
4264,31,32,33,17,113
4265,18,32,33,17,100
4266,17,15,33,17,82
4268,19,14,17,18,68
4269,14,35,34,15,98
4270,17,18,34,15,84
4271,18,34,15,18,85
4273,17,33,18,14,82
4276,0,32,18,17,67
4277,14,35,81,17,147
4279,83,32,18,16,149
4282,34,32,18,16,100
4283,17,32,18,16,83
4285,17,34,17,16,84
4286,0,34,17,16,67
4287,16,33,18,15,82
4288,0,33,18,15,66
4290,18,15,167,18,218
4291,15,35,132,18,200
4292,0,35,132,18,185
4293,33,17,99,18,167
4296,17,16,66,18,117
4297,16,33,33,18,100
4298,17,16,33,18,84
4300,18,15,18,17,68
4301,33,17,15,17,82
4302,18,17,15,17,67
4305,17,34,15,18,84
4309,35,16,16,18,85
4310,17,16,16,18,67
4312,16,18,35,12,81
4314,15,20,12,19,66
4315,20,31,34,18,103
4317,19,34,18,15,86
4319,67,17,17,16,117
4320,50,17,17,16,100
4321,32,17,17,16,82
4322,17,17,17,16,67
4324,33,33,15,18,99
4326,0,33,15,18,66
4328,15,18,16,18,67
4330,16,18,15,19,68
4331,33,19,84,16,152
4332,15,19,84,16,134
4334,15,18,51,16,100
4336,32,35,15,17,99
4337,115,35,16,17,183
4338,100,35,16,17,168
4340,65,35,16,17,133
4341,50,35,16,17,118
4343,18,35,16,17,86
4344,35,33,16,16,100
4346,0,33,16,16,65
4349,51,33,50,16,150
4350,35,33,50,16,134
4351,17,33,50,16,116
4352,0,33,50,16,99
4353,34,16,18,16,84
4354,16,16,18,16,66
4355,16,34,18,16,84
4356,18,16,18,16,68
4359,16,33,16,16,81
4360,0,33,16,16,65
4361,34,16,19,14,83
4363,0,16,19,14,49
4364,0,33,19,16,68
4365,14,35,33,14,96
4367,16,33,14,19,82
4368,17,16,14,19,66
4369,16,33,17,15,81
4371,19,32,102,16,169
4376,17,16,34,16,83
4377,16,34,16,16,82
4378,18,16,16,16,66
4379,16,32,34,17,99
4381,0,16,34,17,67
4385,17,32,19,16,84
4386,17,15,19,16,67
4387,34,16,17,16,83
4388,52,16,16,18,102
4389,33,16,16,18,83
4390,17,16,16,18,67
4392,16,18,81,18,133
4393,18,33,48,18,117
4394,47,18,16,18,99
4395,30,18,16,18,82
4396,14,18,16,18,66
4397,34,18,17,17,86
4398,34,34,17,16,101
4399,18,34,17,16,85
4402,0,33,16,17,66
4404,16,17,84,17,134
4406,0,35,49,17,101
4408,17,15,34,16,82
4409,15,34,48,18,115
4410,0,34,48,18,100
4411,17,31,17,18,83
4412,16,15,17,18,66
4414,84,18,32,19,153
4419,18,32,19,16,85
4421,15,35,17,15,82
4422,19,16,17,15,67
4423,16,32,17,16,81
4424,32,33,33,18,116
4425,32,16,33,18,99
4427,33,16,18,15,82
4428,17,16,18,15,66
4429,16,33,17,18,84
4431,15,35,17,15,82
4432,17,18,17,15,67
4433,18,32,19,16,85
4434,0,32,19,16,67
4436,35,33,83,16,167
4437,16,33,83,16,148
4438,33,34,49,16,132
4440,15,19,49,16,99
4441,0,19,49,16,84
4442,16,15,117,18,166
4444,18,16,83,18,135
4445,16,33,50,18,117
4446,0,33,50,18,101
4447,17,34,16,18,85
4449,32,18,16,17,83
4450,16,18,16,17,67
4451,18,33,17,15,83
4452,0,33,17,15,65
4454,17,15,18,17,67
4455,33,17,33,18,101
4456,18,17,33,18,86
4457,17,33,18,17,85
4459,100,17,50,16,183
4460,83,17,50,16,166
4461,65,17,50,16,148
4462,48,17,50,16,131
4464,16,17,50,16,99
4466,16,18,16,16,66
4468,16,16,17,18,67
4470,84,16,16,19,135
4471,67,16,16,19,118
4472,49,16,16,19,100
4473,34,16,16,19,85
4474,17,16,16,19,68
4476,16,19,116,16,167
4477,19,34,82,16,151
4478,17,17,82,16,132
4480,82,16,17,16,131
4482,50,16,17,16,99
4483,34,16,17,16,83
4484,16,16,17,16,65
4486,0,33,18,18,69
4489,18,32,16,16,82
4490,15,17,16,16,64
4491,33,16,17,18,84
4493,0,16,17,18,51
4494,17,18,33,16,84
4495,18,33,16,17,84
4496,33,33,17,17,100
4497,18,33,17,17,85
4499,0,17,17,17,51
4500,17,17,15,17,66
4501,17,32,33,19,101
4502,32,33,35,16,116
4503,17,33,35,16,101
4504,17,16,35,16,84
4506,19,16,16,17,68
4507,32,17,15,19,83
4508,16,17,15,19,67
4510,15,19,50,15,99
4511,35,16,18,15,84
4512,16,16,18,15,65
4514,18,15,17,16,66
4515,32,16,18,17,83
4516,51,17,17,15,100
4517,34,17,17,15,83
4518,18,17,17,15,67
4519,117,33,15,17,182
4521,83,33,15,17,148
4523,51,33,15,17,116
4526,0,33,15,17,65
4528,82,18,17,16,133
4530,50,18,17,16,101
4532,16,18,17,16,67
4533,18,33,14,20,85
4534,0,33,14,20,67
4536,34,34,82,16,166
4538,15,19,82,16,132
4539,0,19,82,16,117
4540,14,17,51,16,98
4541,17,35,16,16,84
4542,35,32,17,18,102
4543,18,32,17,18,85
4544,32,35,15,16,98
4545,16,35,15,16,82
4547,18,31,35,15,99
4548,15,16,35,15,81
4549,16,35,34,17,102
4550,18,17,34,17,86
4552,34,33,49,16,132
4555,16,31,18,16,81
4556,31,34,18,18,101
4557,14,34,18,18,84
4559,34,18,16,15,83
4560,18,18,16,15,67
4561,18,31,17,15,81
4565,117,34,15,18,184
4566,102,34,15,18,169
4569,51,34,15,18,118
4572,15,19,15,18,67
4573,19,33,15,17,84
4574,33,32,17,16,98
4576,15,17,17,16,65
4577,17,33,18,16,84
4579,34,16,84,15,149
4580,18,16,84,15,133
4581,16,33,51,15,115
4582,16,17,51,15,99
4583,17,35,16,15,83
4584,0,35,16,15,66
4585,16,31,18,16,81
4586,16,15,18,16,65
4587,15,34,17,16,82
4589,33,16,19,14,82
4590,17,16,19,14,66
4591,49,35,16,17,117
4592,33,35,16,17,101
4593,14,35,16,17,82
4594,0,35,16,17,68
4597,17,33,50,18,118
4600,17,16,17,18,68
4601,16,35,82,18,151
4602,35,33,49,18,135
4603,18,33,49,18,118
4606,0,32,17,18,67
4607,16,35,17,15,83
4608,17,18,17,15,67
4609,35,15,17,18,85
4611,15,35,15,17,82
4612,17,18,15,17,67
4613,18,32,16,19,85
4615,33,19,14,17,83
4617,69,13,37,15,134
4618,50,13,37,15,115
4619,36,13,37,15,101
4621,34,48,16,17,115
4622,21,48,16,17,102
4624,15,17,16,17,65
4627,17,32,18,16,83
4628,17,15,18,16,66
4629,15,34,18,15,82
4633,15,35,15,17,82
4634,67,35,16,17,135
4636,32,35,16,17,100
4637,17,35,16,17,85
4638,35,33,33,18,119
4639,19,33,33,18,103
4640,16,17,33,18,84
4641,17,33,18,15,83
4645,0,15,16,18,49
4646,16,18,16,16,66
4647,18,32,17,19,86
4649,33,19,80,19,151
4650,36,33,47,19,135
4652,15,18,47,19,99
4653,18,31,16,19,84
4655,15,35,16,17,83
4657,35,17,15,19,86
4658,67,31,18,16,132
4660,34,31,18,16,99
4661,19,31,18,16,84
4663,17,34,16,18,85
4664,18,16,16,18,68
4665,16,34,16,16,82
4667,18,32,18,17,85
4669,16,35,17,15,83
4670,0,35,17,15,67
4676,34,32,19,15,100
4677,34,15,19,15,83
4678,32,34,34,15,115
4679,15,34,34,15,98
4682,34,32,85,15,166
4683,16,32,85,15,148
4684,15,17,85,15,132
4685,17,33,52,15,117
4686,18,15,52,15,100
4687,15,33,19,15,82
4688,17,16,19,15,67
4689,16,34,35,15,100
4691,15,35,15,19,84
4694,34,32,13,20,99
4695,34,17,13,20,84
4697,0,17,13,20,50
4700,0,34,17,15,66
4701,35,15,18,15,83
4702,17,15,18,15,65
4705,15,34,17,16,82
4707,18,33,17,16,84
4708,50,16,17,18,101
4709,33,16,17,18,84
4710,17,16,17,18,68
4711,33,18,15,16,82
4712,17,18,15,16,66
4713,18,31,18,16,83
4715,34,16,85,15,150
4716,18,16,85,15,134
4717,16,33,52,15,116
4720,18,15,19,15,67
4721,34,15,17,21,87
4722,19,15,17,21,72
4723,32,21,79,18,150
4725,21,29,50,18,118
4727,19,36,14,18,87
4728,36,32,83,17,168
4729,18,32,83,17,150
4730,0,32,83,17,132
4731,18,34,49,17,118
4732,34,33,16,17,100
4733,34,17,16,17,84
4734,16,17,16,17,66
4736,16,17,16,18,67
4738,0,34,17,16,67
4739,18,33,15,18,84
4741,16,33,15,18,82
4742,0,33,15,18,66
4745,18,32,34,18,102
4746,16,16,34,18,84
4747,16,34,85,16,151
4748,34,34,51,16,135
4749,35,16,51,16,118
4750,34,32,19,16,101
4751,48,35,17,15,115
4752,32,35,17,15,99
4753,17,35,17,15,84
4755,16,32,18,16,82
4756,17,15,18,16,66
4757,33,16,18,16,83
4758,85,16,50,16,167
4759,67,16,50,16,149
4762,17,16,50,16,99
4763,16,33,17,16,82
4765,18,33,18,16,85
4766,17,16,18,16,67
4767,16,34,17,16,83
4768,18,16,17,16,67
4769,16,33,17,17,83
4770,82,19,16,17,134
4772,49,19,16,17,101
4773,32,19,16,17,84
4774,15,19,16,17,67
4775,19,33,15,17,84
4777,49,33,34,17,133
4778,32,33,34,17,116
4779,17,33,34,17,101
4781,16,34,17,17,84
4782,0,34,17,17,68
4783,15,34,34,15,98
4785,0,17,34,15,66
4787,18,31,33,19,101
4788,0,31,33,19,83
4792,19,16,15,17,67
4793,0,16,15,17,48
4795,17,34,33,18,102
4797,18,33,18,17,86
4798,33,35,16,18,102
4799,16,35,16,18,85
4800,18,17,16,18,69
4801,17,34,15,18,84
4802,34,33,13,20,100
4803,84,32,17,16,149
4806,33,32,17,16,98
4808,15,17,17,16,65
4809,34,16,18,16,84
4810,17,16,18,16,67
4811,34,16,17,17,84
4812,18,16,17,17,68
4813,33,17,16,17,83
4814,17,17,16,17,67
4819,34,14,18,18,84
4820,33,36,32,17,118
4821,32,18,32,17,99
4822,18,18,32,17,85
4825,17,33,33,18,101
4826,0,33,33,18,84
4827,16,33,18,17,84
4828,0,33,18,17,68
4831,17,33,16,16,82
4832,33,32,17,16,98
4833,17,32,17,16,82
4834,83,16,18,16,133
4835,67,16,18,16,117
4836,51,16,18,16,101
4837,34,16,18,16,84
4839,50,33,16,20,119
4840,34,33,16,20,103
4842,0,33,16,20,69
4843,16,36,114,16,182
4844,16,20,114,16,166
4845,20,32,82,16,150
4846,15,17,82,16,130
4847,17,32,50,16,115
4849,0,18,50,16,84
4851,99,17,17,16,149
4854,50,17,17,16,100
4855,34,17,17,16,84
4856,32,33,18,15,98
4857,17,33,18,15,83
4858,17,16,18,15,66
4859,16,33,18,17,84
4860,0,33,18,17,68
4861,15,35,17,15,82
4862,18,17,17,15,67
4863,17,32,18,15,82
4864,17,15,18,15,65
4865,33,15,18,17,83
4866,18,15,18,17,68
4870,17,15,19,14,65
4871,15,33,34,18,100
4872,0,33,34,18,85
4874,18,16,18,15,67
4875,16,33,17,17,83
4876,18,15,17,17,67
4877,15,34,17,16,82
4878,34,33,16,18,101
4880,17,16,16,18,67
4881,16,34,16,18,84
4887,14,36,84,32,166
4888,18,18,84,32,152
4889,18,33,51,32,134
4891,33,16,20,32,101
4893,16,20,16,16,68
4894,0,20,16,16,52
4895,16,32,17,16,81
4898,17,16,16,18,67
4901,18,33,35,14,100
4902,68,33,16,15,132
4903,53,33,16,15,117
4904,35,33,16,15,99
4905,19,33,16,15,83
4906,0,33,16,15,64
4907,19,31,17,18,85
4908,16,15,17,18,66
4909,15,35,16,18,84
4910,35,34,15,17,101
4911,18,34,15,17,84
4914,15,17,18,17,67
4915,35,17,31,17,100
4916,18,17,31,17,83
4917,17,31,34,17,99
4918,0,31,34,17,82
4920,17,17,17,17,68
4922,133,35,17,15,200
4924,99,35,17,15,166
4925,82,35,17,15,149
4926,66,35,17,15,133
4927,51,35,17,15,118
4928,33,35,17,15,100
4929,16,35,17,15,83
4930,16,19,17,15,67
4931,19,32,16,17,84
4933,31,17,17,18,83
4934,16,17,17,18,68
4935,17,35,16,16,84
4936,17,18,16,16,67
4937,18,32,16,17,83
4938,32,33,19,32,116
4942,0,19,15,17,51
4943,32,16,15,19,82
4944,17,16,15,19,67
4945,16,34,17,15,82
4946,15,19,17,15,66
4947,19,32,16,18,85
4948,17,15,16,18,66
4950,16,18,32,18,84
4952,17,15,18,16,66
4953,33,16,19,14,82
4954,134,34,15,18,201
4956,100,34,15,18,167
4957,81,34,15,18,148
4958,67,34,15,18,134
4959,48,34,15,18,115
4960,31,34,15,18,98
4961,15,34,15,18,82
4962,17,17,15,18,67
4963,17,33,16,18,84
4964,15,18,16,18,67
4965,34,18,15,18,85
4966,16,18,15,18,67
4968,0,33,116,19,168
4969,18,33,83,19,153
4970,16,17,83,19,135
4971,17,35,48,19,119
4972,35,31,17,19,102
4974,0,31,17,19,67
4978,32,33,85,15,165
4979,18,33,85,15,151
4980,16,17,85,15,133
4981,17,33,52,15,117
4982,17,16,52,15,100
4985,16,34,33,19,102
4986,19,15,33,19,86
4987,15,33,19,30,97
4988,82,19,16,17,134
4989,65,19,16,17,117
4991,30,19,16,17,82
4992,33,33,17,15,98
4995,34,15,32,19,100
4997,15,32,19,16,82
4999,15,35,17,16,83
5000,87,15,101,17,220
5003,35,15,101,17,168
5004,19,15,101,17,152
5006,16,18,67,17,118
5007,18,32,35,17,102
5008,0,32,35,17,84
5010,35,33,15,19,102
5013,0,16,15,19,50
5014,15,19,15,16,65
5015,19,31,18,16,84
5016,15,16,18,16,65
5019,16,33,33,17,99
5020,33,33,34,17,117
5021,82,33,17,17,149
5022,67,33,17,17,134
5023,50,33,17,17,117
5024,34,33,17,17,101
5026,17,16,17,17,67
5027,16,34,18,16,84
5028,17,17,18,16,68
5029,17,34,17,15,83
5030,18,16,17,15,66
5032,17,15,17,16,65
5033,15,33,86,32,166
5034,17,16,86,32,151
5035,36,47,19,32,134
5036,20,47,19,32,118
5037,14,33,19,32,98
5040,19,48,16,17,100
5042,17,16,16,17,66
5044,33,36,31,18,118
5045,17,36,31,18,102
5046,19,17,31,18,85
5047,17,31,84,15,147
5049,34,15,51,15,115
5050,18,15,51,15,99
5052,66,34,17,18,135
5053,48,34,17,18,117
5055,15,34,17,18,84
5057,15,35,15,20,85
5058,35,35,16,34,120
5060,15,20,16,34,85
5061,20,16,15,19,70
5062,16,34,81,16,147
5064,33,35,32,16,116
5065,14,35,32,16,97
5066,16,19,32,16,83
5067,19,32,16,17,84
5068,132,33,17,19,201
5070,100,33,17,19,169
5071,84,33,17,19,153
5072,67,33,17,19,136
5075,17,33,17,19,86
5076,69,32,15,17,133
5077,53,32,15,17,117
5078,50,18,15,17,100
5079,33,18,15,17,83
5080,14,18,15,17,64
5081,18,32,84,17,151
5083,68,15,18,17,118
5084,51,15,18,17,101
5085,33,15,18,17,83
5088,18,17,17,14,66
5090,17,14,36,17,84
5091,14,36,17,31,98
5092,36,17,50,16,119
5093,33,50,16,16,115
5094,17,50,16,16,99
5095,16,34,16,16,82
5096,15,19,16,16,66
5097,35,16,16,18,85
5098,16,16,16,18,66
5100,0,34,16,16,66
5101,34,16,34,18,102
5102,16,16,34,18,84
5103,16,34,18,15,83
5105,17,33,18,17,85
5108,66,34,35,16,151
5109,48,34,35,16,133
5110,31,34,35,16,116
5111,14,34,35,16,99
5113,17,35,34,32,118
5114,17,18,34,32,101
5116,16,18,15,17,66
5117,18,32,17,16,83
5118,0,32,17,16,65
5119,17,33,16,18,84
5124,16,16,16,19,67
5125,32,19,16,17,84
5126,35,33,15,18,101
5127,19,33,15,18,85
5129,17,33,16,17,83
5130,82,18,81,17,198
5133,33,18,81,17,149
5134,16,18,81,17,132
5135,18,32,49,17,116
5136,15,17,49,17,98
5137,17,19,30,17,83
5138,0,19,30,17,66
5139,30,17,18,15,80
5141,0,17,18,15,50
5142,18,15,21,32,86
5143,15,21,12,20,68
5144,102,31,36,16,185
5145,81,31,36,16,164
5146,69,31,36,16,152
5147,49,31,36,16,132
5148,35,31,36,16,118
5149,16,31,36,16,99
5150,17,14,36,16,83
5152,0,20,16,16,52
5154,34,31,17,18,100
5155,18,31,17,18,84
5156,31,35,83,15,164
5158,17,18,83,15,133
5161,16,32,18,15,81
5162,0,32,18,15,65
5164,0,33,17,16,66
5165,15,33,85,16,149
5166,0,33,85,16,134
5167,16,34,51,16,117
5168,34,20,31,16,101
5169,82,33,16,17,148
5170,67,33,16,17,133
5171,47,33,16,17,113
5172,32,33,16,17,98
5175,15,33,84,16,148
5176,0,33,84,16,133
5177,35,15,51,16,117
5179,15,34,17,16,82
5181,16,33,17,17,83
5182,17,16,17,17,67
5183,16,34,16,18,84
5184,0,34,16,18,68
5185,33,18,16,16,83
5187,18,32,19,18,87
5188,0,32,19,18,69
5189,16,37,80,16,149
5190,0,37,80,16,133
5191,18,32,48,16,114
5192,0,32,48,16,96
5193,19,33,15,16,83
5194,14,19,15,16,64
5196,31,36,16,16,99
5197,16,36,16,16,84
5198,17,19,16,16,68
5201,16,32,18,18,84
5202,0,32,18,18,68
5203,34,18,15,18,85
5204,18,18,15,18,69
5205,18,33,14,17,82
5206,0,33,14,17,64
5207,49,34,17,17,117
5208,82,17,16,16,131
5209,68,17,16,16,117
5210,51,17,16,16,100
5211,32,17,16,16,81
5213,17,32,17,17,83
5215,16,34,34,16,100
5216,17,17,34,16,84
5218,34,32,20,31,117
5219,15,32,20,31,98
5220,16,16,20,31,83
5222,36,31,17,18,102
5223,16,31,17,18,82
5225,0,16,17,18,51
5229,17,19,14,17,67
5231,14,36,15,16,81
5232,17,19,15,16,67
5233,0,19,15,16,50
5234,15,16,35,14,80
5235,16,35,14,19,84
5236,35,33,16,16,100
5238,14,19,16,16,65
5239,19,32,17,17,85
5240,16,16,17,17,66
5241,16,34,17,16,83
5243,17,33,17,17,84
5244,17,16,17,17,67
5247,17,35,16,16,84
5248,35,32,17,14,98
5249,18,32,17,14,81
5250,32,31,36,15,114
5252,17,14,36,15,82
5253,14,36,15,18,83
5256,33,35,14,16,98
5257,35,18,14,16,83
5258,17,18,14,16,65
5260,14,16,17,17,64
5261,33,17,32,19,101
5262,17,17,32,19,85
5265,16,35,17,16,84
5266,19,16,17,16,68
5267,16,33,49,18,116
5268,17,16,49,18,100
5269,16,33,16,18,83
5271,17,34,18,35,104
5272,16,18,18,35,87
5273,18,18,35,31,102
5274,33,20,13,18,84
5275,66,16,34,15,131
5276,51,16,34,15,116
5278,18,16,34,15,83
5279,33,17,15,17,82
5282,32,34,17,17,100
5283,17,34,17,17,85
5284,17,17,17,17,68
5286,17,17,16,17,67
5289,32,18,17,16,83
5290,33,33,16,18,100
5293,16,34,151,15,216
5294,16,18,151,15,200
5297,49,34,51,15,149
5298,34,34,51,15,134
5299,17,34,51,15,117
5300,116,17,18,16,167
5301,100,17,18,16,151
5302,82,17,18,16,133
5303,66,17,18,16,117
5305,48,34,17,17,116
5306,33,34,17,17,101
5307,17,34,17,17,85
5308,84,15,19,15,133
5310,50,15,19,15,99
5312,16,15,19,15,65
5313,15,34,34,16,99
5315,15,34,16,19,84
5316,102,32,16,19,169
5317,84,32,16,19,151
5318,68,32,16,19,135
5322,16,16,16,19,67
5323,32,19,81,18,150
5324,16,19,81,18,134
5325,19,33,48,18,118
5326,16,17,48,18,99
5327,17,33,15,18,83
5328,17,16,15,18,66
5329,16,33,16,16,81
5330,15,18,16,16,65
5333,16,34,34,16,100
5335,18,34,82,17,151
5336,0,34,82,17,133
5337,17,33,49,17,116
5338,0,33,49,17,99
5339,83,33,33,16,165
5340,66,33,33,16,148
5341,48,33,33,16,130
5342,135,32,16,18,201
5343,118,32,16,18,184
5346,68,32,16,18,134
5347,51,32,16,18,117
5348,35,32,16,18,101
5349,19,32,16,18,85
5350,17,15,16,18,66
5351,0,15,16,18,49
5353,36,15,18,17,86
5355,33,17,15,18,83
5357,17,33,15,18,83
5358,33,33,17,15,98
5359,18,33,17,15,83
5361,18,32,17,18,85
5362,17,15,17,18,67
5364,17,18,34,16,85
5366,0,34,16,15,65
5367,18,31,18,16,83
5368,16,15,18,16,65
5369,15,34,18,16,83
5371,16,34,17,16,83
5372,0,34,17,16,67
5374,0,33,16,18,67
5375,16,34,31,18,99
5378,0,31,18,18,67
5380,36,31,18,15,100
5382,0,31,18,15,64
5385,0,15,117,19,151
5387,17,35,48,19,119
5388,19,16,48,19,102
5389,32,17,15,19,83
5390,16,17,15,19,67
5393,34,17,16,17,84
5394,15,17,16,17,65
5395,17,33,16,18,84
5397,117,34,16,18,185
5400,66,34,16,18,134
5401,48,34,16,18,116
5402,82,18,150,17,267
5403,67,18,150,17,252
5406,34,32,118,17,201
5407,18,32,118,17,185
5408,0,32,118,17,167
5411,16,18,66,17,117
5412,18,49,17,17,101
5413,15,34,17,17,83
5415,0,16,17,17,50
5416,17,17,15,17,66
5417,17,32,33,16,98
5418,0,32,33,16,81
5419,17,33,16,18,84
5421,16,34,16,18,84
5422,16,18,16,18,68
5425,51,33,34,16,134
5426,33,33,34,16,116
5427,16,33,34,16,99
5428,33,34,16,16,99
5429,17,34,16,16,83
5431,18,32,85,16,151
5432,82,17,68,15,182
5433,66,17,68,15,166
5434,50,17,68,15,150
5435,32,17,68,15,132
5436,18,17,68,15,118
5438,83,18,15,17,133
5440,82,17,17,18,134
5442,48,17,17,18,100
5444,32,35,14,18,99
5447,18,32,34,16,100
5448,32,34,16,17,99
5449,18,34,16,17,85
5450,17,17,16,17,67
5451,17,33,33,16,99
5453,33,17,16,17,83
5454,33,33,16,17,99
5455,17,33,16,17,83
5456,16,17,16,17,66
5457,17,33,35,16,101
5458,84,17,32,19,152
5459,68,17,32,19,136
5460,51,17,32,19,119
5461,83,36,15,16,150
5462,65,36,15,16,132
5464,32,36,15,16,99
5465,15,36,15,16,82
5466,36,31,16,19,102
5467,17,31,16,19,83
5468,15,16,16,19,66
5469,16,35,33,17,101
5470,16,19,33,17,85
5473,18,32,18,16,84
5474,17,15,18,16,66
5476,0,34,15,17,66
5479,17,36,82,17,152
5480,84,17,17,17,135
5481,83,34,17,15,149
5482,65,34,17,15,131
5483,50,34,17,15,116
5486,84,15,18,16,133
5487,67,15,18,16,116
5488,50,15,18,16,99
5489,33,15,18,16,82
5490,18,15,18,16,67
5492,86,17,33,16,152
5493,68,17,33,16,134
5494,52,17,33,16,118
5495,35,17,33,16,101
5497,17,33,32,15,97
5498,0,33,32,15,80
5499,20,32,15,19,86
5500,16,16,15,19,66
5501,16,34,15,17,82
5502,34,32,18,15,99
5504,0,32,18,15,65
5505,17,33,18,16,84
5506,0,33,18,16,67
5508,18,16,16,19,69
5509,16,35,15,17,83
5512,15,17,17,16,65
5513,0,17,17,16,50
5516,17,17,16,18,68
5519,0,18,16,17,51
5521,17,33,82,17,149
5522,16,17,82,17,132
5523,17,32,50,17,116
5524,17,15,50,17,99
5525,49,33,17,18,117
5528,16,17,17,18,68
5531,34,15,17,18,84
5534,0,35,16,17,68
5537,17,33,32,19,101
5538,84,17,15,18,134
5539,66,17,15,18,116
5541,34,17,15,18,84
5543,17,33,33,15,98
5544,0,33,33,15,81
5545,34,17,15,18,84
5546,16,17,15,18,66
5547,17,33,16,18,84
5548,15,18,16,18,67
5549,34,18,15,18,85
5550,16,18,15,18,67
5551,33,18,16,16,83
5553,34,16,18,17,85
5554,16,16,18,17,67
5555,16,35,17,15,83
5556,18,17,17,15,67
5557,34,15,17,17,83
5558,82,17,18,16,133
5561,33,17,18,16,84
5563,35,16,33,17,101
5564,18,16,33,17,84
5565,31,18,17,17,83
5567,35,17,15,16,83
5568,17,17,15,16,65
5569,17,31,18,18,84
5571,16,36,15,17,84
5572,18,18,15,17,68
5573,18,32,18,17,85
5574,15,17,18,17,67
5577,31,18,19,30,98
5578,14,18,19,30,81
5580,0,19,14,16,49
5582,16,17,17,18,68
5584,17,18,14,17,66
5587,17,36,15,17,85
5588,36,32,16,17,101
5589,19,32,16,17,84
5590,0,32,16,17,65
5593,0,17,16,19,52
5594,16,19,15,16,66
5595,19,31,83,17,150
5599,19,33,15,17,84
5600,16,17,15,17,65
5601,17,32,18,16,83
5602,0,32,18,16,66
5604,0,34,17,18,69
5605,16,35,82,17,150
5608,17,14,51,17,99
5610,0,34,34,14,82
5611,33,17,14,19,83
5613,17,33,17,15,82
5614,14,19,17,15,65
5615,19,32,17,17,85
5618,17,17,33,17,84
5620,0,33,17,18,68
5621,98,18,32,18,166
5622,83,18,32,18,151
5623,66,18,32,18,134
5625,33,18,32,18,101
5626,15,18,32,18,83
5629,34,18,33,16,101
5630,18,18,33,16,85
5631,18,33,16,16,83
5632,33,32,16,19,100
5633,33,16,16,19,84
5635,16,35,16,15,82
5637,19,31,86,31,167
5638,16,15,86,31,148
5640,0,35,51,31,117
5641,16,33,18,31,98
5642,16,17,18,31,82
5643,35,47,18,16,116
5644,18,47,18,16,99
5645,14,33,18,16,81
5646,85,15,33,17,150
5648,85,15,17,17,134
5652,18,15,17,17,67
5653,15,34,33,16,98
5654,17,17,33,16,83
5655,17,33,16,17,83
5657,16,33,17,16,82
5658,16,17,17,16,66
5661,16,36,33,15,100
5663,35,17,15,16,83
5664,16,17,15,16,64
5665,17,31,17,18,83
5666,0,31,17,18,66
5667,16,35,18,17,86
5668,35,35,32,14,116
5669,18,35,32,14,99
5671,17,32,14,17,80
5672,14,18,14,17,63
5673,18,31,18,18,85
5675,0,17,18,18,53
5677,18,33,16,17,84
5678,15,18,16,17,66
5679,18,33,34,15,100
5680,67,33,15,19,134
5681,51,33,15,19,118
5682,34,33,15,19,101
5684,0,33,15,19,67
5686,15,19,33,16,83
5687,19,33,16,18,86
5689,34,18,14,17,83
5690,16,18,14,17,65
5691,49,34,17,16,116
5693,17,34,17,16,84
5695,16,33,33,17,99
5697,16,33,17,16,82
5698,17,16,17,16,66
5699,84,34,14,19,151
5700,68,34,14,19,135
5703,17,34,14,19,84
5704,17,17,14,19,67
5705,17,33,16,17,83
5706,14,19,16,17,66
5707,35,17,17,16,85
5708,16,17,17,16,66
5709,83,34,82,17,216
5710,83,17,82,17,199
5712,84,16,49,17,166
5713,67,16,49,17,149
5715,34,16,49,17,116
5716,17,16,49,17,99
5717,16,33,33,16,98
5719,18,33,16,19,86
5721,101,16,17,15,149
5722,84,16,17,15,132
5723,68,16,17,15,116
5724,49,16,17,15,97
5729,84,34,50,15,183
5731,50,34,50,15,149
5732,34,34,50,15,133
5733,18,34,50,15,117
5736,16,15,34,17,82
5737,34,15,17,17,83
5738,19,15,17,17,68
5739,15,34,16,18,83
5741,33,18,16,18,85
5742,68,33,15,16,132
5743,52,33,15,16,116
5744,34,33,15,16,98
5746,0,33,15,16,64
5748,31,33,18,17,99
5751,16,35,16,17,84
5752,18,17,16,17,68
5753,17,33,18,16,84
5755,17,34,16,17,84
5756,0,34,16,17,67
5757,32,17,16,16,81
5758,16,17,16,16,65
5759,33,16,17,18,84
5760,83,18,14,19,134
5763,34,18,14,19,85
5765,32,19,32,17,100
5766,14,19,32,17,82
5767,34,17,17,18,86
5768,15,17,17,18,67
5769,34,18,16,15,83
5770,17,18,16,15,66
5773,32,18,17,16,83
5774,17,18,17,16,68
5778,15,18,18,16,67
5783,15,35,16,16,82
5784,35,32,16,19,102
5785,18,32,16,19,85
5786,16,16,16,19,67
5787,16,35,14,20,85
5788,16,19,14,20,69
5789,19,34,14,17,84
5791,20,31,18,16,85
5792,14,17,18,16,65
5793,17,34,18,16,85
5794,18,16,18,16,68
5795,34,16,16,16,82
5796,18,16,16,16,66
5797,32,16,17,17,82
5798,32,34,16,17,99
5799,16,34,16,17,83
5800,34,33,18,14,99
5801,17,33,18,14,82
5802,33,32,34,17,116
5803,17,32,34,17,100
5804,101,34,15,20,170
5805,83,34,15,20,152
5806,69,34,15,20,138
5807,51,34,15,20,120
5808,35,34,15,20,104
5809,18,34,15,20,87
5811,33,20,13,18,84
5813,20,31,16,16,83
5816,133,34,48,18,233
5817,117,34,48,18,217
5818,101,34,48,18,201
5819,84,34,48,18,184
5820,67,34,48,18,167
5821,51,34,48,18,151
5823,18,34,48,18,118
5824,67,33,16,16,132
5826,33,33,16,16,98
5827,17,33,16,16,82
5828,0,33,16,16,65
5829,100,17,17,18,152
5830,82,17,17,18,134
5831,66,17,17,18,118
5832,50,17,17,18,102
5834,15,17,17,18,67
5835,17,35,16,16,84
5836,17,18,16,16,67
5840,0,34,16,17,67
5842,33,33,16,17,99
5843,17,33,16,17,83
5844,18,15,16,17,66
5845,31,17,18,16,82
5846,33,34,15,17,99
5848,34,32,17,17,100
5849,31,17,17,17,82
5850,15,17,17,17,66
5854,83,17,18,17,135
5856,83,17,16,17,133
5857,68,17,16,17,118
5858,52,17,16,17,102
5859,35,17,16,17,85
5860,18,17,16,17,68
5861,0,17,16,17,50
5862,0,33,15,18,66
5863,32,18,16,16,82
5864,15,18,16,16,65
5865,18,32,18,16,84
5866,16,16,18,16,66
5867,16,34,84,17,151
5868,18,16,84,17,135
5869,16,34,50,17,117
5870,17,17,50,17,101
5871,17,33,17,17,84
5872,15,18,17,17,67
5874,0,34,17,14,65
5875,17,31,19,16,83
5876,0,31,19,16,66
5877,14,35,16,16,81
5880,16,16,85,17,134
5881,33,18,50,17,118
5882,17,18,50,17,102
5883,18,34,16,17,85
5884,0,34,16,17,67
5885,0,18,16,17,51
5886,16,17,17,17,67
5888,51,14,85,16,166
5889,34,14,85,16,149
5890,17,14,85,16,132
5891,32,17,50,16,115
5892,18,17,50,16,101
5893,17,34,16,16,83
5894,34,32,16,17,99
5896,32,33,18,17,100
5897,16,33,18,17,84
5898,16,17,18,17,68
5899,83,34,83,17,217
5900,66,34,83,17,200
5901,48,34,83,17,182
5902,31,34,83,17,165
5903,16,34,83,17,150
5904,18,16,83,17,134
5905,16,32,51,17,116
5906,83,17,17,18,135
5907,67,17,17,18,119
5909,34,17,17,18,86
5910,16,17,17,18,68
5911,17,35,16,16,84
5912,0,35,16,16,67
5914,16,16,16,17,65
5918,15,19,15,17,66
5919,19,32,16,17,84
5920,32,33,18,16,99
5922,0,33,18,16,67
5923,17,34,17,16,84
5924,34,33,35,15,117
5926,0,33,35,15,83
5927,66,17,18,16,117
5928,50,17,18,16,101
5930,15,17,18,16,66
5931,17,34,33,17,101
5935,17,33,16,18,84
5936,17,16,16,18,67
5937,16,34,16,17,83
5938,16,18,16,17,67
5941,17,32,18,16,83
5942,17,15,18,16,66
5945,66,16,19,16,117
5946,50,16,19,16,101
5947,33,16,19,16,84
5948,16,16,19,16,67
5949,16,35,32,18,101
5951,48,35,16,18,117
5952,32,35,16,18,101
5953,16,35,16,18,85
5954,18,17,16,18,69
5956,16,18,15,16,65
5957,18,31,17,18,84
5959,16,35,34,16,101
5960,0,35,34,16,85
5961,18,34,16,17,85
5962,0,34,16,17,67
5963,19,33,17,16,85
5964,16,17,17,16,66
5967,33,16,35,33,117
5970,35,33,15,17,100
5971,19,33,15,17,84
5973,84,33,18,16,151
5974,65,33,18,16,132
5976,33,33,18,16,100
5978,16,17,18,16,67
5979,35,16,33,16,100
5980,18,16,33,16,83
5981,16,33,16,17,82
5982,33,33,118,17,201
5983,18,33,118,17,186
5985,17,34,84,17,152
5986,17,17,84,17,135
5987,82,36,14,18,150
5988,65,36,14,18,133
5989,49,36,14,18,117
5990,33,36,14,18,101
5992,19,17,14,18,68
5993,17,32,17,15,81
5994,14,18,17,15,64
5995,18,32,17,17,84
5996,32,34,16,18,100
5997,15,34,16,18,83
