序号,发送->接收,接收->转发,转发->接收,接收->处理,总计
2,0,40,17,17,74
3,34,34,66,16,150
4,0,16,17,17,50
5,0,34,66,16,116
7,0,33,0,17,50
8,17,33,133,16,199
9,0,33,133,16,182
11,16,17,50,17,100
12,0,17,50,17,84
13,21,12,50,17,100
14,12,34,16,17,79
16,17,33,16,17,83
17,33,33,18,17,101
20,0,17,18,17,52
21,35,32,0,16,83
22,17,32,0,16,65
23,0,32,0,16,48
24,16,34,0,16,66
25,0,34,0,16,50
26,18,33,17,16,84
27,0,33,17,16,66
30,16,33,0,17,66
31,33,34,16,18,101
33,17,17,16,18,68
35,0,34,32,18,84
36,18,32,0,18,68
39,0,35,16,15,66
40,0,17,16,15,48
41,0,31,34,18,83
42,15,34,0,18,67
43,34,35,0,16,85
44,16,35,0,16,67
45,0,35,0,16,51
46,0,17,0,16,33
47,0,32,0,17,49
48,0,16,0,17,33
49,0,34,0,16,50
50,0,17,0,16,33
52,0,18,0,15,33
53,0,32,18,16,66
55,0,34,84,15,133
56,0,16,84,15,115
57,0,32,52,15,99
58,0,16,52,15,83
59,0,35,17,15,67
61,32,34,0,18,84
64,0,17,0,18,35
66,19,30,0,17,66
67,0,30,0,17,47
68,18,35,48,17,118
70,0,18,48,17,83
71,0,31,34,17,82
73,0,34,0,17,51
74,17,32,0,18,67
75,0,32,0,18,50
76,15,35,0,18,68
77,0,35,0,18,53
78,0,17,0,18,35
80,0,15,0,17,32
81,0,32,17,17,66
83,0,34,0,17,51
86,0,17,0,16,33
87,0,34,0,14,48
89,0,31,19,15,65
90,0,17,19,15,51
91,68,34,0,16,118
92,15,34,18,16,83
94,52,32,0,16,100
95,0,34,0,16,50
97,0,32,0,16,48
100,0,19,0,15,34
101,0,32,17,16,65
102,0,17,17,16,50
103,0,33,33,17,83
106,0,16,0,17,33
107,17,16,35,15,83
108,16,35,0,15,66
109,68,34,0,17,119
110,17,33,0,17,67
111,15,18,0,17,50
112,0,18,0,17,35
115,0,34,0,14,48
117,31,33,0,17,81
118,0,17,0,18,35
119,0,33,0,17,50
120,0,15,0,17,32
121,0,34,0,17,51
123,0,34,0,17,51
127,0,34,0,15,49
128,31,17,0,17,65
129,0,32,0,17,49
130,0,17,0,17,34
131,17,16,17,17,67
132,0,16,17,17,50
133,0,34,16,17,67
135,16,17,16,17,66
136,17,33,0,16,66
137,0,33,0,16,49
138,17,33,17,17,84
140,0,17,17,17,51
141,0,34,16,18,68
142,17,34,49,16,116
143,0,34,49,16,99
144,18,32,17,16,83
146,17,33,18,16,84
151,0,32,36,17,85
152,15,36,17,15,83
153,0,36,17,15,68
154,17,32,17,16,82
156,0,15,17,16,48
157,0,33,0,18,51
158,16,35,0,15,66
159,18,17,0,15,50
161,0,32,17,27,76
162,0,17,17,27,61
163,17,27,0,22,66
164,27,22,18,16,83
165,0,22,18,16,56
166,18,34,16,18,86
167,0,34,16,18,68
169,0,34,18,15,67
170,18,33,49,17,117
171,18,15,49,17,99
172,32,16,16,17,81
173,0,33,16,17,66
175,0,33,17,17,67
176,0,17,17,17,51
177,0,34,17,16,67
181,0,34,17,15,66
182,0,16,17,15,48
183,0,32,36,14,82
185,0,36,65,17,118
186,17,32,0,15,64
189,0,33,34,16,83
190,0,18,34,16,68
191,17,17,0,16,50
192,33,16,16,18,83
193,0,32,16,18,66
194,50,35,0,15,100
196,18,35,0,15,68
198,18,32,67,18,135
199,0,32,67,18,117
201,0,32,0,18,50
203,0,35,49,18,102
204,17,33,16,18,84
205,0,33,16,18,67
206,0,15,16,18,49
207,34,32,17,16,99
208,18,32,17,16,83
209,32,33,17,17,99
210,17,33,17,17,84
211,33,34,18,14,99
212,50,32,18,17,117
214,17,32,18,17,84
216,14,35,16,16,81
220,16,34,17,17,84
221,34,34,15,18,101
223,0,34,15,18,67
224,17,33,33,16,99
225,33,33,16,17,99
226,18,33,16,17,84
228,17,33,18,17,85
229,0,33,18,17,68
231,0,35,15,18,68
232,17,33,17,20,87
234,18,37,12,16,83
235,0,37,12,16,65
237,0,28,18,16,62
239,0,34,17,17,68
241,0,34,0,16,50
242,0,17,0,16,33
243,0,33,50,17,100
245,0,33,17,17,67
246,17,34,16,17,84
247,0,34,16,17,67
249,0,33,67,16,116
251,0,34,17,16,67
254,16,33,16,18,83
255,49,18,15,18,100
256,0,17,16,18,51
257,34,33,66,18,151
258,18,33,66,18,135
260,0,18,66,18,102
263,18,15,0,18,51
264,15,35,0,14,64
265,0,35,0,14,49
267,0,32,0,17,49
269,0,33,0,16,49
270,0,16,0,16,32
271,16,17,0,17,50
272,0,17,0,17,34
274,0,16,0,17,33
277,18,15,0,17,50
278,15,33,0,17,65
280,0,16,0,17,33
281,17,18,16,17,68
282,0,18,16,17,51
283,16,17,16,18,67
284,0,17,16,18,51
285,16,18,15,17,66
289,32,36,16,17,101
290,15,36,16,17,84
293,0,33,16,17,66
294,0,17,16,17,50
295,33,34,98,18,183
296,17,34,98,18,167
297,0,34,98,18,150
298,17,31,18,17,83
299,0,31,18,17,66
301,0,35,50,16,101
302,17,32,18,16,83
303,32,34,18,15,99
306,0,16,18,15,49
309,0,35,16,16,67
310,0,18,16,16,50
311,0,32,17,17,66
312,0,16,17,17,50
313,0,34,17,15,66
314,17,32,18,16,83
315,0,32,18,16,66
318,16,33,0,17,66
319,33,33,0,18,84
320,68,16,33,17,134
321,0,33,0,18,51
322,0,16,0,18,34
324,0,16,33,17,66
325,0,33,101,16,150
326,32,18,0,17,67
327,17,18,0,17,52
328,0,18,0,17,35
329,0,33,64,18,115
331,0,33,31,18,82
333,0,31,0,18,49
334,0,15,0,18,33
335,0,35,101,15,151
337,0,34,0,16,50
339,16,17,16,18,67
343,0,32,32,18,82
344,0,17,32,18,67
345,17,15,0,18,50
346,15,36,16,17,84
347,0,36,16,17,69
348,0,18,16,17,51
350,17,33,66,18,134
351,0,33,66,18,117
354,16,33,34,17,100
355,0,33,34,17,84
358,0,16,0,17,33
360,0,17,0,16,33
362,0,17,0,17,34
365,49,17,18,15,99
366,16,33,18,15,82
367,0,33,18,15,66
369,33,36,0,15,84
372,18,33,0,14,65
373,0,33,0,14,47
374,0,18,0,14,32
375,0,31,34,18,83
376,51,34,17,15,117
377,0,34,0,18,52
378,17,34,17,15,83
381,17,15,52,16,100
382,50,33,17,16,116
385,0,33,17,16,66
386,16,33,16,17,82
390,17,33,0,17,67
393,0,34,0,16,50
394,0,17,0,16,33
397,0,33,83,17,133
398,16,34,18,15,83
401,18,15,16,17,66
402,15,33,17,17,82
403,0,33,17,17,67
404,17,34,0,17,68
405,0,34,0,17,51
406,17,33,0,16,66
407,0,33,0,16,49
409,67,34,16,17,134
410,0,18,16,17,51
412,17,34,16,17,84
413,34,33,0,17,84
415,16,17,0,17,50
416,17,33,0,16,66
417,0,33,0,16,49
418,0,16,0,16,32
419,0,33,0,17,50
420,17,33,33,18,101
421,0,33,33,18,84
422,0,16,33,18,67
424,15,34,17,17,83
425,0,34,17,17,68
427,0,34,33,17,84
429,0,33,0,17,50
430,17,33,0,16,66
431,0,33,0,16,49
433,0,34,50,17,101
434,51,34,33,16,134
435,0,33,17,17,67
437,17,17,33,16,83
438,17,33,49,17,116
439,0,33,49,17,99
442,33,17,16,18,84
444,17,34,0,17,68
445,0,34,0,17,51
446,18,32,0,17,67
447,0,32,0,17,49
448,15,34,0,16,65
450,0,17,0,16,33
451,0,33,16,18,67
453,16,18,0,16,50
456,0,17,18,15,50
457,0,33,18,16,67
460,0,16,16,17,49
461,33,34,17,16,100
462,17,34,17,16,84
463,0,34,17,16,67
464,35,16,0,16,67
467,0,33,0,16,49
468,0,17,0,16,33
469,0,33,18,16,67
470,0,17,18,16,51
471,0,34,16,17,67
472,0,16,16,17,49
473,16,17,0,18,51
474,17,33,17,17,84
475,0,33,17,17,67
476,0,15,17,17,49
477,0,34,50,16,100
478,17,33,17,16,83
479,0,33,17,16,66
480,17,33,17,16,83
482,16,33,18,16,83
483,33,34,0,17,84
484,16,34,0,17,67
485,0,34,0,17,51
486,16,33,18,17,84
488,16,35,32,18,101
490,0,17,32,18,67
492,17,34,0,15,66
493,0,34,0,15,49
494,0,16,0,15,31
495,33,33,0,16,82
497,0,33,0,16,49
499,0,33,0,17,50
500,0,17,0,17,34
502,0,18,15,17,50
503,66,33,33,18,150
504,17,34,66,18,135
506,17,33,33,18,101
508,50,33,16,19,118
509,0,33,0,18,51
511,0,33,16,19,68
514,19,33,16,15,83
515,0,33,16,15,64
516,0,16,16,15,47
517,16,15,0,18,49
518,15,35,50,17,117
519,0,35,50,17,102
523,17,17,0,16,50
524,17,34,15,17,83
525,0,34,15,17,66
526,0,18,15,17,50
527,32,33,17,17,99
528,17,33,17,17,84
529,0,33,17,17,67
531,0,34,101,15,150
532,0,17,101,15,133
533,0,34,15,17,66
534,18,32,18,17,85
536,0,17,18,17,52
538,0,17,15,17,49
539,0,32,17,17,66
541,0,34,15,18,67
542,17,33,17,15,82
544,0,18,17,15,50
545,0,32,18,17,67
546,15,35,16,17,83
548,0,17,16,17,50
552,18,35,0,14,67
553,0,35,0,14,49
554,0,19,0,14,33
555,14,19,0,15,48
556,0,19,0,15,34
558,18,33,49,17,117
559,0,33,49,17,99
560,18,32,51,17,118
563,0,34,17,17,68
565,0,34,17,16,67
566,17,33,49,18,117
567,0,33,49,18,100
568,16,33,16,18,83
569,0,33,16,18,67
570,33,18,32,17,100
571,34,32,51,17,134
574,17,34,67,16,134
575,17,17,67,16,117
576,0,17,67,16,100
577,34,33,0,16,83
578,17,33,0,16,66
579,16,17,0,16,49
581,16,17,17,17,67
582,51,32,0,18,101
583,0,34,16,16,66
584,0,17,16,16,49
587,0,35,0,15,50
588,0,17,0,15,32
589,0,32,17,16,65
590,0,17,17,16,50
591,33,34,183,17,267
594,17,33,0,17,67
595,0,33,0,17,50
596,0,17,0,17,34
597,0,33,17,17,67
598,0,16,17,17,50
599,0,34,17,17,68
600,0,17,17,17,51
601,0,34,49,17,100
603,0,33,16,17,66
604,17,33,17,17,84
605,16,17,17,17,67
606,0,17,17,17,51
607,0,34,15,17,66
608,17,32,17,17,83
609,0,32,17,17,66
610,17,34,17,17,85
612,17,34,0,16,67
613,0,34,0,16,50
614,17,34,16,15,82
615,16,18,16,15,65
616,0,18,16,15,49
619,0,35,16,18,69
620,0,17,16,18,51
622,18,32,0,17,67
624,0,17,0,17,34
626,0,16,35,15,66
627,0,35,15,18,68
628,17,33,32,18,100
630,0,18,32,18,68
631,0,32,35,16,83
632,16,35,33,17,101
633,0,35,33,17,85
636,0,17,0,17,34
638,0,15,0,17,32
639,0,33,0,17,50
640,0,16,0,17,33
641,0,35,32,17,84
642,0,18,32,17,67
643,0,32,0,17,49
645,0,34,34,15,83
646,0,17,34,15,66
647,34,32,0,17,83
649,0,32,0,17,49
650,51,33,0,17,101
653,0,33,0,17,50
655,0,34,0,16,50
656,17,33,17,17,84
658,34,17,0,15,66
660,50,34,16,17,117
661,0,33,17,17,67
662,18,34,16,17,85
666,17,33,51,15,116
667,66,33,17,15,131
668,0,18,51,15,84
669,17,16,18,15,66
672,0,15,17,15,47
674,15,34,17,17,83
676,48,33,18,16,115
677,0,34,33,18,85
678,17,33,18,16,84
679,0,33,18,16,67
680,34,16,17,16,83
684,0,16,0,17,33
686,0,17,16,16,49
687,0,32,17,17,66
688,16,34,68,15,133
690,17,34,16,18,85
691,0,34,16,18,68
692,17,34,33,17,101
693,0,34,33,17,84
694,18,33,17,16,84
695,0,33,17,16,66
698,0,16,18,15,49
699,0,33,34,15,82
700,15,34,34,15,98
701,0,34,34,15,83
702,0,18,34,15,67
703,0,34,0,15,49
705,0,33,0,15,48
707,0,31,19,17,67
708,0,16,19,17,52
709,36,31,35,15,117
710,17,31,35,15,98
714,17,32,17,18,84
717,0,35,17,15,67
718,0,18,17,15,50
719,0,32,18,15,65
720,65,17,16,17,115
721,0,33,0,17,50
722,0,15,0,17,32
723,0,34,16,17,67
724,0,17,16,17,50
725,16,17,18,17,68
726,0,17,18,17,52
728,17,32,50,17,116
729,0,32,50,17,99
730,17,33,17,17,84
731,33,34,16,17,100
732,15,34,16,17,82
734,17,33,51,17,118
735,0,33,51,17,101
737,0,34,51,14,99
738,17,34,50,17,118
739,0,34,50,17,101
741,0,31,84,17,132
742,14,36,48,17,115
743,0,36,48,17,101
744,0,17,48,17,82
745,0,31,17,17,65
746,50,32,18,17,117
747,34,32,18,17,101
748,17,32,18,17,84
749,0,32,18,17,67
751,0,35,34,15,84
753,0,34,15,17,66
754,17,32,17,16,82
755,0,32,17,16,65
757,0,33,18,15,66
758,83,34,33,17,167
759,67,34,33,17,151
760,0,15,18,16,49
761,0,34,18,16,68
762,16,34,33,17,100
764,0,16,33,17,66
766,33,17,49,17,116
768,0,17,49,17,83
769,32,34,17,17,100
770,32,17,17,17,83
771,101,34,17,15,167
772,0,17,17,17,51
774,17,33,17,17,84
776,17,34,17,15,83
777,0,34,17,15,66
778,17,32,18,16,83
779,0,32,18,16,66
780,33,16,17,17,83
783,0,34,32,18,84
784,17,32,18,15,82
785,0,32,18,15,65
786,20,33,17,17,87
787,33,34,0,17,84
788,0,15,17,17,49
789,0,34,0,17,51
790,101,17,16,17,151
791,0,32,52,17,101
793,0,35,17,17,69
794,0,17,17,17,51
795,34,33,16,17,100
796,17,33,16,17,83
797,0,33,16,17,66
798,17,33,16,17,83
800,17,33,51,17,118
801,0,33,51,17,101
803,84,16,84,17,201
804,0,18,17,17,52
805,17,17,16,16,66
806,17,32,84,17,150
808,16,33,18,16,83
809,33,34,49,17,133
810,0,16,18,16,50
812,0,16,49,17,82
814,0,17,15,17,49
816,17,34,33,17,101
817,0,34,33,17,84
818,17,33,0,17,67
819,0,33,0,17,50
820,15,34,0,17,66
822,0,17,0,17,34
823,0,34,0,16,50
825,0,31,35,15,81
826,0,15,35,15,65
827,35,32,0,18,85
828,16,32,0,18,66
830,0,17,0,18,35
831,18,16,0,17,51
832,0,16,0,17,33
833,17,15,18,17,67
836,17,34,65,16,132
837,0,34,65,16,115
839,0,33,17,15,65
840,16,32,0,16,64
843,16,18,0,18,52
844,0,18,0,18,36
845,0,33,17,16,66
847,0,33,0,18,51
848,16,35,0,15,66
850,0,17,0,15,32
851,0,32,17,16,65
852,0,17,17,16,50
854,16,35,0,15,66
855,0,35,0,15,50
858,0,16,18,16,50
859,34,35,0,15,84
860,16,35,0,15,66
861,0,35,0,15,50
862,17,33,15,17,82
863,15,18,15,17,65
864,50,34,67,17,168
866,17,34,67,17,135
867,0,34,67,17,118
868,17,33,34,17,101
870,0,15,34,17,66
871,0,34,0,17,51
872,17,32,17,17,83
873,0,32,17,17,66
875,34,34,17,15,100
876,17,34,17,15,83
877,0,34,17,15,66
879,0,32,17,16,65
881,0,33,19,16,68
883,0,35,16,16,67
885,67,32,35,17,151
887,0,35,16,16,67
888,0,18,16,16,50
889,0,32,35,17,84
891,0,35,0,17,52
893,0,33,16,16,65
894,0,16,16,16,48
897,17,17,34,15,83
898,0,17,34,15,66
902,0,17,0,17,34
903,0,36,97,17,150
904,0,19,97,17,133
905,0,32,15,18,65
906,18,33,17,15,83
908,18,32,50,17,117
913,0,33,0,17,50
914,17,35,0,15,67
915,0,35,0,15,50
916,0,18,0,15,33
917,0,32,0,17,49
921,0,33,0,16,49
922,17,33,0,17,67
923,0,33,0,17,50
925,17,17,0,16,50
926,0,17,0,16,33
927,0,32,0,18,50
928,0,16,0,18,34
929,52,15,100,17,184
930,15,34,100,17,166
931,19,15,100,17,151
932,15,35,0,15,65
935,0,33,16,16,65
936,0,18,16,16,50
939,17,17,33,16,83
940,17,33,51,16,117
942,17,34,17,16,84
944,51,34,16,16,117
945,33,34,16,16,99
946,16,34,16,16,82
948,17,32,18,16,83
949,0,32,18,16,66
950,16,34,17,16,83
951,34,33,0,17,84
954,0,16,0,17,33
955,0,36,0,14,50
956,0,19,0,14,33
957,31,33,33,18,115
958,0,17,33,17,67
960,0,16,33,18,67
962,0,16,0,18,34
963,0,33,68,17,118
964,182,34,49,17,282
965,0,33,0,19,52
966,16,35,0,17,68
967,0,35,0,17,52
968,0,16,0,17,33
969,133,34,32,18,217
970,17,32,51,16,116
971,48,17,18,16,99
973,0,33,18,16,67
974,35,16,49,17,117
978,17,32,0,18,67
980,17,35,16,15,83
983,0,31,36,16,83
984,0,15,36,16,67
986,33,15,18,15,81
989,0,33,0,18,51
990,15,35,16,17,83
991,0,35,16,17,68
992,0,17,16,17,50
993,16,17,34,15,82
994,17,34,49,17,117
995,100,34,15,18,167
996,0,17,49,17,83
999,0,32,17,17,66
1001,0,34,15,18,67
1002,50,32,18,17,117
1003,0,33,16,16,65
1005,0,32,18,17,67
1006,0,16,18,17,51
1007,0,35,15,17,67
1008,182,34,34,16,266
1010,17,33,0,18,68
1012,17,32,19,17,85
1013,0,32,19,17,68
1014,50,32,51,17,150
1015,0,36,18,14,68
1016,17,32,51,17,117
1017,83,17,34,15,149
1018,31,17,34,16,98
1019,0,34,34,16,84
1020,0,17,34,16,67
1022,17,34,49,16,116
1023,0,34,49,16,99
1024,0,18,49,16,83
1025,0,33,16,16,65
1026,0,18,16,16,50
1027,16,16,0,16,48
1028,16,33,35,16,100
1029,33,35,0,16,84
1030,0,17,35,16,68
1031,0,35,0,16,51
1032,32,16,0,17,65
1033,0,32,0,17,49
1034,0,16,0,17,33
1035,33,33,0,17,83
1036,0,16,33,17,66
1037,0,33,0,17,50
1038,15,34,0,17,66
1039,17,17,0,17,51
1040,0,17,0,17,34
1041,0,34,0,17,51
1042,0,17,0,17,34
1043,17,16,17,17,67
1046,17,33,0,17,67
1048,51,32,0,17,100
1049,66,35,0,15,116
1051,0,32,0,17,49
1052,15,35,0,15,65
1053,0,35,0,15,50
1054,0,18,0,15,33
1055,0,32,0,18,50
1056,100,17,0,17,134
1057,18,15,0,17,50
1061,0,33,0,17,50
1062,0,17,0,17,34
1064,33,17,0,17,67
1066,17,34,49,18,118
1068,0,17,49,18,84
1069,0,32,17,18,67
1070,17,35,17,15,84
1071,0,35,17,15,67
1072,18,32,19,15,84
1074,0,15,19,15,49
1075,34,34,0,15,83
1076,15,34,0,15,64
1078,68,16,0,16,100
1079,0,32,84,16,132
1080,0,17,84,16,117
1082,16,33,33,16,98
1083,0,33,33,16,82
1084,17,33,0,16,66
1085,17,16,0,16,49
1086,16,33,0,17,66
1087,50,16,84,18,168
1088,0,17,0,17,34
1090,0,16,84,18,118
1094,16,35,15,17,83
1095,0,35,15,17,67
1096,18,32,18,16,84
1098,17,34,16,16,83
1101,0,32,18,17,67
1102,0,16,18,17,51
1103,35,33,16,17,101
1104,17,33,16,17,83
1105,133,34,16,17,200
1106,17,33,17,16,83
1107,0,33,17,16,66
1108,17,33,68,16,134
1109,0,33,68,16,117
1110,16,34,50,17,117
1113,0,34,16,17,67
1114,17,33,15,17,82
1115,0,33,15,17,65
1116,0,17,15,17,49
1117,0,32,17,17,66
1119,0,34,49,17,100
1120,0,17,49,17,83
1121,0,34,48,17,99
1122,50,33,17,16,116
1123,0,32,16,17,65
1124,17,33,17,16,83
1125,0,33,17,16,66
1126,0,17,17,16,50
1128,34,17,16,17,84
1129,0,35,16,17,68
1130,0,17,16,17,50
1133,0,33,17,16,66
1134,16,33,17,21,87
1135,0,33,17,21,71
1137,17,21,12,18,68
1139,0,30,16,17,63
1140,18,33,17,16,84
1142,0,17,17,16,50
1143,0,33,16,17,66
1144,0,16,16,17,49
1145,0,33,0,17,50
1146,17,33,68,15,133
1147,0,33,68,15,116
1154,17,34,17,16,84
1157,0,33,16,17,66
1158,0,16,16,17,49
1159,33,34,0,17,84
1160,17,34,0,17,68
1161,0,34,0,17,51
1164,0,17,50,15,82
1168,0,15,18,18,51
1171,0,31,17,17,65
1173,0,34,34,17,85
1176,17,32,18,16,83
1177,0,32,18,16,66
1178,0,15,18,16,49
1179,0,34,18,16,68
1180,16,34,15,17,82
1182,16,32,51,16,115
1183,0,32,51,16,99
1185,0,34,17,16,67
1187,17,16,17,17,67
1189,0,34,33,17,84
1191,0,33,0,17,50
1192,17,35,48,17,117
1193,17,18,48,17,100
1195,0,31,17,17,65
1196,0,17,17,17,51
1197,0,34,16,18,68
1198,17,34,15,16,82
1199,0,34,15,16,65
1201,49,17,0,16,82
1202,0,16,18,17,51
1203,51,17,50,17,135
1204,17,33,50,17,117
1205,116,18,16,16,166
1206,0,17,50,17,84
1208,49,34,16,16,115
1209,16,17,50,16,99
1210,17,34,16,16,83
1211,0,34,16,16,66
1213,0,32,17,17,66
1216,0,17,0,17,34
1217,0,33,49,17,99
1218,0,16,49,17,82
1219,0,35,14,17,66
1220,17,31,0,19,67
1221,0,31,0,19,50
1223,19,16,0,16,51
1224,0,16,0,16,32
1225,16,17,0,16,49
1226,0,17,0,16,33
1228,0,17,34,15,66
1229,0,34,0,15,49
1230,17,32,17,16,82
1231,65,35,0,15,115
1232,0,17,17,16,50
1233,33,35,0,15,83
1235,17,18,0,15,50
1236,0,18,0,15,33
1239,0,34,0,17,51
1240,16,33,33,17,99
1242,0,16,33,17,66
1243,0,33,0,17,50
1244,17,34,66,17,134
1245,0,34,66,17,117
1246,17,34,0,15,66
1247,0,34,0,15,49
1249,0,32,17,17,66
1250,17,34,0,16,67
1251,0,34,0,16,50
1252,0,17,0,16,33
1253,0,33,0,17,50
1257,0,34,15,18,67
1258,19,33,16,16,84
1259,49,16,35,15,115
1260,18,32,35,15,100
1263,0,35,15,17,67
1264,18,32,51,16,117
1265,15,17,51,16,99
1266,0,17,51,16,84
1267,17,20,14,16,67
1268,20,30,17,15,82
1269,0,30,17,15,62
1270,16,32,17,18,83
1273,35,32,18,17,102
1274,18,32,18,17,85
1277,0,35,0,16,51
1278,17,33,16,17,83
1281,16,17,16,17,66
1283,0,33,68,15,116
1284,17,34,15,19,85
1285,16,18,15,19,68
1286,18,34,0,15,67
1287,0,34,0,15,49
1288,19,32,17,17,85
1289,0,32,17,17,66
1293,34,33,16,17,100
1297,0,33,16,17,66
1298,17,33,17,16,83
1299,0,33,17,16,66
1300,17,33,18,15,83
1301,33,33,17,17,100
1302,16,33,17,17,83
1303,0,33,17,17,67
1304,15,34,18,15,82
1306,17,33,18,17,85
1307,0,33,18,17,68
1309,35,32,0,17,84
1310,17,32,0,17,66
1311,0,32,0,17,49
1316,51,33,17,16,117
1317,0,34,50,16,100
1318,17,33,17,16,83
1319,0,33,17,16,66
1322,16,33,50,17,116
1323,33,34,16,17,100
1325,34,33,18,16,101
1327,0,33,18,16,67
1328,17,34,17,17,85
1330,16,34,50,16,116
1331,0,34,50,16,100
1332,17,33,17,16,83
1335,0,33,83,17,133
1336,0,16,83,17,116
1337,0,33,16,17,66
1338,0,17,16,17,50
1339,0,33,50,17,100
1340,17,34,16,17,84
1341,34,33,17,17,101
1343,33,34,66,16,149
1344,0,17,17,17,51
1346,0,17,66,16,99
1347,0,33,17,16,66
1348,49,33,18,15,115
1349,0,33,0,16,49
1350,16,33,18,15,82
1352,0,17,18,15,50
1354,0,15,0,17,32
1355,0,34,0,18,52
1356,0,17,0,18,35
1357,0,33,67,18,118
1359,18,17,0,15,50
1360,0,17,0,15,32
1361,0,32,0,18,50
1362,0,17,0,18,35
1364,0,15,0,17,32
1366,0,17,0,17,34
1367,0,33,0,16,49
1368,0,16,0,16,32
1369,0,34,0,15,49
1371,0,32,17,18,67
1373,35,35,48,17,135
1374,0,18,0,15,33
1375,15,20,48,17,100
1376,20,30,35,16,101
1378,33,17,0,16,66
1379,35,33,0,16,84
1380,17,33,0,16,66
1381,0,33,0,16,49
1382,17,32,0,17,66
1384,0,16,0,17,33
1385,0,34,0,18,52
1386,0,17,0,18,35
1388,0,16,17,15,48
1389,0,32,0,17,49
1391,0,34,0,16,50
1392,0,17,0,16,33
1393,67,32,17,18,134
1394,17,34,49,18,118
1395,0,34,49,18,101
1396,66,18,17,15,116
1397,0,32,17,18,67
1398,32,18,17,15,82
1399,67,34,50,16,167
1400,18,32,18,16,84
1402,15,34,50,16,115
1403,0,34,50,16,100
1405,0,34,16,16,66
1407,16,16,17,17,66
1408,33,17,18,15,83
1409,0,34,18,15,67
1410,0,17,18,15,50
1411,0,33,17,16,66
1412,83,33,0,16,132
1413,33,35,83,16,167
1414,0,16,17,18,51
1415,0,35,83,16,134
1416,18,33,0,16,67
1418,16,33,17,16,82
1419,0,33,17,16,66
1421,17,16,18,16,67
1422,16,34,0,16,66
1423,0,34,0,16,50
1424,16,34,17,15,82
1428,15,33,0,17,65
1429,0,33,0,17,50
1430,0,16,0,17,33
1431,17,18,0,17,52
1432,0,18,0,17,35
1433,0,29,0,20,49
1434,0,12,0,20,32
1436,17,33,17,16,83
1438,16,33,34,16,99
1440,16,34,33,18,101
1441,0,34,33,18,85
1442,16,33,50,16,115
1443,16,17,50,16,99
1444,0,17,50,16,83
1446,14,34,17,16,81
1447,0,34,17,16,67
1448,0,16,17,16,49
1449,0,33,18,16,67
1451,34,33,17,18,102
1453,0,33,17,18,68
1454,16,35,16,17,84
1455,0,35,16,17,68
1456,0,18,16,17,51
1457,16,17,17,15,65
1460,15,33,0,21,69
1461,0,33,0,21,54
1462,0,15,0,21,36
1464,0,13,0,17,30
1465,0,34,16,17,67
1469,0,33,133,17,183
1471,0,34,17,16,67
1475,0,34,16,16,66
1477,0,32,51,17,100
1478,50,34,49,17,150
1480,0,17,66,17,100
1481,0,34,49,17,100
1482,0,17,49,17,83
1483,0,32,17,17,66
1484,17,34,16,17,84
1487,0,33,17,17,67
1488,17,34,48,18,117
1489,0,34,48,18,100
1490,17,33,15,18,83
1491,0,33,15,18,66
1492,16,33,0,18,67
1493,33,33,0,18,84
1494,0,18,0,18,36
1495,0,33,0,18,51
1496,0,15,0,18,33
1497,0,35,15,17,67
1499,32,34,0,15,81
1500,17,34,0,15,66
1501,0,34,0,15,49
1502,0,16,0,15,31
1503,0,33,16,17,66
1505,16,17,17,16,66
1507,0,33,34,16,83
1508,50,33,0,17,100
1509,0,34,0,16,50
1512,0,17,0,17,34
1513,0,33,17,16,66
1514,0,16,17,16,49
1515,17,16,16,18,67
1516,16,34,17,17,84
1518,0,18,17,17,52
1520,17,32,17,17,83
1521,0,32,17,17,66
1523,0,34,17,17,68
1524,17,34,16,17,84
1525,0,34,16,17,67
1526,17,33,17,17,84
1528,0,17,17,17,51
1529,0,34,65,17,116
1531,0,33,49,17,99
1533,0,32,51,16,99
1534,15,34,17,16,82
1535,0,34,17,16,67
1536,0,17,17,16,50
1538,16,35,15,17,83
1540,17,32,17,17,83
1542,17,34,17,16,84
1543,34,33,16,18,101
1544,17,33,16,18,84
1545,0,33,16,18,67
1546,16,34,16,16,82
1548,18,32,18,16,84
1549,0,32,18,16,66
1550,0,16,18,16,50
1552,16,33,17,17,83
1553,0,33,17,17,67
1554,184,34,0,18,236
1556,17,33,18,17,85
1557,33,35,15,16,99
1558,17,35,15,16,83
1560,0,17,15,16,48
1561,64,34,0,18,116
1563,0,33,101,17,151
1564,15,34,0,18,67
1565,0,34,0,18,52
1566,16,33,18,16,83
1568,182,33,18,16,249
1569,0,34,17,16,67
1570,16,33,35,14,98
1571,0,33,35,14,82
1572,0,16,35,14,65
1573,0,35,0,14,49
1576,0,18,16,17,51
1579,33,34,51,16,134
1582,49,34,16,18,117
1583,33,34,16,18,101
1585,0,34,16,18,68
1586,16,34,16,17,83
1590,17,32,0,17,66
1591,0,32,0,17,49
1592,34,17,17,17,85
1593,0,34,17,17,68
1596,0,17,0,16,33
1597,0,33,0,17,50
1600,0,17,15,17,49
1601,32,34,15,17,98
1603,34,32,17,17,100
1604,16,32,17,17,82
1606,17,34,0,17,68
1607,0,34,0,17,51
1608,34,17,84,16,151
1609,0,34,84,16,134
1611,0,33,0,17,50
1613,0,33,18,16,67
1615,0,34,16,17,67
1616,16,33,0,17,66
1617,200,33,16,17,266
1618,17,32,35,17,101
1619,0,32,35,17,84
1621,0,35,0,17,52
1623,0,33,0,16,49
1624,0,16,0,16,32
1625,16,18,16,17,67
1626,0,18,16,17,51
1629,0,33,16,17,66
1630,17,33,16,18,84
1632,17,34,0,16,67
1633,0,34,0,16,50
1634,0,18,0,16,34
1635,0,33,17,16,66
1636,0,17,17,16,50
1637,0,33,0,17,50
1639,0,33,17,17,67
1640,0,16,17,17,50
1641,0,34,17,16,67
1642,17,33,19,15,84
1643,0,33,19,15,67
1644,16,34,16,17,83
1645,0,34,16,17,67
1647,0,33,16,17,66
1648,17,33,18,16,84
1649,0,33,18,16,67
1653,0,33,17,16,66
1654,0,17,17,16,50
1655,0,33,17,17,67
1657,0,34,16,16,66
1658,0,17,16,16,49
1659,0,32,18,16,66
1660,0,16,18,16,50
1661,0,34,17,18,69
1662,0,16,17,18,51
1664,0,18,15,17,50
1665,0,32,17,17,66
1667,0,34,16,17,67
1668,17,33,17,15,82
1669,0,33,17,15,65
1670,17,32,34,16,99
1672,15,34,33,17,99
1674,17,33,17,17,84
1675,0,33,17,17,67
1677,17,17,49,17,100
1678,0,17,49,17,83
1679,66,33,18,17,134
1681,34,33,18,17,102
1683,33,35,17,15,100
1684,15,35,17,15,82
1685,0,35,17,15,67
1686,17,32,0,18,67
1689,0,35,0,15,50
1690,0,17,0,15,32
1692,0,17,34,17,68
1695,0,33,16,16,65
1696,0,16,16,16,48
1697,0,32,0,18,50
1698,16,35,16,17,84
1700,0,17,16,17,50
1701,33,33,18,17,101
1702,17,33,18,17,85
1703,166,35,16,15,232
1704,0,17,18,17,52
1705,18,17,15,18,68
1707,0,33,48,17,98
1708,0,18,48,17,83
1709,48,17,51,15,131
1710,32,17,51,15,115
1711,16,17,51,15,99
1712,251,33,17,17,318
1713,17,18,16,15,66
1714,0,18,16,15,49
1715,66,32,18,15,131
1716,15,35,15,17,82
1717,35,32,18,15,100
1718,17,32,18,15,82
1719,0,32,18,15,65
1720,17,33,18,17,85
1721,101,33,17,17,168
1722,15,35,15,18,83
1724,17,33,16,17,83
1726,18,33,17,17,85
1727,100,34,49,17,200
1728,17,34,16,17,84
1731,0,33,16,18,67
1732,17,34,49,17,117
1734,0,18,49,17,84
1737,0,34,16,19,69
1738,17,35,16,15,83
1739,35,31,51,16,133
1740,0,19,16,15,50
1741,98,34,16,16,164
1742,33,15,18,16,82
1743,0,33,18,16,67
1745,34,34,16,16,100
1746,16,34,16,16,82
1747,0,34,16,16,66
1748,216,33,16,16,281
1749,32,34,17,17,100
1751,34,34,66,17,151
1753,0,34,66,17,117
1754,34,17,32,17,100
1755,34,32,17,17,100
1756,0,17,32,17,66
1757,382,18,15,17,432
1758,0,16,17,17,50
1759,0,34,16,17,67
1760,0,17,16,17,50
1763,0,32,19,15,66
1764,0,16,19,15,50
1765,0,34,17,17,68
1766,15,34,16,17,82
1767,0,34,16,17,67
1768,33,17,0,17,67
1769,0,33,0,17,50
1770,0,17,0,17,34
1772,34,14,0,18,66
1774,0,14,0,18,32
1775,0,35,0,17,52
1777,0,33,17,18,68
1778,51,32,0,17,100
1779,0,35,15,17,67
1781,0,32,0,17,49
1782,17,34,17,15,83
1783,0,34,17,15,66
1785,17,15,0,17,49
1786,100,16,17,16,149
1787,0,34,0,17,51
1789,0,34,50,16,100
1791,33,33,17,17,100
1793,0,33,17,17,67
1794,33,17,15,18,83
1795,34,33,17,15,99
1797,0,33,17,15,65
1798,18,32,0,17,67
1799,0,32,0,17,49
1800,15,35,0,17,67
1801,0,35,0,17,52
1802,0,18,0,17,35
1803,0,32,0,17,49
1806,19,32,15,18,84
1807,32,33,0,18,83
1808,17,33,0,18,68
1810,52,33,133,17,235
1811,50,17,133,17,217
1812,0,16,0,16,32
1813,0,33,133,17,183
1814,0,17,133,17,167
1817,0,34,0,17,51
1818,0,16,0,17,33
1819,34,33,17,15,99
1823,0,32,34,17,83
1825,0,34,34,17,85
1826,16,34,33,17,100
1828,0,17,33,17,67
1829,0,33,0,17,50
1830,16,34,33,17,100
1832,0,17,33,17,67
1833,0,33,0,17,50
1834,16,34,0,16,66
1835,0,34,0,16,50
1838,0,17,0,14,31
1839,0,33,33,17,83
1840,19,33,0,17,69
1842,15,33,0,17,65
1843,0,33,0,17,50
1844,0,16,0,17,33
1847,0,33,0,17,50
1848,0,16,0,17,33
1850,0,17,49,16,82
1851,0,34,15,16,65
1852,19,31,18,17,85
1854,16,35,34,15,100
1855,0,35,34,15,84
1856,17,34,15,17,83
1857,34,32,0,16,82
1858,17,32,0,16,65
1859,0,32,0,16,48
1860,0,17,0,16,33
1861,16,17,52,15,100
1862,17,34,33,16,100
1863,0,34,33,16,83
1864,17,33,0,16,66
1865,18,15,0,16,49
1866,15,34,0,16,65
1867,0,34,0,16,50
1868,0,18,0,16,34
1869,16,18,15,17,66
1870,0,18,15,17,50
1872,17,33,0,16,66
1873,0,33,0,16,49
1875,0,33,0,18,51
1876,17,35,32,17,101
1878,0,17,32,17,66
1879,49,16,0,17,82
1880,15,33,0,17,65
1881,0,33,0,17,50
1882,0,16,0,17,33
1883,0,34,0,17,51
1884,0,17,0,17,34
1885,0,34,32,17,83
1886,0,17,32,17,66
1887,32,35,0,16,83
1888,15,35,0,16,66
1889,51,17,0,17,85
1890,18,33,0,17,68
1891,0,33,0,17,50
1892,0,17,0,17,34
1893,17,16,17,17,67
1894,0,16,17,17,50
1895,66,33,0,20,119
1896,17,32,0,18,67
1897,32,33,0,20,85
1899,0,33,0,20,53
1900,0,15,0,20,35
1901,0,33,19,17,69
1902,0,13,19,17,49
1904,17,32,33,17,99
1905,0,32,33,17,82
1906,17,33,0,17,67
1907,0,33,0,17,50
1908,17,35,16,17,85
1909,0,35,16,17,68
1911,0,33,0,16,49
1912,17,33,0,17,67
1913,0,33,0,17,50
1914,17,32,18,15,82
1915,0,32,18,15,65
1917,18,15,0,18,51
1918,15,35,16,16,82
1919,0,35,16,16,67
1923,35,32,33,16,116
1924,49,33,0,16,98
1926,17,33,0,16,66
1927,0,33,0,16,49
1928,17,33,0,17,67
1930,0,17,0,17,34
1932,0,17,0,18,35
1933,0,33,102,14,149
1934,0,15,102,14,131
1936,16,34,0,17,67
1938,0,15,0,17,32
1940,0,18,14,18,50
1944,15,35,0,15,65
1945,0,35,0,15,50
1946,17,33,0,16,66
1948,0,18,0,16,34
1949,0,32,0,18,50
1951,0,33,34,16,83
1955,0,34,0,15,49
1957,0,33,0,16,49
1958,0,18,0,16,34
1959,0,34,0,15,49
1960,50,35,15,18,118
1961,0,32,0,18,50
1962,0,17,0,18,35
1964,0,17,15,18,50
1965,15,18,49,17,99
1967,49,17,15,18,99
1969,17,17,15,18,67
1970,50,35,15,17,117
1971,0,33,18,17,68
1972,18,35,15,17,85
1974,49,33,18,15,115
1975,0,32,16,17,65
1976,17,33,18,15,83
1978,17,33,18,18,86
1980,51,32,49,17,149
1981,0,36,0,15,51
1982,18,32,49,17,116
1985,31,35,18,15,99
1986,16,35,18,15,84
1987,18,17,18,15,68
1988,85,32,17,16,150
1989,0,33,0,19,52
1990,34,16,0,14,64
1991,0,35,0,14,49
1992,0,16,0,14,30
1993,0,32,17,16,65
1994,0,18,17,16,51
1997,0,34,32,18,84
1999,0,32,0,18,50
2000,15,34,0,17,66
2001,0,34,0,17,51
2002,0,16,0,17,33
2003,0,34,0,17,51
2004,0,17,0,17,34
2005,0,32,17,17,66
2006,0,15,17,17,49
2007,17,17,17,16,67
2008,17,33,0,18,68
2009,0,33,0,18,51
2010,0,16,0,18,34
2011,0,35,15,16,66
2013,0,31,35,15,81
2014,16,35,0,15,66
2015,50,18,0,17,85
2016,17,33,0,17,67
2018,18,35,48,16,117
2025,0,34,67,17,118
2026,16,32,17,18,83
2027,0,32,17,18,67
2028,0,17,17,18,52
2029,17,18,17,17,69
2030,18,34,32,17,101
2031,17,17,32,17,83
2033,0,32,17,17,66
2034,17,34,17,17,85
2035,17,17,17,17,68
2036,17,34,16,17,84
2037,17,17,16,17,67
2039,33,32,18,17,100
2040,17,32,18,17,84
2043,0,35,14,20,69
2045,0,34,16,16,66
2046,20,32,17,17,86
2047,0,32,17,17,66
2049,0,34,0,17,51
2050,17,33,17,17,84
2052,0,16,17,17,50
2053,17,17,15,17,66
2054,0,17,15,17,49
2055,0,32,18,16,66
2056,17,34,16,16,83
2058,0,16,16,16,48
2059,16,16,17,18,67
2060,16,35,49,16,116
2061,0,35,49,16,100
2062,0,18,49,16,83
2063,0,32,17,16,65
2064,0,17,17,16,50
2067,0,34,0,17,51
2068,17,34,0,17,68
2069,0,34,0,17,51
2070,17,33,34,18,102
2071,0,33,34,18,85
2072,0,16,34,18,68
2073,0,34,33,17,84
2074,0,17,33,17,67
2075,0,33,34,15,82
2078,0,17,98,18,133
2080,0,17,16,18,51
2081,16,18,0,15,49
2082,18,32,0,18,68
2083,0,32,0,18,50
2084,0,17,0,18,35
2085,0,35,67,15,117
2086,0,17,67,15,99
2087,0,32,0,16,48
2088,15,35,32,17,99
2090,0,19,32,17,68
2092,0,17,0,17,34
2093,17,17,17,17,68
2094,0,17,17,17,51
2095,17,17,49,16,99
2096,49,33,18,15,115
2097,0,32,51,15,98
2098,17,33,18,15,83
2100,16,33,66,18,133
2102,0,15,66,18,99
2103,0,33,0,18,51
2104,0,16,0,18,34
2105,18,15,18,17,68
2106,0,15,18,17,50
2107,0,35,18,15,68
2108,0,17,18,15,50
2111,66,33,0,17,116
2112,17,33,100,17,167
2113,0,33,100,17,150
2114,15,33,0,17,65
2115,0,33,0,17,50
2116,16,35,49,18,118
2117,0,35,49,18,102
2119,32,35,31,18,116
2121,0,35,31,18,84
2122,18,31,18,16,83
2123,0,31,18,16,65
2124,33,16,34,17,100
2125,0,34,34,17,85
2127,0,34,17,15,66
2128,66,18,17,17,118
2130,84,32,0,18,134
2131,17,18,17,17,69
2132,18,34,65,17,134
2133,0,34,65,17,116
2134,17,32,0,18,67
2135,32,33,0,17,82
2137,235,32,0,17,284
2138,0,15,0,17,32
2139,0,34,33,17,84
2140,0,17,33,17,67
2141,0,33,0,17,50
2144,0,17,49,17,83
2145,0,33,16,17,66
2146,0,16,16,17,49
2148,0,17,35,15,67
2149,0,35,0,15,50
2151,0,32,0,17,49
2152,0,17,0,17,34
2154,0,17,17,17,51
2155,34,31,17,17,99
2156,17,31,17,17,82
2157,0,31,17,17,65
2160,0,17,50,18,85
2161,0,33,17,18,68
2162,16,35,0,17,68
2163,0,35,0,17,52
2164,0,18,0,17,35
2165,0,32,0,16,48
2166,0,15,0,16,31
2167,0,34,66,17,117
2169,33,33,0,17,83
2170,17,33,0,17,67
2171,0,33,0,17,50
2172,17,33,68,17,135
2173,68,33,17,17,135
2176,18,33,17,17,85
2177,115,16,0,18,149
2178,0,17,17,17,51
2179,0,34,15,16,65
2180,0,17,15,16,48
2181,0,31,0,17,48
2182,16,33,0,18,67
2183,0,33,0,18,51
2184,0,16,0,18,34
2185,0,35,17,15,67
2186,0,17,17,15,49
2187,0,32,0,18,50
2188,0,15,0,18,33
2190,0,15,0,18,33
2191,0,35,0,17,52
2192,0,17,0,17,34
2193,0,34,16,16,66
2194,0,17,16,16,49
2195,0,32,17,16,65
2197,0,33,50,17,100
2198,0,16,50,17,83
2199,35,32,84,17,168
2200,49,33,17,17,116
2202,17,33,17,17,84
2203,0,33,17,17,67
2204,0,16,17,17,50
2205,0,34,17,17,68
2206,17,34,17,17,85
2207,0,34,17,17,68
2208,17,34,15,17,83
2209,382,17,16,18,433
2211,15,17,0,16,48
2212,17,33,16,17,83
2213,49,17,17,17,100
2215,0,33,17,17,67
2216,17,34,17,15,83
2217,34,32,17,17,100
2220,15,34,34,16,99
2221,34,34,0,16,84
2222,17,34,0,16,67
2224,16,33,0,17,66
2225,0,33,0,17,50
2226,0,17,0,17,34
2227,0,34,16,17,67
2228,50,33,16,18,117
2230,50,34,17,17,118
2231,0,33,16,18,67
2232,17,34,17,17,85
2233,16,18,17,17,68
2234,0,18,17,17,52
2235,0,34,15,18,67
2237,0,33,0,15,48
2238,0,18,0,15,33
2239,0,33,17,17,67
2240,52,32,0,17,101
2242,49,34,17,16,116
2243,0,32,0,17,49
2248,50,33,32,18,133
2249,0,34,65,18,117
2250,18,33,32,18,101
2251,0,33,32,18,83
2252,16,32,0,18,66
2253,83,18,0,16,117
2254,86,31,36,15,168
2256,0,15,0,18,33
2257,36,31,36,15,118
2259,0,31,36,15,82
2260,0,15,36,15,66
2261,0,36,0,15,51
2262,168,17,33,15,233
2268,183,34,68,15,300
2269,0,33,0,17,50
2271,34,33,0,15,82
2272,0,17,33,15,65
2273,0,33,0,15,48
2274,18,33,17,15,83
2275,0,33,17,15,65
2276,0,18,17,15,50
2277,0,32,17,17,66
2278,15,34,68,15,132
2279,34,34,16,18,102
2280,17,34,16,18,85
2281,0,34,16,18,68
2284,18,32,34,17,101
2287,0,34,17,15,66
2288,17,32,18,17,84
2289,0,32,18,17,67
2290,0,15,18,17,50
2291,0,35,16,17,68
2292,33,17,17,16,83
2293,33,33,51,15,132
2294,0,17,17,16,50
2295,0,33,51,15,99
2296,0,16,51,15,82
2297,83,17,67,16,183
2298,0,17,18,15,50
2299,0,33,17,17,67
2300,15,34,67,16,132
2301,0,34,67,16,117
2302,0,17,67,16,100
2303,0,33,17,17,67
2308,0,17,17,17,51
2310,183,32,18,17,250
2311,0,33,32,17,82
2312,17,32,17,17,83
2313,0,32,17,17,66
2314,16,34,18,16,84
2315,0,34,18,16,68
2316,51,33,15,17,116
2317,0,34,17,16,67
2318,16,33,15,17,81
2319,0,33,15,17,65
2322,17,35,49,18,119
2323,0,35,49,18,102
2326,17,35,49,17,118
2327,0,35,49,17,101
2328,18,33,50,17,118
2329,0,33,50,17,100
2330,17,33,17,17,84
2331,0,33,17,17,67
2332,17,34,0,17,68
2333,0,34,0,17,51
2334,17,32,0,17,66
2335,0,32,0,17,49
2336,0,15,0,17,32
2339,32,33,18,16,99
2340,0,17,16,17,50
2341,16,17,18,16,67
2342,17,34,16,18,85
2343,0,34,16,18,68
2344,16,34,0,16,66
2346,18,32,18,15,83
2347,0,32,18,15,65
2348,0,16,18,15,49
2349,0,33,17,17,67
2352,17,33,17,17,84
2353,0,33,17,17,67
2354,0,16,17,17,50
2355,17,17,0,16,50
2356,17,33,33,18,101
2357,0,33,33,18,84
2358,34,16,66,18,134
2360,49,33,0,18,100
2363,0,33,0,18,51
2364,16,36,32,17,101
2365,0,36,32,17,85
2366,0,18,32,17,67
2367,0,32,17,17,66
2372,16,35,0,15,66
2373,17,18,0,15,50
2374,0,18,0,15,33
2375,0,32,0,18,50
2376,0,17,0,18,35
2377,0,33,34,18,85
2378,15,34,33,18,100
2379,0,34,33,18,85
2380,17,33,0,18,68
2381,0,33,0,18,51
2382,15,33,0,17,65
2384,0,15,0,17,32
2385,0,35,16,16,67
2387,16,16,0,17,49
2388,16,33,0,18,67
2390,117,33,0,17,167
2391,0,34,0,17,51
2392,0,16,0,17,33
2394,0,17,66,17,100
2395,0,33,0,16,49
2396,17,33,0,17,67
2397,0,33,0,17,50
2398,0,17,0,17,34
2399,0,32,0,18,50
2400,0,15,0,18,33
2401,0,34,16,17,67
2404,17,33,0,18,68
2405,0,33,0,18,51
2407,0,35,0,17,52
2408,0,17,0,17,34
2411,0,33,67,17,117
2412,0,15,67,17,99
2413,18,17,17,15,67
2414,0,17,17,15,49
2415,0,32,0,17,49
2417,0,33,18,17,68
2418,0,16,18,17,51
2419,18,17,0,17,52
2420,17,33,16,18,84
2421,17,16,16,18,67
2422,0,16,16,18,50
2423,34,33,0,16,83
2424,18,33,0,16,67
2425,0,33,0,16,49
2427,0,33,16,16,65
2428,0,17,16,16,49
2429,0,32,35,16,83
2430,0,16,35,16,67
2431,35,34,0,15,84
2432,98,18,17,15,148
2433,16,18,0,15,49
2434,0,18,0,15,33
2435,0,32,0,16,48
2436,0,17,0,16,33
2437,0,34,17,15,66
2438,18,32,0,18,68
2439,0,32,0,18,50
2440,15,34,0,17,66
2441,0,34,0,17,51
2443,0,34,16,17,67
2444,17,33,0,16,66
2445,0,33,0,16,49
2446,17,33,50,16,116
2447,0,33,50,16,99
2448,0,17,50,16,83
2449,0,33,17,16,66
2450,33,16,18,17,84
2451,17,16,18,17,68
2453,0,35,17,15,67
2454,0,17,17,15,49
2456,0,15,17,17,49
2457,0,34,16,17,67
2458,50,34,17,16,117
2459,0,33,17,17,67
2462,0,17,17,16,50
2463,0,33,17,16,66
2464,16,33,34,16,99
2465,0,33,34,16,83
2466,16,34,16,17,83
2468,18,33,50,17,118
2469,0,33,50,17,100
2471,0,32,68,18,118
2475,0,33,18,16,67
2476,0,17,18,16,51
2479,0,33,16,17,66
2481,0,33,17,17,67
2482,17,34,16,17,84
2483,17,17,16,17,67
2484,50,32,17,17,116
2485,16,17,49,17,99
2486,0,17,49,17,83
2487,0,32,17,17,66
2488,16,34,0,16,66
2489,17,17,0,16,50
2490,17,34,0,16,67
2492,0,18,0,16,34
2493,0,32,0,17,49
2494,0,16,0,17,33
2495,0,35,0,17,52
2496,18,33,0,16,67
2497,17,16,0,16,49
2498,0,16,0,16,32
2499,0,33,0,17,50
2500,0,17,0,17,34
2501,0,32,0,18,50
2502,0,15,0,18,33
2503,18,17,17,16,68
2504,50,34,0,15,99
2506,16,34,0,15,65
2508,17,33,16,17,83
2509,0,33,16,17,66
2510,0,18,16,17,51
2511,16,17,17,17,67
2512,17,34,0,15,66
2513,34,31,68,17,150
2516,0,16,68,17,101
2518,16,34,50,16,116
2520,17,34,16,16,83
2521,0,34,16,16,66
2522,0,17,16,16,49
2523,16,16,0,17,49
2524,16,35,0,15,66
2525,0,35,0,15,50
2526,51,33,0,17,101
2527,0,33,16,17,66
2529,0,33,0,17,50
2530,17,33,16,18,84
2533,16,18,17,16,67
2534,18,33,0,16,67
2535,0,33,0,16,49
2536,116,33,0,17,166
2537,0,34,17,15,66
2538,0,18,17,15,50
2539,32,34,16,17,99
2541,0,34,16,17,67
2542,0,17,16,17,50
2543,0,33,0,17,50
2544,17,33,0,17,67
2545,50,17,67,17,151
2548,0,17,67,17,101
2550,17,33,0,17,67
2552,16,33,0,17,66
2553,0,33,0,17,50
2554,0,16,0,17,33
2556,0,17,0,19,36
2557,0,33,32,18,83
2559,17,15,35,17,84
2561,0,35,0,17,52
2562,0,17,0,17,34
2563,17,15,18,17,67
2564,0,15,18,17,50
2566,17,32,17,16,82
2567,17,15,17,16,65
2568,0,15,17,16,48
2569,17,16,17,17,67
2570,16,34,16,17,83
2573,0,33,17,17,67
2574,17,34,17,17,85
2575,0,34,17,17,68
2577,0,34,15,17,66
2578,0,17,15,17,49
2580,17,34,0,16,67
2581,0,34,0,16,50
2582,0,18,0,16,34
2583,0,33,0,17,50
2584,0,17,0,17,34
2586,0,17,15,18,50
2587,0,33,32,17,82
2588,18,32,17,17,84
2589,0,32,17,17,66
2590,16,34,18,16,84
2591,0,34,18,16,68
2592,0,17,18,16,51
2593,0,34,17,16,67
2594,16,33,17,17,83
2595,50,17,33,16,116
2596,16,34,33,16,99
2597,0,34,33,16,83
2598,17,33,16,17,83
2599,0,33,16,17,66
2600,0,17,16,17,50
2601,0,33,17,17,67
2602,0,17,17,17,51
2603,0,34,16,16,66
2604,17,32,50,17,116
2606,16,35,50,16,117
2608,0,17,50,16,83
2609,0,32,18,16,66
2611,0,34,16,17,67
2612,16,33,83,17,149
2613,0,33,83,17,133
2614,17,33,17,16,83
2615,0,33,17,16,66
2617,0,33,134,16,183
2618,0,16,134,16,166
2619,0,34,17,17,68
2622,0,17,50,16,83
2623,0,33,17,16,66
2624,0,17,17,16,50
2625,0,33,16,17,66
2626,66,17,16,17,116
2627,0,33,17,17,67
2628,184,34,50,16,284
2629,0,34,16,17,67
2632,17,33,17,17,84
2633,0,33,17,17,67
2635,0,34,0,17,51
2637,0,33,34,16,83
2638,0,16,34,16,66
2639,0,34,50,16,100
2640,17,33,17,16,83
2641,0,33,17,16,66
2642,0,17,17,16,50
2644,16,33,17,17,83
2645,0,33,17,17,67
2647,0,34,0,17,51
2648,34,17,0,17,68
2649,0,34,0,17,51
2650,0,17,0,17,34
2651,49,17,0,16,82
2652,0,15,17,17,49
2654,17,33,17,16,83
2655,0,33,17,16,66
2656,0,17,17,16,50
2657,49,17,68,16,150
2658,16,33,68,16,133
2659,0,33,68,16,117
2661,0,34,17,17,68
2663,17,17,16,18,68
2664,17,34,0,15,66
2665,0,34,0,15,49
2666,0,18,0,15,33
2669,0,32,18,16,66
2671,0,34,0,16,50
2672,16,33,15,18,82
2673,0,33,15,18,66
2675,0,33,0,17,50
2678,0,16,0,18,34
2679,0,34,0,17,51
2680,0,16,0,17,33
2681,0,33,0,17,50
2683,0,34,50,17,101
2684,17,33,34,15,99
2685,50,17,15,17,99
2687,17,17,15,17,66
2688,17,32,0,18,67
2689,0,32,0,18,50
2690,0,17,0,18,35
2691,0,34,0,17,51
2692,0,16,0,17,33
2694,49,35,0,16,100
2695,16,16,0,18,50
2696,0,16,0,18,34
2697,0,35,0,16,51
2698,0,17,0,16,33
2700,49,34,17,17,117
2701,17,16,0,18,51
2702,0,16,0,18,34
2703,0,34,17,17,68
2704,0,16,17,17,50
2705,17,17,16,16,66
2706,17,32,34,17,100
2707,0,32,34,17,83
2710,0,17,0,17,34
2711,0,34,16,16,66
2712,0,17,16,16,49
2713,0,32,51,16,99
2714,16,34,17,16,83
2716,16,33,16,19,84
2717,0,33,16,19,68
2718,16,35,15,17,83
2719,0,35,15,17,67
2722,17,33,17,17,84
2723,0,33,17,17,67
2724,17,34,16,17,84
2726,17,33,17,17,84
2727,16,17,17,17,67
2729,0,34,15,19,68
2730,17,34,15,21,87
2731,0,34,15,21,70
2732,19,36,0,12,67
2734,21,30,15,17,83
2735,0,30,15,17,62
2736,18,32,18,15,83
2737,15,17,18,15,65
2738,0,17,18,15,50
2739,0,33,18,17,68
2741,0,35,15,18,68
2742,17,33,16,17,83
2743,0,33,16,17,66
2745,0,33,17,16,66
2746,17,33,0,18,68
2747,0,33,0,18,51
2749,0,34,0,18,52
2750,0,16,0,18,34
2751,0,34,0,15,49
2752,16,33,15,17,81
2754,0,18,15,17,50
2755,15,17,0,17,49
2756,17,34,0,16,67
2757,0,34,0,16,50
2758,17,33,17,17,84
2759,0,33,17,17,67
2760,0,17,17,17,51
2761,0,34,0,17,51
2763,0,33,66,17,116
2767,0,34,17,17,68
2768,0,16,17,17,50
2770,0,17,51,15,83
2771,0,34,17,15,66
2772,17,32,18,15,82
2774,48,35,0,15,98
2775,0,33,18,17,68
2776,15,35,0,15,65
2780,0,18,0,15,33
2782,0,17,35,15,67
2783,18,17,15,18,68
2784,183,34,17,16,250
2785,0,33,17,16,66
2786,0,18,17,16,51
2787,33,35,0,15,83
2788,16,35,0,15,66
2789,0,35,0,15,50
2790,50,33,51,16,150
2791,0,32,16,17,65
2792,0,17,16,17,50
2793,16,17,51,16,100
2794,17,34,17,16,84
2798,16,32,0,17,65
2799,0,32,0,17,49
2800,15,34,0,16,65
2802,0,17,0,16,33
2803,0,33,35,15,83
2804,0,17,35,15,67
2805,0,35,0,15,50
2806,17,32,0,17,66
2807,0,32,0,17,49
2808,34,17,16,16,83
2810,0,17,16,16,49
2811,16,16,18,17,67
2812,16,35,32,18,101
2813,0,35,32,18,85
2814,17,32,0,18,67
2815,0,32,0,18,50
2816,16,35,17,16,84
2817,0,35,17,16,68
2819,17,16,0,16,49
2821,0,31,34,17,82
2822,0,15,34,17,66
2823,0,34,0,17,51
2827,16,17,16,17,66
2828,0,17,16,17,50
2829,33,34,15,18,100
2830,17,34,15,18,84
2831,18,16,15,18,67
2832,16,33,16,18,83
2833,0,33,16,18,67
2834,18,34,0,16,68
2835,16,18,0,16,50
2836,18,34,15,16,83
2837,65,34,0,16,115
2838,0,18,15,16,49
2839,0,31,18,16,65
2841,0,34,0,16,50
2842,16,34,15,18,83
2844,0,18,15,18,51
2845,0,33,32,18,83
2849,50,17,17,17,101
2850,0,16,16,17,49
2851,0,33,17,17,67
2852,17,34,0,16,67
2855,16,17,0,18,51
2856,17,33,0,17,67
2857,0,33,0,17,50
2858,15,34,0,16,65
2859,17,17,0,16,50
2860,0,17,0,16,33
2861,0,33,34,14,81
2863,17,17,14,19,67
2865,0,33,16,17,66
2866,0,19,16,17,52
2867,0,33,0,16,49
2869,0,34,0,16,50
2870,0,18,0,16,34
2871,0,33,16,17,66
2872,0,17,16,17,50
2873,16,17,17,18,68
2874,17,35,15,17,84
2875,0,35,15,17,67
2876,18,32,17,17,84
2879,0,34,16,16,66
2880,49,34,50,17,150
2881,16,16,17,17,66
2882,16,34,50,17,117
2883,0,34,50,17,101
2885,17,17,16,17,67
2886,0,17,16,17,50
2887,16,17,17,16,66
2888,17,33,16,18,84
2889,0,33,16,18,67
2890,16,34,16,17,83
2891,34,33,51,15,133
2892,18,33,51,15,117
2893,0,33,51,15,99
2895,0,32,19,15,66
2896,15,34,50,18,117
2897,0,34,50,18,102
2899,34,34,15,18,101
2901,0,34,15,18,67
2903,33,33,32,17,115
2904,33,18,32,17,100
2905,0,33,32,17,82
2906,0,18,32,17,67
2907,0,32,0,17,49
2908,17,35,0,15,67
2909,0,35,0,15,50
2910,0,18,0,15,33
2911,32,33,0,18,83
2912,0,17,33,18,68
2913,0,33,0,18,51
2914,16,35,15,18,84
2916,0,17,15,18,50
2917,15,18,16,17,66
2918,18,33,16,18,85
2922,18,33,0,16,67
2924,0,17,0,16,33
2926,0,17,16,17,50
2927,16,17,0,17,50
2928,17,33,17,16,83
2930,0,16,17,16,49
2932,0,16,33,18,67
2934,15,34,0,18,67
2936,0,16,0,18,34
2937,0,33,0,19,52
2939,19,15,0,17,51
2942,0,16,0,17,33
2943,50,17,33,18,118
2945,0,33,33,18,84
2946,0,17,33,18,68
2947,33,33,0,18,84
2949,0,33,0,18,51
2951,0,35,15,17,67
2952,0,17,15,17,49
2954,17,34,0,17,68
2955,0,34,0,17,51
2957,0,32,0,18,50
2959,0,34,67,16,117
2960,0,16,67,16,99
2962,0,17,15,17,49
2963,0,32,16,18,66
2964,51,33,33,17,134
2967,0,33,33,17,83
2968,17,33,17,16,83
2972,0,16,51,16,83
2973,51,16,17,16,100
2975,17,16,17,16,66
2976,0,16,17,16,49
2977,0,33,0,18,51
2978,16,34,0,16,66
2979,0,34,0,16,50
2980,0,16,0,16,32
2981,0,34,50,16,100
2984,0,17,18,16,51
2987,0,33,17,16,66
2988,16,33,17,16,82
2989,0,33,17,16,66
2990,16,33,85,15,149
2993,51,15,19,15,100
2995,0,32,19,15,66
2996,0,15,19,15,49
2999,0,35,16,18,69
3000,18,34,15,17,84
3002,0,18,15,17,50
3003,0,32,16,19,67
3004,17,35,0,16,68
3005,0,35,0,16,51
3006,19,31,17,17,84
3008,0,15,17,17,49
3010,17,32,18,16,83
3011,0,32,18,16,66
3012,0,17,18,16,51
3014,16,34,67,17,134
3015,0,34,67,17,118
3016,0,17,67,17,101
3017,16,18,0,15,49
3018,18,33,32,17,100
3019,0,33,32,17,82
3021,0,32,0,17,49
3022,0,15,0,17,32
3023,0,35,15,17,67
3024,0,18,15,17,50
3027,0,33,68,15,116
3031,0,33,0,15,48
3032,0,17,0,15,32
3033,0,33,49,17,99
3034,0,18,49,17,84
3037,0,34,34,17,85
3039,0,34,17,17,68
3040,0,17,17,17,51
3042,0,17,0,15,32
3043,0,32,0,18,50
3044,0,17,0,18,35
3047,0,32,50,17,99
3051,17,17,16,17,67
3053,0,33,51,16,100
3054,17,34,17,16,84
3055,0,34,17,16,67
3056,17,33,16,18,84
3057,17,16,16,18,67
3060,18,33,32,18,101
3062,17,32,18,17,84
3063,50,17,0,15,82
3064,16,35,0,15,66
3065,0,35,0,15,50
3066,0,17,0,15,32
3067,15,17,18,17,67
3070,17,31,19,15,82
3071,0,31,19,15,65
3073,0,34,34,17,85
3074,49,34,0,17,100
3075,0,34,99,17,150
3077,0,34,0,17,51
3078,0,17,0,17,34
3080,17,31,84,16,148
3082,16,35,49,16,116
3083,0,35,49,16,100
3084,0,18,49,16,83
3085,0,32,17,16,65
3086,0,16,17,16,49
3089,0,34,0,17,51
3090,66,15,17,18,116
3091,0,33,0,18,51
3092,0,16,0,18,34
3093,68,33,50,17,168
3096,18,33,50,17,118
3097,0,33,50,17,100
3098,16,34,16,17,83
3099,0,34,16,17,67
3100,0,17,16,17,50
3103,0,33,50,15,98
3106,48,34,17,17,116
3108,15,34,17,17,83
3109,0,34,17,17,68
3110,0,15,17,17,49
3113,0,34,67,16,117
3116,0,18,34,16,68
3120,0,17,16,17,50
3121,0,33,0,16,49
3123,0,34,0,15,49
3124,0,18,0,15,33
3125,0,33,18,14,65
3126,0,18,18,14,50
3127,32,34,34,17,117
3129,0,34,34,17,85
3130,16,34,0,17,67
3131,0,34,0,17,51
3132,17,33,0,17,67
3134,0,16,0,17,33
3135,0,32,0,17,49
3136,0,15,0,17,32
3137,17,17,0,18,52
3138,0,17,0,18,35
3140,0,15,16,19,50
3141,35,32,50,16,133
3142,19,32,50,16,117
3143,0,32,50,16,98
3144,0,15,50,16,81
3145,34,32,0,18,84
3146,16,32,0,18,66
3147,16,16,0,18,50
3148,16,35,15,17,83
3149,18,17,15,17,67
3150,17,32,0,18,67
3151,15,17,0,18,50
3155,16,18,15,17,66
3156,0,18,15,17,50
3159,0,32,19,15,66
3160,0,15,19,15,49
3162,15,35,16,15,81
3164,34,15,0,20,69
3165,31,34,0,18,83
3166,15,34,0,18,67
3167,0,34,0,18,52
3168,14,34,33,16,97
3169,0,34,33,16,83
3170,16,33,0,16,65
3171,0,33,0,16,49
3172,16,33,0,17,66
3175,0,34,49,17,100
3177,0,34,15,17,66
3178,17,32,16,17,82
3179,15,17,16,17,65
3180,17,33,0,18,68
3181,0,33,0,18,51
3186,50,33,17,16,116
3187,0,33,16,17,66
3191,0,33,18,16,67
3193,0,34,52,16,102
3195,0,34,18,16,68
3197,0,34,17,15,66
3200,15,34,16,17,82
3202,18,33,0,16,67
3204,17,33,0,18,68
3205,116,17,51,14,198
3206,0,17,0,18,35
3207,0,33,67,17,117
3208,49,33,51,14,147
3211,0,33,51,14,98
3212,0,17,51,14,82
3213,17,17,31,18,83
3215,0,31,0,18,49
3217,85,15,17,17,134
3219,81,17,33,17,148
3220,34,15,17,17,83
3221,32,34,33,17,116
3222,0,15,17,17,49
3223,0,34,33,17,84
3224,17,33,34,18,102
3225,0,33,34,18,85
3226,0,15,34,18,67
3227,0,34,0,18,52
3228,0,17,0,18,35
3229,0,34,0,17,51
3230,0,16,0,17,33
3232,0,16,33,17,66
3234,0,15,0,17,32
3235,0,34,34,13,81
3236,0,17,34,13,64
3237,0,34,49,16,99
3238,17,33,50,16,116
3239,0,33,50,16,99
3240,20,32,18,16,86
3241,0,32,18,16,66
3244,0,16,16,18,50
3247,0,32,35,16,83
3248,15,35,16,16,82
3252,67,16,18,14,115
3253,0,33,52,14,99
3254,67,14,19,16,116
3256,16,32,19,16,83
3257,0,32,19,16,67
3258,49,34,0,17,100
3259,0,35,0,17,52
3260,33,17,0,17,67
3261,0,34,0,17,51
3263,0,33,17,17,67
3265,115,17,16,19,167
3267,0,32,34,15,81
3268,17,34,48,19,118
3269,0,34,48,19,101
3270,0,17,48,19,84
3272,0,17,16,19,52
3273,16,19,0,15,50
3277,0,34,0,17,51
3278,17,34,17,14,82
3279,0,34,17,14,65
3280,0,17,17,14,48
3281,0,31,0,20,51
3282,34,16,16,16,82
3283,0,36,16,16,68
3285,0,32,16,20,68
3286,0,16,16,20,52
3287,0,36,14,16,66
3288,20,30,51,16,117
3289,0,30,51,16,97
3296,0,17,0,16,33
3297,16,17,0,16,49
3298,0,17,0,16,33
3299,0,34,17,16,67
3300,0,18,17,16,51
3301,17,16,0,15,48
3302,16,33,17,16,82
3303,0,33,17,16,66
3304,35,16,16,17,84
3305,17,16,16,17,66
3306,16,33,19,14,82
3307,0,33,19,14,66
3308,17,33,17,18,85
3309,19,14,17,18,68
3310,49,32,34,17,132
3312,0,18,17,15,50
3313,0,32,34,17,83
3314,15,34,0,17,66
3315,0,34,0,17,51
3316,17,32,51,17,117
3317,0,32,51,17,100
3318,0,15,51,17,83
3319,16,20,15,17,68
3321,32,33,0,17,82
3322,17,33,0,17,67
3323,0,33,0,17,50
3324,16,34,0,17,67
3325,17,17,0,17,51
3326,0,17,0,17,34
3327,17,17,0,15,49
3328,0,17,0,15,32
3329,15,17,49,17,98
3330,0,17,49,17,83
3331,0,33,16,17,66
3332,0,17,16,17,50
3334,52,32,0,17,101
3337,0,32,0,17,49
3339,17,18,15,16,66
3341,15,16,18,17,66
3343,0,35,17,15,67
3344,17,32,17,17,83
3345,0,32,17,17,66
3346,0,15,17,17,49
3347,168,32,17,17,234
3351,17,16,50,17,100
3354,16,33,17,15,81
3356,0,17,17,15,49
3357,0,32,17,17,66
3358,0,15,17,17,49
3359,0,34,49,19,102
3360,17,34,15,19,85
3361,0,34,15,19,68
3362,17,34,15,17,83
3364,19,32,17,17,85
3366,151,32,33,19,235
3367,0,34,17,17,68
3369,17,17,15,18,67
3370,0,17,15,18,50
3372,18,33,15,17,83
3373,33,32,33,19,117
3375,0,32,33,19,84
3376,0,17,33,19,69
3378,15,34,16,18,83
3379,19,15,16,18,68
3380,83,32,18,17,150
3382,34,18,15,17,84
3384,0,18,15,17,50
3389,32,33,18,16,99
3390,0,17,18,15,50
3391,33,34,50,17,134
3392,15,34,50,17,116
3393,0,34,50,17,101
3395,0,34,16,17,67
3396,0,17,16,17,50
3397,33,32,18,17,100
3398,0,17,17,15,49
3399,32,35,15,17,99
3401,0,35,15,17,67
3403,0,32,34,17,83
3404,0,17,34,17,68
3406,16,33,17,17,83
3407,499,34,17,16,566
3410,17,33,17,17,84
3411,0,33,17,17,67
3412,33,17,16,17,83
3414,0,17,16,17,50
3415,0,33,17,15,65
3416,17,32,18,17,84
3418,15,35,17,15,82
3420,0,17,17,15,49
3421,0,32,17,18,67
3423,0,35,15,16,66
3424,18,31,0,19,68
3425,0,31,0,19,50
3426,16,35,49,17,117
3427,0,35,49,17,101
3428,0,16,49,17,82
3432,17,33,0,18,68
3433,0,33,0,18,51
3434,100,16,0,18,134
3435,167,34,0,17,218
3437,0,34,17,16,67
3439,17,16,0,18,51
3440,16,35,15,17,83
3441,0,35,15,17,67
3442,32,17,134,17,200
3445,0,34,0,17,51
3447,0,32,17,16,65
3448,0,15,17,16,48
3450,34,17,17,17,85
3451,0,35,17,17,69
3453,99,34,16,17,166
3454,0,17,50,15,82
3456,17,32,50,17,116
3457,99,33,18,16,166
3458,15,34,16,17,82
3459,34,33,17,16,100
3461,0,33,17,16,66
3462,0,17,17,16,50
3463,0,33,18,16,67
3464,0,16,18,16,50
3465,0,34,17,17,68
3466,0,16,17,17,50
3467,0,34,17,16,67
3468,0,17,17,16,50
3469,33,32,18,17,100
3470,16,32,18,17,83
3471,0,32,18,17,67
3472,15,35,17,16,83
3473,35,33,50,16,134
3474,0,17,17,16,50
3475,0,33,50,16,99
3476,0,16,50,16,82
3478,18,33,50,17,118
3480,0,16,50,17,83
3481,0,33,17,17,67
3482,50,33,52,14,149
3483,102,31,17,17,167
3486,0,16,52,14,82
3487,0,35,48,17,100
3488,49,34,16,18,117
3492,17,34,16,17,84
3493,84,16,17,17,134
3494,18,33,50,17,118
3495,0,33,50,17,100
3496,17,33,17,17,84
3497,33,34,33,17,117
3499,0,34,33,17,84
3500,50,32,19,15,116
3501,0,33,17,15,65
3502,16,32,19,15,82
3504,49,35,50,15,149
3505,0,34,52,16,102
3507,0,35,50,15,100
3508,0,19,50,15,84
3509,298,35,16,17,366
3510,16,32,18,17,83
3511,32,35,49,16,132
3512,15,35,49,16,115
3513,0,35,49,16,100
3517,0,33,18,17,68
3518,16,35,15,17,83
3522,51,32,51,17,151
3523,0,34,83,17,134
3525,0,32,51,17,100
3526,32,18,16,17,83
3527,0,35,16,17,68
3530,0,17,16,16,49
3531,0,32,50,18,100
3533,0,35,15,18,68
3537,0,32,18,17,67
3538,0,17,18,17,52
3539,0,35,17,20,72
3540,0,17,17,20,54
3541,37,30,32,16,115
3542,0,20,46,16,82
3543,0,30,32,16,78
3546,16,35,16,17,84
3547,35,33,49,17,134
3548,52,32,17,17,118
3549,0,33,49,17,99
3551,32,34,50,17,133
3553,0,34,50,17,101
3554,0,17,50,17,84
3555,33,34,49,17,133
3556,0,16,17,17,50
3559,0,32,17,17,66
3561,0,34,17,16,67
3562,0,17,17,16,50
3563,33,33,0,18,84
3564,32,17,0,18,67
3565,0,33,0,18,51
3566,0,17,0,18,35
3569,0,34,50,18,102
3571,17,16,17,18,68
3572,0,16,17,18,51
3573,17,18,15,19,69
3574,18,34,47,17,116
3575,0,34,47,17,98
3576,19,32,15,17,83
3577,0,32,15,17,64
3578,0,17,15,17,49
3582,0,17,0,15,32
3583,0,32,0,17,49
3584,0,17,0,17,34
3587,0,34,15,17,66
3588,0,17,15,17,49
3590,0,17,100,16,133
3591,51,17,0,16,84
3592,0,16,35,16,67
3593,0,35,0,16,51
3595,0,32,0,16,48
3596,0,16,0,16,32
3597,0,34,50,17,101
3598,0,18,50,17,85
3599,0,34,33,17,84
3602,51,33,0,16,100
3603,0,34,0,17,51
3604,0,17,0,17,34
3605,0,33,0,16,49
3606,48,35,0,14,97
3608,0,16,35,14,65
3609,0,35,0,14,49
3610,17,33,17,16,83
3611,0,33,17,16,66
3612,0,19,17,16,52
3614,16,34,100,16,166
3615,0,34,100,16,150
3616,17,32,0,18,67
3617,0,32,0,18,50
3618,17,35,33,16,101
3622,0,18,33,15,66
3623,0,33,15,17,65
3624,116,33,17,17,183
3626,0,17,35,15,67
3627,0,35,49,16,100
3629,15,17,67,17,116
3630,0,17,67,17,101
3631,33,34,17,17,101
3633,0,34,17,17,68
3635,34,33,50,17,134
3636,0,17,16,17,50
3637,0,33,50,17,100
3638,0,17,50,17,84
3639,0,33,17,17,67
3641,0,34,15,18,67
3642,83,34,0,16,133
3643,0,33,14,19,66
3644,18,33,17,17,85
3645,0,33,17,17,67
3646,19,34,0,16,69
3647,0,34,0,16,50
3648,33,16,17,17,83
3650,0,16,17,17,50
3651,0,34,17,17,68
3652,0,17,17,17,51
3653,66,33,34,17,150
3654,0,17,0,15,32
3658,15,34,0,17,66
3661,0,34,34,15,83
3664,32,16,0,18,66
3669,166,33,0,17,216
3672,16,34,33,17,100
3673,84,16,0,20,120
3674,17,33,0,17,67
3675,0,33,0,17,50
3676,34,16,0,20,70
3678,36,13,0,17,66
3682,0,17,0,17,34
3684,0,16,17,16,49
3685,17,16,51,17,101
3686,16,35,16,17,84
3688,0,17,16,17,50
3689,0,33,15,19,67
3691,0,34,16,17,67
3692,68,17,15,17,117
3693,0,33,65,17,115
3694,33,17,15,17,82
3697,66,34,17,15,132
3698,0,17,17,17,51
3699,0,34,18,16,68
3700,35,16,17,15,83
3702,48,33,85,17,183
3703,0,32,17,16,65
3705,0,33,85,17,135
3708,51,34,15,18,118
3709,16,17,17,17,67
3710,17,34,15,18,84
3711,0,34,15,18,67
3712,50,32,18,16,116
3713,0,33,15,17,65
3714,18,32,18,16,84
3715,0,32,18,16,66
3716,335,15,50,17,417
3717,0,34,16,17,67
3718,0,16,16,17,49
3719,0,33,17,17,67
3720,17,34,0,15,66
3722,17,33,17,16,83
3723,0,33,17,16,66
3724,35,16,16,17,84
3725,0,33,16,17,66
3726,49,33,0,18,100
3727,33,33,0,18,84
3728,17,33,0,18,68
3729,0,33,0,18,51
3731,0,35,0,16,51
3735,17,15,50,17,99
3736,0,15,50,17,82
3737,0,35,50,15,100
3739,15,17,18,15,65
3740,35,15,18,16,84
3741,0,33,18,16,67
3742,33,16,18,15,82
3744,16,33,17,18,84
3745,0,33,17,18,68
3746,15,35,49,17,116
3750,0,16,17,17,50
3751,117,16,17,17,167
3752,17,33,50,16,116
3753,0,33,50,16,99
3754,0,17,50,16,83
3755,0,33,50,17,100
3756,84,34,99,17,234
3757,17,16,17,17,67
3758,16,34,34,15,99
3760,100,18,32,17,167
3761,34,32,0,17,83
3762,17,32,0,17,66
3763,0,32,0,17,49
3766,0,18,32,17,67
3768,15,34,0,15,64
3769,0,34,0,15,49
3770,0,17,0,15,32
3771,0,33,0,16,49
3772,0,18,0,16,34
3774,0,17,0,17,34
3775,0,34,0,16,50
3777,0,34,32,18,84
3780,17,34,17,15,83
3781,0,34,17,15,66
3782,116,33,32,19,200
3783,0,32,0,17,49
3784,15,34,17,17,83
3785,0,34,17,17,68
3786,0,17,17,17,51
3788,17,33,32,19,101
3789,0,33,32,19,84
3791,32,34,84,17,167
3792,15,34,84,17,150
3793,0,34,84,17,135
3794,0,15,84,17,116
3795,17,16,84,17,134
3796,16,34,17,17,84
3797,0,34,17,17,68
3798,17,34,50,16,117
3800,17,33,17,16,83
3801,0,33,17,16,66
3802,17,33,50,17,117
3803,0,33,50,17,100
3804,16,34,16,17,83
3806,17,33,16,18,84
3807,0,33,16,18,67
3808,51,32,17,19,119
3809,34,32,17,19,102
3810,168,15,17,17,217
3811,0,32,17,19,68
3812,16,36,49,15,116
3814,19,32,17,15,83
3816,17,32,18,15,82
3817,0,32,18,15,65
3818,0,15,18,15,48
3819,0,33,17,17,67
3822,17,34,0,17,68
3827,0,34,48,18,100
3829,0,33,15,18,66
3830,16,33,0,16,65
3831,33,33,0,18,84
3832,34,17,0,18,69
3833,0,33,0,18,51
3834,0,17,0,18,35
3835,0,34,0,16,50
3836,0,16,0,16,32
3837,0,33,0,17,50
3838,0,17,0,17,34
3839,0,33,0,17,50
3841,0,34,0,17,51
3842,0,17,0,17,34
3843,0,33,33,16,82
3844,0,16,33,16,65
3845,16,17,0,16,49
3846,17,34,16,17,84
3847,0,34,16,17,67
3850,17,34,16,16,83
3851,0,34,16,16,66
3852,0,18,16,16,50
3853,0,32,0,16,48
3854,16,34,67,17,134
3855,0,34,67,17,118
3857,34,33,17,16,100
3860,17,33,17,16,83
3861,17,16,17,16,66
3864,0,16,0,17,33
3865,0,33,50,17,100
3866,0,16,50,17,83
3867,0,35,15,17,67
3868,0,16,15,17,48
3870,17,33,17,18,85
3871,0,33,17,18,68
3873,0,35,48,17,100
3874,0,18,48,17,83
3876,17,32,17,17,83
3878,17,34,51,17,119
3879,17,17,51,17,102
3880,0,17,51,17,85
3881,0,33,18,17,68
3882,16,35,15,16,82
3883,0,35,15,16,66
3885,0,31,17,17,65
3886,16,34,50,17,117
3888,0,17,50,17,84
3890,16,34,17,17,84
3892,17,34,15,18,84
3893,0,34,15,18,67
3894,17,33,32,18,100
3896,18,32,0,18,68
3897,32,36,31,18,117
3899,0,36,31,18,85
3900,0,18,31,18,67
3901,0,31,0,18,49
3903,0,34,18,15,67
3905,0,33,16,17,66
3907,135,32,16,17,200
3909,35,32,50,17,134
3910,17,32,50,17,116
3911,0,32,50,17,99
3912,0,16,50,17,83
3914,17,32,16,17,82
3915,32,33,17,16,98
3917,33,33,18,15,99
3918,17,33,18,15,83
3919,33,33,17,17,100
3920,16,33,17,17,83
3922,49,33,18,15,115
3923,0,34,17,16,67
3925,33,33,18,17,101
3926,16,33,18,17,84
3927,0,33,18,17,68
3928,15,35,48,18,116
3929,35,32,16,18,101
3930,0,17,48,18,83
3931,0,32,16,18,66
3932,16,34,37,12,99
3933,16,18,37,12,83
3935,0,37,0,12,49
3937,30,33,0,16,79
3939,0,33,0,16,49
3942,0,16,0,17,33
3943,0,34,0,17,51
3944,0,17,0,17,34
3945,52,15,50,16,133
3946,0,16,0,19,35
3947,19,15,50,16,100
3950,49,34,0,18,101
3951,17,16,0,17,50
3952,16,34,0,18,68
3953,0,34,0,18,52
3955,67,33,17,17,134
3956,116,34,0,15,165
3957,32,33,17,17,99
3958,50,34,0,17,101
3959,0,33,17,17,67
3960,17,34,0,17,68
3961,51,17,0,15,83
3962,17,34,0,15,66
3964,0,17,0,15,32
3966,0,17,117,16,150
3967,0,35,16,16,67
3970,82,34,17,15,148
3973,33,34,17,15,99
3974,16,34,17,15,82
3975,34,32,18,17,101
3976,18,32,18,17,85
3978,15,35,17,16,83
3980,17,33,16,17,83
3981,0,33,16,17,66
3983,0,33,34,17,84
3984,34,17,17,15,83
3986,0,17,17,15,49
3987,0,32,0,17,49
3988,0,15,0,17,32
3990,0,18,0,15,33
3991,15,18,16,16,65
3992,50,35,0,16,101
3993,16,16,0,18,50
3994,16,35,0,16,67
3995,0,35,0,16,51
3996,0,17,0,16,33
3997,0,32,0,19,51
3999,0,34,67,17,118
4000,0,15,67,17,99
4002,0,16,0,19,35
4005,0,33,34,16,83
4006,0,16,34,16,66
4007,0,34,0,16,50
4008,17,32,0,18,67
4010,16,33,17,17,83
4011,18,15,17,17,67
4012,0,15,17,17,49
4014,17,34,0,17,68
4016,17,33,0,16,66
4019,0,33,0,17,50
4020,17,33,0,17,67
4021,17,16,0,17,50
4022,0,16,0,17,33
4023,0,33,17,17,67
4024,0,16,17,17,50
4026,17,34,0,15,66
4027,18,16,0,15,49
4028,16,33,0,15,64
4029,0,33,0,15,48
4030,0,18,0,15,33
4031,0,33,0,17,50
4032,0,18,0,17,35
4033,0,33,0,17,50
4034,0,16,0,17,33
4035,0,33,0,18,51
4036,0,16,0,18,34
4037,0,33,50,19,102
4042,19,32,0,17,68
4043,0,32,0,17,49
4045,0,34,16,17,67
4046,0,17,16,17,50
4047,99,35,15,17,166
4048,17,34,0,16,67
4049,0,34,0,16,50
4051,0,32,0,18,50
4052,0,16,0,18,34
4053,0,35,15,17,67
4055,32,33,17,15,97
4057,0,33,17,15,65
4058,48,36,33,17,134
4060,15,36,33,17,101
4061,0,36,33,17,86
4062,0,16,33,17,66
4063,0,33,34,16,83
4064,18,34,0,16,68
4065,0,34,0,16,50
4066,0,17,0,16,33
4067,0,32,0,17,49
4068,0,16,0,17,33
4069,0,34,17,16,67
4070,0,17,17,16,50
4071,33,34,16,16,99
4072,16,34,16,16,82
4073,17,17,16,16,66
4074,33,16,0,17,66
4075,16,16,0,17,49
4076,16,34,0,16,66
4077,0,34,0,16,50
4081,0,32,0,17,49
4082,16,33,18,17,84
4083,0,33,18,17,68
4084,0,16,18,17,51
4085,18,17,48,18,101
4087,0,33,49,17,99
4089,0,33,16,17,66
4090,18,33,17,17,85
4093,0,34,0,15,49
4094,133,17,0,16,166
4095,116,17,0,16,149
4096,18,34,0,15,67
4098,0,18,0,15,33
4100,0,18,16,17,51
4101,16,17,0,16,49
4103,0,32,0,18,50
4104,0,16,0,18,34
4105,35,33,0,16,84
4106,0,17,0,15,32
4107,0,33,0,16,49
4108,0,18,0,16,34
4109,0,34,0,16,50
4110,0,18,0,16,34
4111,0,33,0,16,49
4112,0,17,0,16,33
4114,0,17,32,18,67
4115,0,32,0,18,50
4116,0,15,0,18,33
4117,0,35,34,16,85
4119,0,34,31,18,83
4120,0,19,31,18,68
4121,49,17,16,17,99
4122,0,15,18,17,50
4123,68,34,16,17,135
4124,0,17,16,17,50
4127,20,14,16,17,67
4128,14,33,16,17,80
4129,0,33,16,17,66
4130,17,33,34,15,99
4131,0,33,34,15,82
4133,17,17,15,17,66
4135,0,32,0,17,49
4137,0,34,67,15,116
4138,0,17,67,15,99
4139,34,33,33,16,116
4140,17,33,33,16,99
4142,18,33,0,16,67
4144,0,18,0,16,34
4146,0,18,0,16,34
4147,0,31,0,17,48
4148,0,15,0,17,32
4149,0,34,0,18,52
4150,0,17,0,18,35
4152,0,16,0,17,33
4153,0,34,34,15,83
4154,0,17,34,15,66
4155,0,34,32,16,82
4158,17,34,16,17,84
4161,0,33,0,17,50
4162,17,33,17,17,84
4164,0,16,17,17,50
4165,17,17,0,17,51
4166,0,17,0,17,34
4168,0,17,0,15,32
4169,0,32,0,16,48
4170,50,34,17,16,117
4173,0,34,17,16,67
4175,0,33,51,15,99
4177,0,33,33,17,83
4178,16,33,17,18,84
4179,0,33,17,18,68
4180,50,33,50,17,150
4181,17,18,15,18,68
4182,0,18,15,18,51
4183,0,33,50,17,100
4186,50,33,16,16,115
4187,0,35,16,17,68
4188,17,33,16,16,82
4189,0,33,16,16,65
4190,17,32,17,17,83
4191,0,32,17,17,66
4193,0,34,67,16,117
4195,0,34,14,19,67
4196,17,33,50,17,117
4197,0,33,50,17,100
4198,19,33,83,18,153
4199,0,33,83,18,134
4201,0,34,183,17,234
4202,84,33,15,18,150
4203,0,34,49,17,100
4204,17,33,16,17,83
4206,18,33,15,18,84
4207,0,33,15,18,66
4208,17,33,16,17,83
4209,0,33,16,17,66
4212,17,34,16,17,84
4213,0,34,16,17,67
4214,17,33,17,16,83
4216,17,33,18,15,83
4217,0,33,18,15,66
4218,83,34,50,15,182
4220,15,34,17,17,83
4223,34,33,50,17,134
4225,0,33,50,17,100
4226,18,32,18,17,85
4227,0,32,18,17,67
4228,0,15,18,17,50
4229,0,35,15,16,66
4231,0,31,0,19,50
4232,35,17,0,15,67
4233,36,32,16,19,103
4234,32,17,16,19,84
4235,0,32,16,19,67
4236,0,17,16,19,52
4237,16,19,48,17,100
4238,19,32,33,18,102
4239,48,17,18,14,97
4242,17,32,0,18,67
4244,32,17,34,16,99
4245,0,35,34,16,85
4247,17,17,33,17,84
4248,17,33,0,17,67
4249,0,33,0,17,50
4250,34,16,16,16,82
4251,17,16,16,16,65
4253,0,32,18,16,66
4255,0,34,18,16,68
4257,0,34,17,17,68
4259,0,34,16,17,67
4260,0,17,16,17,50
4263,34,32,17,18,101
4264,17,32,17,18,84
4265,0,32,17,18,67
4266,0,16,17,18,51
4268,0,18,16,17,51
4269,16,17,65,17,115
4270,17,32,18,15,82
4271,0,32,18,15,65
4273,18,15,17,17,67
4276,0,17,0,17,34
4277,0,32,35,17,84
4279,0,35,34,15,84
4282,0,17,0,15,32
4283,0,32,50,16,98
4285,0,34,16,16,66
4286,0,17,16,16,49
4287,16,16,0,17,49
4288,16,34,17,17,84
4290,17,34,0,16,67
4291,0,34,0,16,50
4292,17,34,0,16,67
4293,0,34,0,16,50
4296,0,18,0,15,33
4297,0,33,15,16,64
4298,0,18,15,16,49
4300,0,16,84,18,118
4301,0,34,17,18,69
4302,16,35,82,17,150
4305,99,32,17,19,167
4309,0,33,17,15,65
4310,17,32,17,19,85
4312,0,15,17,19,51
4314,19,31,17,17,84
4315,31,34,33,17,115
4317,0,34,33,17,84
4319,0,33,0,17,50
4320,0,17,0,17,34
4321,17,18,32,17,84
4322,0,18,32,17,67
4324,17,33,16,18,84
4326,0,16,16,18,50
4328,0,18,0,17,35
4330,0,15,0,18,33
4331,0,35,15,17,67
4332,17,32,0,18,67
4334,0,17,0,18,35
4336,17,32,0,18,67
4337,0,32,0,18,50
4338,0,17,0,18,35
4340,0,15,16,17,48
4341,0,33,0,18,51
4343,0,36,0,16,52
4344,0,18,0,16,34
4346,33,15,0,17,65
4349,0,35,33,15,83
4350,0,18,33,15,66
4351,33,33,17,17,100
4352,16,33,17,17,83
4353,15,18,17,17,67
4354,0,18,17,17,52
4355,0,34,32,18,84
4356,0,17,32,18,67
4359,0,33,17,17,67
4360,15,34,50,17,116
4361,34,33,17,17,101
4363,0,33,17,17,67
4364,15,34,0,16,65
4365,34,34,0,15,83
4367,49,17,0,17,83
4368,0,18,0,15,33
4369,0,32,0,17,49
4371,68,31,0,19,118
4376,15,34,0,18,67
4377,19,15,0,18,52
4378,15,35,0,15,65
4379,18,17,0,15,50
4381,0,32,0,18,50
4385,0,35,50,17,102
4386,17,32,35,15,99
4387,0,32,35,15,82
4388,15,35,82,17,149
4389,0,35,82,17,134
4390,17,32,18,16,83
4392,0,17,18,16,51
4393,0,34,16,17,67
4394,16,33,66,17,132
4395,16,17,66,17,116
4396,17,34,49,17,117
4397,0,34,49,17,100
4398,0,17,49,17,83
4399,16,16,17,17,66
4402,0,17,51,15,83
4404,33,15,50,17,115
4406,0,15,50,17,82
4408,17,33,17,17,84
4409,33,34,49,18,134
4410,17,34,49,18,118
4411,0,34,49,18,101
4412,84,34,98,17,233
4414,51,34,98,17,200
4419,0,33,0,15,48
4421,82,18,0,17,117
4422,0,17,17,16,50
4423,0,33,0,17,50
4424,0,16,0,17,33
4425,0,35,0,17,52
4427,32,33,17,17,99
4428,0,15,0,18,33
4429,0,33,17,17,67
4431,0,34,0,16,50
4432,0,17,0,16,33
4433,0,33,0,17,50
4434,52,32,0,16,100
4436,0,18,0,16,34
4437,0,32,0,16,48
4438,16,33,34,17,100
4440,0,17,34,17,68
4441,17,17,0,17,51
4442,116,38,47,15,216
4444,50,32,85,15,182
4445,17,16,0,17,50
4446,0,16,0,17,33
4447,70,32,15,15,132
4449,0,38,47,15,100
4450,21,32,15,15,83
4451,62,35,0,16,113
4452,49,35,0,16,100
4454,15,35,0,16,66
4455,0,35,0,16,51
4456,0,19,0,16,35
4457,0,33,67,17,117
4459,16,17,0,17,50
4460,17,34,32,17,100
4461,0,34,32,17,83
4462,0,17,32,17,66
4464,0,15,0,17,32
4466,0,17,33,17,67
4468,17,34,16,17,84
4470,17,33,0,17,67
4471,0,33,0,17,50
4472,0,17,0,17,34
4473,0,34,16,16,66
4474,0,17,16,16,49
4476,16,34,17,15,82
4477,0,34,17,15,66
4478,17,32,17,21,87
4480,15,38,47,17,117
4482,21,30,50,17,118
4483,0,30,50,17,97
4484,17,34,16,17,84
4486,17,33,15,18,83
4489,0,33,17,17,67
4490,18,34,0,18,70
4491,0,34,0,18,52
4493,0,33,32,17,82
4494,0,15,32,17,64
4495,0,32,0,17,49
4496,17,33,18,16,84
4497,17,16,18,16,67
4499,18,16,33,17,84
4500,49,34,0,16,99
4501,0,33,17,17,67
4502,15,34,0,16,65
4503,0,34,0,16,50
4504,0,17,0,16,33
4506,0,17,18,16,51
4507,18,16,66,18,118
4508,16,33,17,16,82
4510,0,17,17,16,50
4511,51,16,0,15,82
4512,50,33,16,18,117
4514,0,16,0,15,31
4515,0,33,16,18,67
4516,0,18,16,18,52
4517,0,34,0,16,50
4518,18,34,32,16,100
4519,0,34,32,16,82
4521,0,32,0,16,48
4523,0,33,0,16,49
4526,0,18,0,17,35
4528,0,17,17,16,50
4530,0,16,0,17,33
4532,15,34,17,16,82
4533,0,34,17,16,67
4534,17,33,18,17,85
4536,16,35,65,16,132
4538,0,17,65,16,98
4539,0,31,0,17,48
4540,15,34,0,16,65
4541,0,34,0,16,50
4542,0,17,0,16,33
4543,0,34,0,17,51
4544,0,18,0,17,35
4545,0,34,0,15,49
4547,0,32,0,17,49
4548,0,17,0,17,34
4549,0,34,50,17,101
4550,0,17,50,17,84
4552,17,33,15,18,83
4555,48,17,18,16,99
4556,18,32,18,16,84
4557,15,17,18,16,66
4559,0,34,0,17,51
4560,16,34,17,16,83
4561,0,34,17,16,67
4565,0,32,35,16,83
4566,0,15,35,16,66
4569,0,33,0,17,50
4572,0,16,0,17,33
4573,0,33,0,17,50
4574,0,16,0,17,33
4576,0,17,0,17,34
4577,0,34,0,15,49
4579,0,33,0,17,50
4580,0,18,0,17,35
4581,0,32,0,17,49
4582,15,34,17,17,83
4583,17,17,17,17,68
4584,0,17,17,17,51
4585,0,34,32,18,84
4586,17,32,34,17,100
4587,0,32,34,17,83
4589,51,17,17,17,102
4590,0,16,34,17,67
4591,17,17,17,17,68
4592,0,17,17,17,51
4593,0,34,66,16,116
4594,0,17,66,16,99
4597,0,34,0,16,50
4600,0,17,17,17,51
4601,34,34,0,14,82
4602,17,34,0,14,65
4603,0,34,0,14,48
4606,0,18,34,16,68
4607,34,32,0,18,84
4608,18,32,0,18,68
4609,0,32,0,18,50
4611,0,35,0,16,51
4612,0,17,0,16,33
4613,0,32,0,16,48
4615,0,34,17,17,68
4617,34,33,15,17,99
4618,17,33,15,17,82
4619,0,33,15,17,65
4621,32,35,15,17,99
4622,17,35,15,17,84
4624,17,32,18,15,82
4627,0,33,16,17,66
4628,15,33,17,17,82
4629,0,33,17,17,67
4633,0,33,18,15,66
4634,0,16,18,15,49
4636,15,35,0,17,67
4637,18,17,0,17,52
4638,0,17,0,17,34
4639,0,32,0,18,50
4640,15,33,18,16,82
4641,0,33,18,16,67
4645,0,34,0,16,50
4646,0,17,0,16,33
4647,0,33,16,17,66
4649,33,34,0,17,84
4650,17,34,0,17,68
4652,17,32,0,17,66
4653,0,32,0,17,49
4655,68,33,0,17,118
4657,34,33,0,17,84
4658,17,33,0,17,67
4660,17,32,34,17,100
4661,0,32,34,17,83
4663,0,34,17,16,67
4664,16,33,18,17,84
4665,17,16,18,17,68
4667,0,35,0,15,50
4669,0,32,17,16,65
4670,0,17,17,16,50
4676,17,34,0,17,68
4677,0,34,0,17,51
4678,17,33,33,18,101
4679,17,16,33,18,84
4682,0,16,34,16,66
4683,0,34,33,16,83
4684,0,16,33,16,65
4685,0,33,33,17,83
4686,0,17,33,17,67
4687,0,33,0,17,50
4688,17,34,34,15,100
4689,0,34,34,15,83
4691,0,34,32,18,84
4694,0,17,0,18,35
4695,18,15,18,17,68
4697,18,17,32,17,84
4700,17,34,17,17,85
4701,51,17,17,18,103
4702,17,34,17,18,86
4705,35,32,32,17,116
4707,0,32,32,17,81
4708,17,32,0,17,66
4709,0,32,0,17,49
4710,0,17,0,17,34
4711,0,33,17,17,67
4712,0,16,17,17,50
4713,0,34,0,16,50
4715,51,16,50,17,134
4716,0,17,18,16,51
4717,18,16,50,17,101
4720,16,35,0,15,66
4721,0,35,0,15,50
4722,17,32,0,17,66
4723,0,32,0,17,49
4725,0,33,34,17,84
4727,34,35,0,15,84
4728,17,35,0,15,67
4729,17,18,0,15,50
4730,0,18,0,15,33
4731,0,32,0,17,49
4732,0,17,0,17,34
4733,0,33,0,17,50
4734,0,16,0,17,33
4736,0,18,0,15,33
4738,53,30,16,18,117
4739,0,36,30,16,82
4741,0,30,16,18,64
4742,16,34,17,17,84
4745,0,34,98,18,150
4746,17,32,18,17,84
4747,0,32,18,17,67
4748,17,35,49,17,118
4749,18,17,49,17,101
4750,17,31,18,17,83
4751,0,31,18,17,66
4752,14,35,15,17,81
4753,18,17,15,17,67
4755,32,35,16,17,100
4756,17,35,16,17,85
4757,0,35,16,17,68
4758,18,33,17,16,84
4759,50,16,17,17,100
4762,0,16,17,17,50
4763,17,17,17,16,67
4765,17,16,50,17,100
4766,0,16,50,17,83
4767,0,33,17,17,67
4768,0,18,17,17,52
4769,0,34,15,18,67
4770,0,17,15,18,50
4772,0,18,50,16,84
4773,0,34,16,16,66
4774,33,16,18,16,83
4775,16,16,18,16,66
4777,0,34,50,15,99
4778,0,16,50,15,81
4779,0,34,16,15,65
4781,16,15,18,17,66
4782,0,15,18,17,50
4783,0,35,50,17,102
4785,0,33,17,17,67
4787,0,34,16,16,66
4788,17,32,17,17,83
4792,17,34,17,16,84
4793,0,34,17,16,67
4795,0,33,49,18,100
4797,0,32,67,17,116
4798,15,35,17,15,82
4799,0,35,17,15,67
4800,18,32,17,17,84
4801,0,32,17,17,66
4802,15,34,17,17,83
4803,0,34,17,17,68
4806,17,30,20,16,83
4808,0,14,20,16,50
4809,0,36,51,15,102
4810,50,32,52,16,150
4811,0,34,17,15,66
4812,18,32,52,16,118
4813,17,15,52,16,100
4814,0,15,52,16,83
4819,33,33,17,16,99
4820,17,33,17,16,83
4821,0,33,17,16,66
4822,34,16,16,17,83
4825,0,33,18,17,68
4826,17,35,16,16,84
4827,35,32,17,17,101
4828,33,16,17,17,83
4831,34,34,65,18,151
4832,83,33,18,15,149
4833,34,32,17,16,99
4834,32,17,17,16,82
4835,0,32,17,16,65
4836,34,16,18,15,83
4837,0,33,18,15,66
4839,0,33,54,13,100
4840,0,15,54,13,82
4842,0,17,19,13,49
4843,0,32,17,17,66
4844,0,13,17,17,47
4845,0,34,17,17,68
4846,17,34,15,17,83
4847,0,34,15,17,66
4849,32,33,0,18,83
4851,0,33,0,18,51
4854,0,16,0,16,32
4855,0,34,17,15,66
4856,50,34,34,16,134
4857,0,32,52,16,100
4858,15,34,34,16,99
4859,34,34,33,16,117
4860,16,34,33,16,99
4861,0,34,33,16,83
4862,16,33,16,17,82
4863,0,33,16,17,66
4864,0,17,16,17,50
4865,0,33,18,15,66
4866,35,15,33,17,100
4870,0,15,0,17,32
4871,0,35,32,17,84
4872,0,18,32,17,67
4874,17,34,0,16,67
4875,0,34,0,16,50
4876,0,17,0,16,33
4877,0,33,17,16,66
4878,17,33,0,18,68
4880,16,33,0,17,66
4881,18,15,0,17,50
4887,17,17,0,17,51
4888,0,17,0,17,34
4889,0,33,34,15,82
4891,0,34,0,15,49
4893,0,33,83,16,132
4894,0,18,83,16,117
4895,0,33,0,17,50
4898,0,16,17,16,49
4901,0,35,0,15,50
4902,17,32,16,19,84
4903,15,17,16,19,67
4904,0,17,16,19,52
4905,16,19,33,17,85
4906,19,33,48,17,117
4907,0,33,48,17,98
4908,0,17,48,17,82
4909,65,35,0,16,116
4910,0,15,16,17,48
4911,16,17,0,17,50
4914,0,18,0,16,34
4915,0,33,0,17,50
4916,17,34,15,17,83
4917,0,34,15,17,66
4918,0,17,15,17,49
4920,17,34,0,17,68
4922,17,34,0,15,66
4924,0,17,0,15,32
4925,0,32,83,17,132
4926,0,17,83,17,117
4927,0,34,84,17,135
4928,183,34,0,16,233
4929,0,32,17,17,66
4930,16,34,18,17,85
4931,17,17,18,17,69
4933,0,35,0,15,50
4934,17,32,17,17,83
4935,0,32,17,17,66
4936,34,17,0,17,68
4937,17,17,0,17,51
4938,17,34,0,16,67
4942,0,17,0,15,32
4943,0,32,0,17,49
4944,0,17,0,17,34
4945,0,33,18,15,66
4946,34,15,35,15,99
4947,0,33,35,15,83
4948,0,15,35,15,65
4950,0,17,66,18,101
4952,0,17,17,17,51
4953,34,34,0,17,85
4954,17,34,0,17,68
4956,0,16,0,17,33
4957,17,16,34,16,83
4958,0,16,34,16,66
4959,15,19,0,16,50
4960,0,19,0,16,35
4961,0,32,0,16,48
4962,0,16,0,16,32
4963,16,17,17,17,67
4964,0,17,17,17,51
4965,17,17,0,17,51
4966,17,34,15,17,83
4968,17,32,0,18,67
4969,0,32,0,18,50
4970,0,17,0,18,35
4971,0,34,16,16,66
4972,0,16,16,16,48
4974,101,16,0,17,134
4978,16,33,0,17,66
4979,17,16,0,17,50
4980,0,16,0,17,33
4981,17,17,67,17,118
4982,0,17,67,17,101
4985,0,33,50,15,98
4986,0,20,50,15,85
4987,17,17,16,15,65
4988,0,17,16,15,48
4989,0,31,50,18,99
4991,0,35,15,18,68
4992,17,33,0,17,67
4995,0,32,18,17,67
4997,18,17,0,16,51
4999,0,32,0,18,50
5000,0,16,0,18,34
5003,68,33,32,18,151
5004,0,17,67,17,101
5006,16,33,32,18,99
5007,0,33,32,18,83
5008,0,16,32,18,66
5010,0,15,0,18,33
5013,18,17,32,17,84
5014,17,32,0,17,66
5015,0,32,0,17,49
5016,0,17,0,17,34
5019,0,33,16,15,64
5020,17,31,0,18,66
5021,0,31,0,18,49
5022,15,35,0,17,67
5023,0,35,0,17,52
5024,0,17,0,17,34
5026,0,18,0,16,34
5027,0,33,32,18,83
5028,0,17,32,18,67
5029,15,17,18,17,67
5030,0,17,18,17,52
5032,17,32,0,17,66
5033,0,32,0,17,49
5034,0,17,0,17,34
5035,17,17,0,16,50
5036,0,17,0,16,33
5037,0,32,18,16,66
5040,16,33,17,17,83
5042,15,34,0,17,66
5044,0,17,0,17,34
5045,101,32,0,17,150
5046,0,16,33,17,66
5047,50,18,0,15,83
5049,0,35,0,15,50
5050,0,18,0,15,33
5052,0,17,0,17,34
5053,0,34,32,18,84
5055,0,32,0,18,50
5057,0,32,0,19,51
5058,0,14,0,19,33
5060,17,34,0,15,66
5061,0,34,0,15,49
5062,18,32,35,15,100
5064,17,35,0,15,67
5065,0,35,0,15,50
5066,0,18,0,15,33
5067,0,32,16,17,65
5068,118,33,16,17,184
5070,17,34,17,17,85
5071,0,34,17,17,68
5072,0,18,17,17,52
5075,0,33,16,17,66
5076,0,18,16,17,51
5077,16,17,0,16,49
5078,0,17,0,16,33
5079,33,33,50,17,133
5080,50,33,17,17,117
5081,17,16,50,17,100
5083,0,33,17,17,67
5084,16,34,33,17,100
5085,0,34,33,17,84
5088,0,15,0,17,32
5090,0,16,17,16,49
5091,0,33,17,17,67
5092,16,34,34,16,100
5093,51,17,16,17,101
5094,17,34,16,17,84
5095,0,34,16,17,67
5096,17,33,16,17,83
5097,0,33,16,17,66
5098,0,17,16,17,50
5100,51,32,0,18,101
5101,0,34,0,17,51
5102,0,18,0,17,35
5103,0,32,0,18,50
5105,0,35,15,17,67
5108,51,34,33,16,134
5109,0,34,0,17,51
5110,17,34,33,16,100
5111,49,18,0,16,83
5113,0,33,0,16,49
5114,18,33,0,17,68
5116,0,17,0,17,34
5117,0,34,0,16,50
5118,0,17,0,16,33
5119,0,32,18,17,67
5124,0,18,32,16,66
5125,0,32,0,16,48
5126,17,33,34,17,101
5127,0,33,34,17,84
5129,0,34,0,17,51
5130,16,33,17,16,82
5133,0,33,0,18,51
5134,16,34,0,17,67
5135,0,34,0,17,51
5136,0,16,0,17,33
5137,0,33,17,17,67
5138,16,34,18,15,83
5139,0,34,18,15,67
5141,0,33,0,17,50
5142,15,34,15,17,81
5143,0,34,15,17,66
5144,0,17,15,17,49
5145,15,17,0,17,49
5146,17,34,50,17,118
5147,0,34,50,17,101
5148,0,17,50,17,84
5149,0,33,17,17,67
5150,15,34,50,17,116
5152,17,33,17,17,84
5154,17,34,0,17,68
5155,51,15,101,16,183
5156,17,32,101,16,166
5158,15,34,0,17,66
5161,0,33,18,16,67
5162,0,16,18,16,50
5164,16,33,16,17,82
5165,0,33,16,17,66
5166,17,33,0,18,68
5167,0,33,0,18,51
5168,17,34,66,17,134
5169,0,34,66,17,117
5170,16,34,0,16,66
5171,34,32,17,16,99
5172,17,32,17,16,82
5175,0,33,17,17,67
5176,0,16,17,17,50
5177,17,17,17,17,68
5179,0,34,17,16,67
5181,17,16,33,18,84
5182,16,33,18,15,82
5183,0,33,18,15,66
5184,0,17,18,15,50
5185,0,33,0,17,50
5187,0,34,0,18,52
5188,0,17,0,18,35
5189,18,15,0,17,50
5190,0,15,0,17,32
5191,0,33,0,17,50
5192,0,16,0,17,33
5193,0,34,32,18,84
5194,0,17,32,18,67
5196,15,36,0,15,66
5197,0,36,0,15,51
5198,50,34,16,17,117
5201,0,34,16,17,67
5202,18,33,15,17,83
5203,0,33,15,17,65
5204,17,32,51,17,117
5205,0,32,51,17,100
5206,0,17,51,17,85
5207,51,17,17,16,101
5208,0,17,17,17,51
5209,0,34,17,16,67
5210,17,33,83,17,150
5211,0,33,83,17,133
5213,0,33,16,17,66
5215,0,33,17,17,67
5216,17,34,18,16,85
5218,17,34,17,15,83
5219,0,34,17,15,66
5220,0,16,17,15,48
5222,33,16,97,20,166
5223,0,34,97,20,151
5225,0,33,17,17,67
5229,0,30,37,17,84
5231,0,37,0,17,54
5232,0,17,0,17,34
5233,0,33,17,17,67
5234,0,16,17,17,50
5235,0,34,0,14,48
5236,0,17,0,14,31
5238,0,18,101,16,135
5239,17,16,0,17,50
5240,0,16,0,17,33
5241,0,34,16,18,68
5243,16,18,50,17,101
5244,18,33,66,16,133
5247,34,32,16,18,100
5248,17,32,16,18,83
5249,0,32,16,18,66
5250,16,34,0,17,67
5252,0,18,0,17,35
5253,0,34,50,16,100
5256,0,17,17,16,50
5257,17,16,16,17,66
5258,0,16,16,17,49
5260,17,33,35,15,100
5261,0,33,35,15,83
5262,51,32,17,17,117
5265,0,32,17,17,66
5266,0,17,17,17,51
5267,0,34,15,17,66
5268,17,32,34,16,99
5269,0,32,34,16,82
5271,0,34,51,16,101
5272,17,33,18,16,84
5273,183,18,0,15,216
5274,51,33,66,17,167
5275,0,34,16,17,67
5276,16,33,66,17,132
5278,17,34,0,15,66
5279,0,34,0,15,49
5282,17,35,0,15,67
5283,0,35,0,15,50
5284,0,18,0,15,33
5286,50,34,0,17,101
5289,34,34,15,18,101
5290,0,16,0,17,33
5293,33,32,17,17,99
5294,18,32,17,17,84
5297,34,33,51,16,134
5298,0,17,33,18,68
5299,0,33,51,16,100
5300,16,33,50,17,116
5301,0,33,50,17,100
5302,0,15,50,17,82
5303,84,17,50,17,168
5305,0,33,17,17,67
5306,0,17,17,17,51
5307,34,33,83,17,167
5308,33,17,83,17,150
5310,83,34,18,15,150
5312,0,17,49,17,83
5313,0,32,34,18,84
5315,0,34,18,15,67
5316,0,17,18,15,50
5317,0,33,17,17,67
5318,0,15,17,17,49
5322,84,33,0,16,133
5323,0,32,0,17,49
5324,15,34,67,17,133
5325,0,34,67,17,118
5326,0,17,67,17,101
5327,0,33,0,16,49
5328,16,34,67,16,133
5329,0,34,67,16,117
5330,0,18,67,16,101
5333,0,35,0,16,51
5335,0,33,0,17,50
5336,17,32,34,18,101
5337,0,32,34,18,84
5338,0,15,34,18,67
5339,0,34,0,18,52
5340,17,34,0,16,67
5341,18,16,0,16,50
5342,0,16,0,16,32
5343,0,33,17,15,65
5346,0,15,51,17,83
5347,0,35,16,17,68
5348,18,33,49,18,118
5349,0,33,49,18,100
5350,17,34,15,18,84
5351,0,34,15,18,67
5353,0,33,67,16,116
5355,0,33,50,17,100
5357,0,34,52,13,99
5358,17,33,19,13,82
5359,16,17,19,13,65
5361,0,32,17,18,67
5362,13,35,33,16,97
5364,18,33,16,18,85
5366,33,18,32,16,99
5367,16,18,32,16,82
5368,0,18,32,16,66
5369,0,32,0,16,48
5371,33,33,17,17,100
5372,0,17,17,16,50
5374,0,16,17,17,50
5375,0,34,0,17,51
5378,0,17,83,17,117
5380,17,34,16,17,84
5382,0,17,16,17,50
5385,49,17,33,17,116
5387,0,33,33,17,83
5388,0,17,33,17,67
5389,33,35,32,17,117
5390,15,35,32,17,99
5393,0,32,0,17,49
5394,17,33,16,18,84
5395,0,33,16,18,67
5397,16,18,0,16,50
5400,0,17,51,16,84
5401,51,16,18,16,101
5402,16,34,18,16,84
5403,0,34,18,16,68
5406,0,16,16,17,49
5407,0,33,0,17,50
5408,0,17,0,17,34
5411,16,16,0,17,49
5412,0,16,0,17,33
5413,0,34,18,15,67
5415,18,15,18,16,67
5416,15,34,16,19,84
5417,18,16,16,19,69
5418,0,16,16,19,51
5419,16,19,16,15,66
5421,16,15,18,17,66
5422,0,15,18,17,50
5425,0,32,16,18,66
5426,50,33,33,18,134
5427,16,18,16,17,67
5428,0,18,16,17,51
5429,0,33,33,18,84
5431,0,33,0,18,51
5432,15,33,18,17,83
5433,18,15,18,17,68
5434,0,15,18,17,50
5435,0,35,15,17,67
5436,17,32,16,17,82
5438,17,33,17,16,83
5440,0,17,17,16,50
5442,16,36,16,15,83
5444,0,19,16,15,50
5447,0,35,15,17,67
5448,18,32,17,16,83
5449,0,32,17,16,65
5450,17,33,18,17,85
5451,17,16,18,17,68
5453,35,33,15,18,101
5454,17,33,15,18,83
5455,0,33,15,18,66
5456,51,34,16,17,118
5457,0,33,17,17,67
5458,0,18,17,17,52
5459,0,34,16,17,67
5460,17,33,17,16,83
5461,0,33,17,16,66
5462,17,33,50,16,116
5464,16,34,16,16,82
5465,16,18,16,16,66
5466,0,18,16,16,50
5467,32,34,16,16,98
5468,0,16,66,18,100
5469,17,17,16,16,66
5470,0,17,16,16,49
5473,0,35,0,17,52
5474,0,17,0,17,34
5476,0,17,15,18,50
5479,0,33,32,17,82
5480,0,18,32,17,67
5481,0,32,50,17,99
5482,0,15,50,17,82
5483,0,35,15,17,67
5486,0,17,18,16,51
5487,0,34,16,17,67
5488,16,33,17,16,82
5489,0,33,17,16,66
5490,0,17,17,16,50
5492,16,35,17,16,84
5493,0,35,17,16,68
5494,0,18,17,16,51
5495,0,33,17,15,65
5497,0,32,34,17,83
5498,15,34,17,15,81
5499,0,34,17,15,66
5500,17,32,18,16,83
5501,50,16,50,17,133
5502,0,15,18,16,49
5504,0,16,50,17,83
5505,34,33,17,17,101
5506,18,33,17,17,85
5508,0,17,17,17,51
5509,0,34,17,17,68
5512,132,18,15,18,183
5513,0,31,51,16,98
5516,0,17,67,15,99
5519,0,35,15,18,68
5521,0,33,0,17,50
5522,18,32,0,17,67
5523,32,33,0,18,83
5524,0,15,0,17,32
5525,0,33,0,18,51
5528,0,16,0,18,34
5531,0,34,0,17,51
5534,0,18,33,15,66
5537,0,32,33,17,82
5538,17,33,0,17,67
5539,18,15,0,17,50
5541,0,34,18,16,68
5543,18,16,16,17,67
5544,0,16,16,17,49
5545,0,33,17,17,67
5546,0,17,17,17,51
5547,0,34,32,18,84
5548,100,17,15,17,149
5549,0,32,18,15,65
5550,0,17,18,15,50
5551,0,33,50,17,100
5553,18,17,15,17,67
5554,0,17,15,17,49
5555,0,32,16,17,65
5556,0,17,16,17,50
5557,0,33,52,15,100
5558,17,34,18,15,84
5561,0,33,17,17,67
5563,0,34,16,17,67
5564,17,33,18,14,82
5565,0,33,18,14,65
5567,0,32,19,17,68
5568,0,14,19,17,50
5569,0,36,48,17,101
5571,0,33,15,17,65
5572,0,15,15,17,47
5573,15,17,50,17,99
5574,17,33,51,17,118
5577,0,34,17,17,68
5578,0,17,17,17,51
5580,0,17,49,18,84
5582,0,16,17,18,51
5584,0,18,15,18,51
5587,0,33,33,17,83
5588,0,17,33,17,67
5589,0,33,50,16,99
5590,17,33,17,16,83
5593,0,33,18,17,68
5594,16,35,50,15,116
5595,0,35,50,15,100
5599,0,33,18,17,68
5600,15,35,15,17,82
5601,35,32,17,17,101
5602,17,32,17,17,83
5604,0,17,17,17,51
5605,0,34,17,15,66
5608,32,18,0,16,66
5610,0,18,0,16,34
5611,0,32,0,18,50
5613,0,34,17,17,68
5614,0,16,17,17,50
5615,0,34,0,18,52
5618,0,14,0,17,31
5620,0,16,34,18,68
5621,18,16,0,18,52
5622,0,16,0,18,34
5623,0,34,0,17,51
5625,0,33,0,18,51
5626,0,16,0,18,34
5629,34,32,0,17,83
5630,17,32,0,17,66
5631,0,32,0,17,49
5632,117,33,0,17,167
5633,0,35,0,17,52
5635,0,34,33,16,83
5637,0,33,33,17,83
5638,17,33,0,17,67
5640,100,16,35,15,166
5641,17,18,0,16,51
5642,0,18,0,16,34
5643,31,33,35,15,114
5644,0,15,0,17,32
5645,0,33,35,15,83
5646,0,16,35,15,66
5648,17,32,17,15,81
5652,15,35,17,17,84
5653,35,34,17,15,101
5654,34,17,17,15,83
5655,0,34,17,15,66
5657,0,32,18,17,67
5658,33,17,15,16,81
5661,0,31,134,18,183
5663,0,35,16,17,68
5664,0,17,16,17,50
5665,0,33,17,17,67
5666,0,17,17,17,51
5667,17,17,16,16,66
5668,17,32,50,18,117
5669,16,16,50,18,100
5671,18,17,15,18,68
5672,0,17,15,18,50
5673,0,33,16,17,66
5675,0,33,17,15,65
5677,0,32,19,16,67
5678,34,16,17,15,82
5679,19,16,17,15,67
5680,16,32,33,18,99
5681,0,32,33,18,83
5682,15,33,18,15,81
5684,16,33,18,18,85
5686,51,31,17,17,116
5687,36,31,17,17,101
5689,0,31,17,17,65
5690,0,16,17,17,50
5691,17,17,17,17,68
5693,34,33,15,18,100
5695,0,33,15,18,66
5697,33,34,82,16,165
5698,18,34,82,16,150
5699,0,34,82,16,132
5700,0,17,82,16,115
5703,0,33,66,18,117
5704,15,32,18,16,81
5705,0,32,18,16,66
5706,16,34,18,17,85
5707,34,35,0,16,85
5708,16,35,0,16,67
5709,35,33,51,16,135
5710,0,17,0,16,33
5712,0,17,51,16,84
5713,0,32,52,15,99
5715,0,35,49,16,100
5716,16,32,17,16,81
5717,32,33,17,17,99
5719,0,33,17,17,67
5721,0,34,18,14,66
5722,17,32,17,17,83
5723,0,32,17,17,66
5724,0,14,17,17,48
5729,0,35,0,16,51
5731,31,34,17,17,99
5732,0,15,0,17,32
5733,0,34,17,17,68
5736,17,33,17,15,82
5737,0,33,17,15,65
5738,16,32,17,18,83
5739,17,15,17,18,67
5741,0,35,0,15,50
5742,0,18,0,15,33
5743,0,32,0,17,49
5744,0,17,0,17,34
5746,0,17,0,17,34
5748,15,34,17,16,82
5751,0,33,18,16,67
5752,0,16,18,16,50
5753,0,34,35,15,84
5755,0,35,0,15,50
5756,50,34,15,17,116
5757,0,32,0,16,48
5758,0,17,0,16,33
5759,0,34,15,17,66
5760,33,17,17,17,84
5763,50,16,51,18,135
5765,50,17,16,18,101
5766,0,16,51,18,85
5767,18,17,16,18,69
5768,0,17,16,18,51
5769,16,18,15,18,67
5770,18,33,0,16,67
5773,49,17,32,17,115
5774,0,17,0,16,33
5778,0,16,0,17,33
5783,0,33,18,16,67
5784,51,33,0,18,102
5785,0,34,16,17,67
5786,0,16,16,17,49
5787,0,33,0,18,51
5788,17,33,17,17,84
5789,0,33,17,17,67
5791,17,17,0,16,50
5792,17,34,16,16,83
5793,0,34,16,16,66
5794,0,18,16,16,50
5795,0,32,17,18,67
5796,16,35,48,17,116
5797,17,18,48,17,100
5798,0,18,48,17,83
5799,0,33,15,17,65
5800,17,32,17,17,83
5801,0,32,17,17,66
5802,17,34,16,17,84
5803,0,34,16,17,67
5804,17,33,17,17,84
5805,0,33,17,17,67
5806,17,34,0,17,68
5807,0,34,0,17,51
5808,251,31,52,17,351
5809,0,33,17,17,67
5811,17,17,15,17,66
5813,0,32,17,17,66
5816,17,33,52,16,118
5817,0,33,52,16,101
5818,16,34,18,16,84
5819,0,34,18,16,68
5820,17,34,17,14,82
5821,0,34,17,14,65
5823,0,31,52,17,100
5824,14,35,81,18,148
5826,17,34,47,18,116
5827,34,32,15,18,99
5828,17,32,15,18,82
5829,0,32,15,18,65
5830,0,16,15,18,49
5831,0,33,17,17,67
5832,0,18,17,17,52
5834,17,33,16,17,83
5835,0,33,16,17,66
5836,17,33,50,16,116
5840,17,33,34,17,101
5842,16,34,66,18,134
5843,0,34,66,18,118
5844,16,34,0,17,67
5845,0,34,0,17,51
5846,0,17,0,17,34
5848,0,15,0,18,33
5849,0,33,0,18,51
5850,0,15,0,18,33
5854,17,31,19,18,85
5856,14,37,33,15,99
5857,70,32,50,17,169
5858,0,18,33,15,66
5859,0,33,0,15,48
5860,18,32,50,17,117
5861,0,32,50,17,99
5862,0,17,50,17,84
5863,18,16,16,17,67
5864,16,33,16,17,82
5865,0,33,16,17,66
5866,17,33,33,17,100
5867,0,33,33,17,83
5868,17,33,17,17,84
5869,0,33,17,17,67
5870,16,34,0,17,67
5871,0,34,0,17,51
5872,0,17,0,17,34
5874,15,33,18,17,83
5875,0,33,18,17,68
5876,15,35,16,18,84
5877,35,34,17,15,101
5880,18,32,68,15,133
5881,0,32,68,15,115
5882,0,15,68,15,98
5883,0,34,49,18,101
5884,0,16,49,18,83
5885,49,18,16,17,100
5886,17,33,16,17,83
5888,0,18,16,17,51
5889,0,33,16,17,66
5890,0,17,16,17,50
5891,0,33,18,15,66
5892,17,33,51,17,118
5893,0,33,51,17,101
5894,15,34,17,17,83
5896,17,34,0,15,66
5897,34,32,0,17,83
5898,17,32,0,17,66
5899,67,33,0,15,115
5900,0,17,0,17,34
5901,17,18,82,18,135
5902,51,32,50,18,151
5903,15,18,0,15,48
5904,18,32,50,18,118
5905,49,18,116,16,199
5906,0,17,50,18,85
5907,17,18,116,16,167
5909,0,33,16,17,66
5910,18,33,17,16,84
5911,0,33,17,16,66
5912,17,33,17,16,83
5914,16,33,118,16,183
5918,17,33,51,16,117
5919,0,33,51,16,100
5920,0,16,51,16,83
5922,49,34,15,17,115
5923,18,16,16,18,68
5924,16,34,15,17,82
5926,50,34,0,17,101
5927,0,32,68,17,117
5928,17,34,0,17,68
5930,34,17,17,15,83
5931,0,34,17,15,66
5935,0,34,0,15,49
5936,32,18,16,17,83
5937,0,33,16,17,66
5938,0,18,16,17,51
5941,0,34,34,15,83
5942,0,17,34,15,66
5945,0,32,18,16,66
5946,0,17,18,16,51
5947,34,34,16,17,101
5948,16,34,16,17,83
5949,16,18,16,17,67
5951,0,33,0,16,49
5952,17,36,13,16,82
5953,0,36,13,16,65
5954,0,20,13,16,49
5956,0,16,51,17,84
5957,0,34,17,17,68
5959,34,32,34,17,117
5960,17,32,34,17,100
5961,0,32,34,17,83
5962,0,16,34,17,67
5963,0,34,50,17,101
5964,0,17,50,17,84
5967,33,34,17,17,101
5970,17,34,48,18,117
5971,34,32,16,18,100
5973,0,32,16,18,66
5974,17,34,15,17,83
5976,0,18,15,17,50
5978,0,17,51,17,85
5979,0,34,17,17,68
5980,0,17,17,17,51
5981,0,34,0,15,49
5982,17,33,51,16,117
5983,0,33,51,16,100
5985,0,33,18,16,67
5986,17,34,32,17,100
5987,18,16,32,17,83
5988,16,32,0,17,65
5989,0,32,0,17,49
5990,17,35,15,17,84
5992,0,18,15,17,50
5993,15,17,0,17,49
5994,17,34,0,17,68
5995,0,34,0,17,51
5996,0,17,0,17,34
5997,17,16,17,16,66
