序号,发送->接收,接收->转发,转发->接收,接收->处理,总计
2,0,13,102,30,145
3,18,18,31,16,83
4,0,18,31,16,65
5,31,35,45,16,127
7,0,35,45,16,96
8,0,19,45,16,80
9,0,45,52,31,128
11,0,15,52,31,98
12,0,32,20,31,83
13,0,16,20,31,67
14,20,49,17,15,101
16,0,34,17,15,66
17,0,18,17,15,50
20,0,34,0,17,51
21,0,17,0,17,34
22,0,34,0,16,50
23,17,32,0,16,65
24,0,32,0,16,48
25,16,32,67,19,134
26,16,16,67,19,118
27,16,35,0,16,67
30,0,32,19,16,67
31,0,16,19,16,51
33,16,32,19,33,100
35,0,16,19,33,68
36,19,50,15,15,99
39,0,17,15,15,47
40,15,15,34,19,83
41,15,34,0,19,68
42,0,34,0,19,53
43,14,35,31,17,97
44,0,35,31,17,83
45,16,31,0,17,64
46,0,31,0,17,48
47,15,37,17,19,88
48,0,37,17,19,73
49,37,50,0,16,103
50,0,17,0,19,36
52,31,16,0,31,78
53,21,16,0,31,68
55,0,47,18,16,81
56,0,31,18,16,65
57,16,34,0,17,67
58,18,16,0,17,51
59,99,17,0,17,133
61,0,16,0,18,34
64,13,17,0,17,47
66,17,17,16,20,70
67,0,17,16,20,53
68,0,36,16,34,86
70,0,16,0,34,50
71,34,33,0,31,98
73,0,33,0,31,64
74,0,17,0,31,48
75,0,48,16,19,83
76,15,17,16,19,67
77,0,17,16,19,52
78,16,19,15,17,67
80,0,32,51,34,117
81,17,32,19,34,102
83,0,14,19,34,67
86,19,47,33,20,119
87,0,47,33,20,100
89,0,16,33,20,69
90,19,14,0,20,53
91,14,20,16,15,65
92,51,16,0,18,85
94,15,16,0,18,49
95,0,16,0,18,34
97,0,15,35,16,66
100,0,32,0,19,51
101,0,16,0,19,35
102,0,19,0,33,52
103,0,49,34,17,100
106,0,34,0,17,51
107,0,19,0,17,36
108,0,32,52,34,118
109,15,19,13,20,67
110,0,19,13,20,52
111,0,33,34,16,83
112,0,20,34,16,70
115,0,50,31,16,97
117,19,31,0,16,66
118,0,31,0,16,47
119,0,16,0,16,32
120,16,19,16,18,69
121,0,19,16,18,53
123,0,18,84,16,118
127,0,15,36,31,82
128,0,20,62,19,101
129,0,47,49,18,114
130,0,31,49,18,98
131,15,34,15,18,82
132,0,34,15,18,67
133,0,19,15,18,52
135,0,18,15,19,52
136,0,34,16,16,66
137,19,32,85,14,150
138,32,19,15,15,81
140,0,19,15,15,49
141,30,17,52,15,114
142,15,17,52,15,99
143,0,17,52,15,84
144,0,33,19,15,67
146,0,34,51,15,100
151,0,15,20,30,65
152,20,47,52,17,136
153,14,33,52,17,116
154,0,33,52,17,102
156,0,37,15,17,69
157,21,32,47,19,119
158,0,32,47,19,98
159,0,17,47,19,83
161,0,15,16,19,50
162,0,35,16,18,69
163,0,19,16,18,53
164,0,34,15,16,65
165,0,18,15,16,49
166,0,31,20,33,84
167,16,20,14,19,69
169,0,33,13,20,66
170,19,33,15,18,85
171,0,33,15,18,66
172,20,33,16,14,83
173,0,33,16,14,63
175,0,49,16,19,84
176,0,33,16,19,68
177,54,30,20,30,134
181,0,15,20,30,65
182,0,20,132,18,170
183,0,47,18,19,84
185,0,17,18,19,54
186,0,37,15,18,70
189,18,33,16,31,98
190,33,16,15,16,80
191,18,16,15,16,65
192,0,16,15,16,47
193,0,47,21,31,99
194,16,16,21,31,84
196,0,21,64,15,100
198,16,17,16,15,64
199,48,39,12,19,118
201,15,39,12,19,85
203,0,22,12,19,53
204,0,31,0,17,48
205,19,17,16,34,86
206,17,50,65,15,147
207,0,50,65,15,130
208,15,19,65,15,114
209,19,30,35,15,99
210,0,30,35,15,80
211,37,47,17,16,117
212,0,20,15,15,50
214,15,17,17,16,65
216,17,16,17,19,69
220,0,34,49,14,97
221,0,19,49,14,82
223,15,33,0,20,68
224,33,35,16,19,103
225,14,35,16,19,84
226,0,35,16,19,70
228,35,31,49,19,134
229,19,31,49,19,118
231,0,15,49,19,83
232,0,35,14,19,68
234,0,33,81,19,133
235,0,19,81,19,119
237,0,15,50,19,84
239,0,16,15,19,50
241,0,19,13,18,50
242,0,31,20,14,65
243,0,18,20,14,52
245,0,14,19,15,48
246,19,15,134,16,184
247,0,15,134,16,165
249,0,19,15,15,49
251,35,15,16,18,84
254,0,34,16,17,67
255,18,33,16,19,86
256,0,33,16,19,68
257,0,17,16,19,52
258,0,35,47,18,100
260,0,32,15,18,65
263,18,35,16,14,83
264,0,35,16,14,65
265,48,35,49,20,152
267,0,14,19,16,49
269,0,16,49,20,85
270,0,34,15,20,69
271,0,19,15,20,54
272,0,35,15,18,68
274,0,33,15,19,67
277,19,30,20,16,85
278,0,30,20,16,66
280,20,47,18,15,100
281,0,47,18,15,80
282,15,16,18,15,64
283,0,16,18,15,49
284,0,33,16,19,68
285,15,35,16,19,85
289,19,16,14,23,72
290,0,16,14,23,53
293,0,43,19,15,77
294,0,30,19,15,64
295,0,16,19,15,50
296,0,34,16,19,69
297,15,35,15,18,83
298,0,35,15,18,68
299,0,19,15,18,52
301,0,18,16,15,49
302,0,31,167,17,215
303,0,15,167,17,199
306,18,18,50,15,101
309,0,15,19,15,49
310,0,34,16,16,66
311,0,15,16,16,47
312,0,32,17,18,67
313,0,16,17,18,51
314,0,35,16,16,67
315,0,18,16,16,50
318,0,34,15,20,69
319,0,15,15,20,50
320,0,35,50,17,102
321,0,20,50,17,87
322,0,30,20,17,67
324,0,37,30,5,72
325,0,17,30,5,52
326,0,30,21,16,67
327,21,35,15,18,89
328,16,35,15,18,84
329,16,19,15,18,68
331,15,18,33,15,81
333,0,33,0,15,48
334,34,34,51,17,136
335,0,49,51,17,117
337,20,35,16,17,88
339,0,20,16,17,53
343,34,34,16,18,102
344,19,34,16,18,87
345,0,34,16,18,68
346,0,19,16,18,53
347,0,34,17,14,65
348,18,31,17,34,100
350,0,14,17,34,65
351,0,51,34,16,101
354,0,15,19,16,50
355,0,35,83,19,137
358,18,35,15,19,87
360,0,19,15,19,53
362,0,19,15,33,67
365,19,33,15,19,86
366,14,19,15,19,67
367,0,19,15,19,53
369,19,16,50,34,119
372,0,16,15,34,65
373,0,49,15,19,83
374,15,19,15,19,68
375,19,15,19,16,69
376,0,15,19,16,50
377,0,35,15,18,68
378,0,16,15,18,49
381,0,51,0,15,66
382,36,15,0,16,67
385,0,35,17,14,66
386,0,19,17,14,50
390,0,14,0,33,47
393,0,33,0,19,52
394,14,34,0,16,64
397,0,35,0,15,50
398,0,19,0,15,34
401,0,31,20,14,65
402,0,16,20,14,50
403,0,34,0,17,51
404,14,52,0,15,81
405,17,35,0,15,67
406,35,15,19,16,85
407,20,15,19,16,70
409,0,35,16,16,67
410,0,16,16,16,48
412,16,33,17,34,100
413,0,33,17,34,84
415,0,51,34,14,99
416,15,19,34,14,82
417,34,33,16,19,102
418,0,15,49,19,83
419,0,33,16,19,68
420,49,34,16,34,133
421,0,35,16,18,69
422,35,18,16,34,103
424,0,18,16,34,68
425,0,50,17,16,83
427,19,17,50,15,101
429,0,31,34,19,84
430,0,15,34,19,68
431,19,15,0,19,53
433,19,16,0,14,49
434,0,16,0,14,30
435,14,35,0,35,84
437,18,35,47,19,119
438,0,35,47,19,101
439,0,20,47,19,86
442,17,34,0,16,67
444,15,35,0,17,67
445,0,35,0,17,52
446,0,19,0,17,36
447,0,34,15,16,65
448,0,17,15,16,48
450,16,33,16,36,101
451,18,15,16,36,85
453,32,20,16,17,85
456,33,17,16,17,83
457,17,17,16,17,67
460,17,34,32,18,101
461,0,34,32,18,84
462,20,32,0,18,70
463,0,32,0,18,50
464,36,16,47,17,116
467,16,16,15,17,64
468,0,16,15,17,48
469,15,35,16,32,98
470,35,16,16,16,83
471,0,18,16,32,66
472,16,53,32,16,117
473,32,21,32,16,101
474,16,21,32,16,85
475,0,21,32,16,69
476,0,16,16,16,48
477,16,16,0,17,49
478,0,16,0,17,33
479,17,15,0,17,49
480,15,34,69,16,134
482,0,17,69,16,102
483,0,34,66,16,116
484,0,17,66,16,99
485,0,35,0,16,51
486,20,31,0,16,67
488,0,15,0,16,31
490,19,32,16,33,100
492,15,49,0,17,81
493,0,49,0,17,66
494,0,33,0,17,50
495,34,34,0,17,85
497,0,34,0,17,51
499,0,34,0,16,50
500,0,17,0,16,33
502,0,17,16,18,51
503,0,34,134,16,184
504,18,33,32,17,100
506,0,16,32,17,65
508,16,49,52,17,134
509,49,20,16,16,101
511,16,20,16,16,68
514,0,16,0,17,33
515,0,34,0,17,51
516,17,34,31,19,101
517,0,34,31,19,84
518,17,31,0,19,67
519,0,31,0,19,50
523,0,47,15,35,97
524,16,19,15,35,85
525,19,15,0,35,69
526,0,15,0,35,50
527,0,35,0,15,50
528,19,35,30,19,103
529,0,35,30,19,84
531,0,30,0,19,49
532,15,35,34,16,100
533,0,35,34,16,85
534,0,16,34,16,66
536,19,31,16,18,84
538,15,34,66,20,135
539,34,51,15,20,120
541,0,51,15,20,86
542,70,15,15,20,120
544,15,35,15,20,85
545,20,15,15,20,70
546,0,15,15,20,50
548,20,31,35,14,100
552,18,49,33,16,116
553,14,35,33,16,98
554,0,35,33,16,84
555,19,33,0,16,68
556,33,16,0,16,65
558,0,16,0,16,32
559,0,35,0,15,50
560,19,49,0,15,83
563,19,15,0,19,53
565,0,34,49,15,98
566,0,15,49,15,79
567,34,50,16,17,117
568,18,50,16,17,101
569,0,50,16,17,83
570,15,20,16,17,68
571,0,20,16,17,53
574,0,16,16,18,50
575,0,34,16,19,69
576,0,18,16,19,53
577,16,19,0,16,51
578,0,19,0,16,35
579,16,15,18,15,64
581,33,34,36,15,118
582,15,34,36,15,100
583,0,34,36,15,85
584,18,36,0,15,69
587,0,31,15,19,65
588,0,16,15,19,50
589,15,19,0,17,51
590,19,34,16,33,102
591,0,34,16,33,83
594,15,18,17,33,83
595,18,17,15,18,68
596,32,18,0,16,66
597,0,33,0,16,49
598,0,18,0,16,34
599,0,35,0,16,51
600,19,31,34,16,100
601,0,31,34,16,81
603,16,18,16,18,68
604,18,34,16,34,102
605,16,18,16,34,84
606,18,50,16,17,101
607,0,50,16,17,83
608,34,16,0,17,67
609,68,33,0,35,136
610,0,16,0,17,33
612,16,33,0,35,84
613,0,33,0,35,68
614,18,35,99,16,168
615,0,35,99,16,150
616,19,32,0,34,85
619,34,33,82,19,168
620,18,33,82,19,152
622,18,48,34,19,119
624,0,32,34,19,85
626,0,19,34,16,69
627,15,19,49,33,116
628,0,19,49,33,101
630,0,33,0,33,66
631,18,33,0,16,67
632,0,33,0,16,49
633,0,18,0,16,34
636,19,50,0,16,85
638,0,34,0,16,50
639,19,16,34,16,85
640,0,16,34,16,66
641,34,50,0,16,100
642,19,50,0,16,85
643,0,50,0,16,66
645,19,16,34,16,85
646,16,34,0,16,66
647,0,34,0,16,50
649,0,32,51,15,98
650,0,16,51,15,82
653,33,34,0,34,101
655,34,34,0,16,84
656,18,34,0,16,68
658,18,34,15,18,85
660,0,18,15,18,51
661,0,33,16,36,85
662,18,52,17,13,100
666,0,17,0,13,30
667,13,35,32,34,114
668,0,35,32,34,101
669,0,19,32,34,85
672,0,34,0,17,51
674,0,17,33,34,84
676,0,18,0,34,52
677,0,34,32,17,83
678,0,19,32,17,68
679,16,16,0,17,49
680,0,16,0,17,33
684,0,33,16,35,84
686,0,16,50,19,85
687,15,20,15,19,69
688,20,34,13,18,85
690,19,31,100,18,168
691,0,31,100,18,149
692,18,34,16,35,103
693,0,34,16,35,85
694,31,35,33,16,115
695,32,19,33,16,100
698,0,15,18,16,49
699,18,16,15,18,67
700,0,16,15,18,49
701,15,18,16,18,67
702,18,34,84,16,152
703,0,34,84,16,134
705,0,49,16,19,84
707,0,18,16,19,53
708,35,16,0,16,67
709,0,35,0,16,51
710,0,16,0,16,32
714,0,16,51,16,83
717,18,16,65,33,132
718,16,33,65,18,132
719,0,33,65,18,116
720,0,17,65,18,100
721,0,32,0,33,65
722,14,33,53,14,114
723,0,33,53,14,100
724,18,35,18,14,85
725,0,35,18,14,67
726,0,17,18,14,49
728,14,34,0,34,82
729,34,34,0,16,84
730,16,34,0,16,66
731,0,34,0,16,50
732,19,34,15,16,84
734,0,18,15,16,49
735,0,31,0,34,65
737,0,34,17,16,67
738,18,33,17,18,86
739,0,33,17,18,68
741,0,35,65,16,116
742,18,50,15,16,99
743,0,50,15,16,81
744,16,19,15,16,66
745,19,15,52,15,101
746,15,36,16,15,82
747,0,36,16,15,67
748,36,15,0,34,85
749,16,15,0,34,65
751,0,34,66,34,134
753,16,34,0,16,66
754,0,34,0,16,50
755,19,16,0,34,69
757,0,34,0,16,50
758,19,35,16,15,85
759,0,35,16,15,66
760,0,19,16,15,50
761,0,31,0,19,50
762,15,34,15,19,83
764,0,15,15,19,49
766,0,19,0,16,35
768,32,18,18,33,101
769,18,18,18,33,87
770,0,18,18,33,69
771,51,17,15,16,99
772,0,33,63,19,115
774,0,17,15,16,48
776,16,34,16,34,100
777,15,19,16,34,84
778,19,50,16,18,103
779,16,34,16,18,84
780,0,34,16,18,68
783,0,34,16,33,83
784,0,16,16,33,65
785,0,49,50,18,117
786,16,17,50,18,101
787,17,34,16,18,85
788,50,18,15,19,102
789,18,34,15,19,86
790,34,15,19,15,83
791,18,15,19,15,67
793,0,34,16,19,69
794,0,15,16,19,50
795,0,35,14,19,68
796,19,33,17,16,85
797,0,33,17,16,66
798,19,33,32,35,119
800,16,32,0,35,83
801,0,32,0,35,67
803,35,33,49,35,152
804,19,33,49,35,136
805,0,33,49,35,117
806,19,33,67,16,135
808,0,16,67,16,99
809,0,51,16,16,83
810,15,20,16,16,67
812,0,16,16,17,49
814,0,17,0,38,55
816,23,29,15,20,87
817,0,29,15,20,64
818,19,35,0,15,69
819,50,16,50,16,132
820,0,20,0,15,35
822,16,34,16,16,82
823,0,34,16,16,66
825,0,32,50,18,100
826,16,34,16,18,84
827,0,34,16,18,68
828,0,17,16,18,51
830,18,32,51,16,117
831,0,32,51,16,99
832,15,35,32,16,98
833,0,35,32,16,83
836,0,16,66,18,100
837,0,51,33,16,100
839,19,33,0,16,68
840,0,33,0,16,49
843,0,34,16,18,68
844,18,34,15,19,86
845,0,34,15,19,68
847,0,34,15,18,67
848,19,33,15,34,101
850,18,49,16,33,116
851,0,49,16,33,98
852,15,19,16,33,83
854,0,16,15,18,49
855,33,51,15,18,117
858,16,18,15,18,67
859,18,33,15,19,85
860,0,33,15,19,67
861,18,34,16,18,86
862,0,34,16,18,68
863,19,16,51,16,102
864,0,16,51,16,83
866,0,16,33,18,67
867,17,16,48,19,100
868,16,33,15,19,83
870,0,15,15,19,49
871,34,34,15,18,101
872,19,34,15,18,86
873,0,34,15,18,67
875,0,33,0,16,49
876,18,32,0,18,68
877,0,32,0,18,50
879,0,33,0,17,50
881,17,19,0,16,52
883,0,31,16,19,66
885,0,35,0,33,68
887,0,33,0,17,50
888,19,34,13,19,85
889,0,34,13,19,66
891,0,32,0,35,67
893,0,35,16,15,66
894,20,31,0,35,86
897,35,32,66,18,151
898,19,32,66,18,135
902,0,15,18,15,48
903,0,33,0,18,51
904,15,34,15,19,83
905,0,34,15,19,68
906,0,16,15,19,50
908,19,35,49,16,119
913,0,34,50,20,104
914,16,34,49,17,116
915,0,34,49,17,100
916,0,18,49,17,84
917,36,30,16,18,100
921,0,34,81,19,134
922,0,18,81,19,118
923,0,31,69,16,116
925,0,34,16,19,69
926,15,35,81,18,149
927,35,31,19,15,100
928,19,31,19,15,84
929,16,15,19,15,65
930,0,15,19,15,49
931,34,34,65,19,152
932,15,34,65,19,133
935,0,50,15,19,84
936,0,34,15,19,68
939,19,15,20,31,85
940,0,15,20,31,66
942,31,33,15,18,97
944,0,33,15,18,66
945,51,35,15,35,136
946,0,33,50,35,118
948,0,35,15,35,85
949,19,15,16,19,69
950,15,35,0,16,66
951,0,35,0,16,51
954,0,16,0,33,49
955,33,35,0,15,83
956,17,35,0,15,67
957,0,35,0,15,50
958,19,49,16,18,102
960,0,34,16,18,68
962,0,16,18,16,50
963,0,34,15,19,68
964,0,16,15,19,50
965,0,34,15,20,69
966,0,19,15,20,54
967,35,48,34,15,132
968,20,48,34,15,117
969,16,32,34,15,97
970,14,18,34,15,81
971,18,16,18,15,67
973,0,33,16,18,67
974,31,18,16,19,84
978,19,49,34,16,118
980,14,19,34,16,83
983,0,35,16,16,67
984,0,16,16,16,48
986,16,34,15,19,84
989,34,50,34,16,134
990,19,50,34,16,119
991,0,50,34,16,100
992,15,19,34,16,84
993,19,15,19,16,69
994,34,16,65,18,133
995,19,16,65,18,118
996,0,16,65,18,99
999,18,34,32,18,102
1001,18,15,17,18,68
1002,0,15,17,18,50
1003,35,34,50,16,135
1005,34,31,19,16,100
1006,18,31,19,16,84
1007,0,31,19,16,66
1008,0,15,19,16,50
1010,16,51,15,16,98
1012,35,15,51,16,117
1013,19,15,51,16,101
1014,0,15,51,16,82
1015,0,51,31,14,96
1016,0,35,31,14,80
1017,19,16,66,18,119
1018,0,16,66,18,100
1019,0,51,15,18,84
1020,14,22,15,18,69
1022,15,34,15,19,83
1023,18,16,15,19,68
1024,0,16,15,19,50
1025,34,49,0,16,99
1026,37,31,0,16,84
1027,0,49,0,16,65
1028,0,31,0,16,47
1029,19,16,16,19,70
1030,0,16,16,19,51
1031,0,35,0,16,51
1032,19,49,15,18,101
1033,0,49,15,18,82
1034,0,33,15,18,66
1035,18,33,0,35,86
1036,33,35,16,34,118
1037,18,35,16,34,103
1038,0,35,16,34,85
1039,0,19,16,34,69
1040,0,16,15,19,50
1041,0,34,16,34,84
1042,69,15,18,16,118
1043,0,50,15,18,83
1046,0,15,18,16,49
1048,0,16,0,34,50
1049,0,34,50,32,116
1051,0,32,18,32,82
1052,15,50,0,35,100
1053,18,32,0,35,85
1054,0,32,0,35,67
1055,0,18,0,35,53
1056,0,35,0,15,50
1057,19,15,18,15,67
1061,34,34,65,19,152
1062,15,34,65,19,133
1064,35,34,50,17,136
1066,0,34,50,17,101
1068,0,34,16,17,67
1069,0,19,16,17,52
1070,0,16,17,15,48
1071,0,32,16,18,66
1072,15,34,0,18,67
1074,0,18,0,18,36
1075,0,35,13,21,69
1076,0,17,13,21,51
1078,53,33,50,33,169
1079,32,33,50,33,148
1080,19,33,50,33,135
1082,0,16,50,33,99
1083,0,50,0,33,83
1084,0,34,0,33,67
1085,19,33,0,16,68
1086,0,33,0,16,49
1087,18,16,0,16,50
1088,0,16,0,16,32
1090,0,19,48,18,85
1094,18,32,0,35,85
1095,16,16,0,35,67
1096,0,16,0,35,51
1098,0,19,17,17,53
1101,0,32,0,16,48
1102,35,35,14,19,103
1103,0,51,14,19,84
1104,35,33,16,16,100
1105,19,33,16,16,84
1106,0,33,16,16,65
1107,19,16,16,16,67
1108,16,32,86,15,149
1109,16,16,86,15,133
1110,16,34,16,19,85
1113,0,35,17,15,67
1114,19,32,16,35,102
1115,17,15,16,35,83
1116,0,15,16,35,66
1117,0,51,15,18,84
1119,19,15,18,16,68
1120,15,34,16,19,84
1121,0,34,16,19,69
1122,0,16,16,19,51
1123,0,35,0,19,54
1124,19,36,12,18,85
1125,36,30,16,18,100
1126,47,34,48,18,147
1128,18,34,48,18,118
1129,0,34,48,18,100
1130,18,32,16,18,84
1133,0,34,15,34,83
1134,0,18,15,34,67
1135,49,16,18,15,98
1137,18,16,18,15,67
1139,0,33,18,33,84
1140,0,15,18,33,66
1142,0,33,18,15,66
1143,18,18,0,15,51
1144,0,18,0,15,33
1145,0,50,0,15,65
1146,0,35,0,15,50
1147,20,15,16,18,69
1154,34,20,14,34,102
1157,0,48,16,33,97
1158,15,19,16,33,83
1159,19,16,0,33,68
1160,0,16,0,33,49
1161,0,33,16,18,67
1164,0,18,16,19,53
1168,19,48,0,19,86
1171,18,19,0,16,53
1173,0,31,16,19,66
1176,19,33,17,31,100
1177,0,33,17,31,81
1178,18,48,19,16,101
1179,0,48,19,16,83
1180,31,19,83,33,166
1182,0,19,83,33,135
1183,0,32,16,19,67
1185,0,35,16,33,84
1187,0,49,16,34,99
1189,19,16,15,19,69
1191,15,19,17,16,67
1192,19,33,101,15,168
1193,0,33,101,15,149
1195,0,33,118,15,166
1196,18,52,16,15,101
1197,0,52,16,15,83
1198,15,19,16,15,65
1199,19,16,15,35,85
1201,0,50,15,17,82
1202,0,35,15,17,67
1203,19,15,66,16,116
1204,0,15,66,16,97
1205,0,51,15,16,82
1206,0,34,15,16,65
1208,0,31,20,15,66
1209,16,20,15,35,86
1210,0,20,15,35,70
1211,0,50,15,19,84
1213,19,15,19,16,69
1216,16,34,15,34,99
1217,0,34,15,34,83
1218,0,19,15,34,68
1219,0,49,34,16,99
1220,0,34,34,16,84
1221,19,15,19,16,69
1223,0,35,15,18,68
1224,16,33,15,18,82
1225,0,33,15,18,66
1226,18,33,16,18,85
1228,18,34,16,31,99
1229,0,34,16,31,81
1230,0,18,16,31,65
1231,47,36,15,19,117
1232,15,16,101,16,148
1233,16,36,15,19,86
1235,19,15,19,15,68
1236,0,15,19,15,49
1239,0,51,15,19,85
1240,16,19,15,19,69
1242,34,15,18,16,83
1243,19,15,18,16,68
1244,64,18,68,15,165
1245,18,16,49,36,119
1246,31,18,68,15,132
1247,15,18,68,15,116
1249,0,52,16,15,83
1250,0,36,16,15,67
1251,20,16,66,18,120
1252,0,16,66,18,100
1253,15,32,19,18,84
1257,0,34,64,18,116
1258,32,32,16,18,98
1259,0,48,16,18,82
1260,14,18,16,18,66
1263,34,34,16,19,103
1264,0,16,0,34,50
1265,16,18,16,19,69
1266,0,18,16,19,53
1267,0,35,0,16,51
1268,19,48,18,15,100
1269,16,32,18,15,81
1270,0,32,18,15,65
1273,15,34,16,18,83
1274,68,16,16,19,119
1277,18,16,16,19,69
1278,0,16,16,19,51
1281,0,31,0,17,48
1283,0,36,15,34,85
1284,0,19,15,34,68
1285,0,49,0,31,80
1286,34,31,0,18,83
1287,19,31,0,18,68
1288,49,50,18,16,133
1289,0,16,0,18,34
1293,18,18,16,34,86
1297,19,17,0,16,52
1298,49,35,14,18,116
1299,16,16,49,18,99
1300,0,16,49,18,83
1301,0,35,14,18,67
1302,19,32,16,33,100
1303,14,18,16,33,81
1304,18,49,52,15,134
1306,33,35,17,15,100
1307,18,35,17,15,85
1309,19,17,15,17,68
1310,0,17,15,17,49
1311,0,32,16,19,67
1316,15,18,16,34,83
1317,18,16,67,34,135
1318,0,16,67,34,117
1319,0,34,18,15,67
1322,15,34,34,16,99
1323,0,34,34,16,84
1325,0,34,0,16,50
1327,32,34,0,16,82
1328,0,16,0,19,35
1330,0,15,0,16,31
1331,0,34,0,15,49
1332,0,18,0,15,33
1335,0,28,19,15,62
1336,15,34,51,15,115
1337,0,34,51,15,100
1338,0,15,51,15,81
1339,36,30,51,33,150
1340,20,30,51,33,134
1341,30,34,50,34,148
1343,0,34,50,34,118
1344,18,50,0,34,102
1346,33,34,16,16,99
1347,18,34,16,16,84
1348,0,34,16,16,66
1349,19,16,16,19,70
1350,16,35,81,19,151
1352,0,19,81,19,119
1354,19,31,16,19,85
1355,0,31,16,19,66
1356,0,14,16,19,49
1357,35,48,15,18,116
1359,0,48,15,18,81
1360,33,33,18,16,100
1361,17,33,18,16,84
1362,0,33,18,16,67
1364,0,18,16,16,50
1366,0,16,19,32,67
1367,0,51,16,18,85
1368,32,16,49,19,116
1369,18,16,49,19,102
1371,0,34,15,19,68
1373,15,19,16,34,84
1374,19,50,16,16,101
1375,0,50,16,16,82
1376,15,19,16,16,66
1378,0,16,16,20,52
1379,0,36,13,18,67
1380,0,20,13,18,51
1381,0,31,16,17,64
1382,18,33,0,16,67
1384,0,17,0,16,33
1385,0,32,35,17,84
1386,0,16,35,17,68
1388,0,19,0,17,36
1389,0,34,0,16,50
1391,0,49,15,19,83
1392,0,33,15,19,67
1393,18,34,17,16,85
1394,0,34,17,16,67
1395,19,17,16,17,69
1396,0,17,16,17,50
1397,0,33,17,16,66
1398,0,17,17,16,50
1399,33,33,16,35,117
1400,16,33,16,35,100
1402,0,16,16,35,67
1403,0,51,17,16,84
1405,0,19,17,16,52
1407,16,15,18,16,65
1408,15,34,0,16,65
1409,0,34,0,16,50
1410,16,51,16,17,100
1411,16,35,16,17,84
1412,0,35,16,17,68
1413,19,16,17,16,68
1414,0,16,17,16,49
1415,33,51,64,17,165
1416,0,16,0,16,32
1418,35,15,18,31,99
1419,19,15,18,31,83
1421,18,31,0,17,66
1422,15,16,0,17,48
1423,16,36,35,14,101
1424,0,36,35,14,85
1428,14,35,34,15,98
1429,0,35,34,15,84
1430,54,30,51,35,170
1431,0,34,0,15,49
1432,18,30,51,35,134
1433,15,15,51,35,116
1434,15,35,16,35,101
1436,16,51,17,16,100
1438,0,35,17,16,68
1440,17,32,15,19,83
1441,16,16,15,19,66
1442,0,16,15,19,50
1443,15,19,15,19,68
1444,53,48,18,16,135
1446,19,48,18,16,101
1447,0,48,18,16,82
1448,32,18,16,17,83
1449,18,18,16,17,69
1451,0,33,0,15,48
1453,0,34,0,15,49
1454,53,31,0,19,103
1455,0,34,31,19,84
1456,0,19,31,19,69
1457,0,31,0,19,50
1460,0,15,15,19,49
1461,0,34,67,15,116
1462,19,49,18,15,101
1464,15,18,18,15,66
1465,18,18,15,19,70
1469,0,33,16,15,64
1471,0,31,0,19,50
1475,0,50,0,16,66
1477,19,16,15,18,68
1478,16,33,16,16,81
1480,18,32,17,19,86
1481,0,32,17,19,68
1482,0,16,17,19,52
1483,36,31,83,20,170
1484,19,31,83,20,153
1487,0,34,19,14,67
1488,48,36,47,19,150
1489,0,33,16,20,69
1490,14,36,47,19,116
1491,0,36,47,19,102
1492,20,32,15,19,86
1493,0,32,15,19,66
1494,0,16,15,19,50
1495,34,32,0,33,99
1496,19,32,0,33,84
1497,0,32,0,33,65
1499,0,33,35,15,83
1500,18,35,49,34,136
1501,0,35,49,34,118
1502,19,49,0,34,102
1503,0,49,0,34,83
1505,19,34,16,18,87
1507,19,16,0,18,53
1508,0,16,0,18,34
1509,0,33,16,19,68
1512,100,18,0,15,133
1513,0,31,19,16,66
1514,0,15,19,16,50
1515,0,35,15,18,68
1516,31,18,0,15,64
1518,0,18,0,15,33
1520,0,19,16,15,50
1521,0,31,0,19,50
1523,0,34,0,35,69
1524,30,20,15,35,100
1525,0,35,15,35,85
1526,0,20,15,35,70
1528,15,20,0,14,49
1529,0,20,0,14,34
1531,0,35,51,15,101
1533,0,33,18,15,66
1534,15,33,0,35,83
1535,0,33,0,35,68
1536,15,35,15,18,83
1538,19,33,16,34,102
1540,18,50,15,20,103
1542,0,34,15,20,69
1543,0,19,15,20,54
1544,0,15,20,15,50
1545,0,35,15,35,85
1546,0,15,15,35,65
1548,0,35,0,16,51
1549,19,16,0,34,69
1550,16,34,0,15,65
1552,19,32,0,19,70
1553,0,32,0,19,51
1554,0,17,0,19,36
1556,15,35,15,33,98
1557,0,35,15,33,83
1558,0,20,15,33,68
1560,0,33,0,16,49
1561,18,16,0,19,53
1563,0,34,0,34,68
1564,0,15,0,34,49
1565,15,19,0,16,50
1566,0,19,0,16,35
1568,16,34,0,18,68
1569,0,34,0,18,52
1570,0,15,0,18,33
1571,0,34,15,18,67
1572,0,16,15,18,49
1573,0,33,0,16,49
1576,0,19,33,15,67
1579,0,33,0,15,48
1582,0,34,16,18,68
1583,19,16,18,16,69
1585,0,34,15,18,67
1586,0,16,15,18,49
1590,0,20,16,15,51
1591,16,15,17,18,66
1592,0,15,17,18,50
1593,0,35,15,19,69
1596,0,19,16,35,70
1597,0,51,16,33,100
1600,0,16,98,16,130
1601,0,33,16,15,64
1603,0,31,19,15,65
1604,0,15,19,15,49
1606,0,15,33,32,80
1607,0,33,0,32,65
1608,0,17,0,32,49
1609,15,37,15,17,84
1611,0,20,15,17,52
1613,0,33,17,32,82
1615,0,49,19,15,83
1616,15,17,19,15,66
1617,0,17,19,15,51
1618,0,19,15,17,51
1619,0,32,19,14,65
1621,0,33,17,18,68
1623,0,35,15,19,69
1624,18,34,0,16,68
1625,0,34,0,16,50
1626,0,19,0,16,35
1629,0,33,34,16,83
1630,15,34,0,16,65
1632,19,33,15,18,85
1633,0,33,15,18,66
1634,17,33,16,18,84
1635,0,33,16,18,67
1636,18,34,0,16,68
1637,0,34,0,16,50
1639,16,16,0,18,50
1640,0,16,0,18,34
1641,18,16,0,18,52
1642,0,16,0,18,34
1643,0,34,132,34,200
1644,16,34,0,16,66
1645,0,34,0,16,50
1647,0,31,34,18,83
1648,0,15,34,18,67
1649,19,15,0,18,52
1653,0,34,36,15,85
1654,18,36,0,15,69
1655,0,36,0,15,51
1657,0,30,0,18,48
1658,0,15,0,18,33
1659,0,34,18,32,84
1660,16,50,0,16,82
1661,0,50,0,16,66
1662,0,32,0,16,48
1664,0,16,0,21,37
1665,0,35,0,15,50
1667,15,35,0,16,66
1668,35,16,0,17,68
1669,19,16,0,17,52
1670,0,16,0,17,33
1672,0,16,15,18,49
1674,0,18,0,19,37
1675,19,14,0,35,68
1677,0,35,65,35,135
1678,50,19,15,35,119
1679,0,50,15,35,100
1681,19,15,51,33,118
1683,0,35,16,33,84
1684,0,19,16,33,68
1685,16,33,16,19,84
1686,14,19,16,19,68
1689,0,36,0,16,52
1690,17,32,0,18,67
1692,0,16,0,18,34
1695,17,18,34,16,85
1696,0,18,34,16,68
1697,34,32,0,35,101
1698,16,32,0,35,83
1700,0,16,0,35,51
1701,0,35,18,17,70
1702,0,19,18,17,54
1703,0,35,63,34,132
1704,0,17,63,34,114
1705,0,48,15,34,97
1707,19,15,147,21,202
1708,15,34,52,31,132
1709,34,33,19,31,117
1710,18,33,19,31,101
1711,0,33,19,31,83
1712,16,50,16,35,117
1713,19,31,16,35,101
1714,13,18,16,35,82
1715,0,18,16,35,69
1716,0,16,14,21,51
1717,0,35,65,19,119
1718,0,21,65,19,105
1719,15,36,14,19,84
1720,0,36,14,19,69
1721,20,14,19,16,69
1722,33,16,0,16,65
1724,0,16,0,16,32
1726,0,17,0,33,50
1727,0,33,0,32,65
1728,18,49,0,19,86
1731,0,17,0,19,36
1732,0,19,33,17,69
1734,19,32,19,15,85
1737,34,34,16,35,119
1738,15,34,16,35,100
1739,0,34,16,35,85
1740,18,51,31,34,134
1741,0,51,31,34,116
1742,15,20,31,34,100
1743,20,15,66,33,134
1745,0,50,16,33,99
1746,0,34,16,33,83
1747,19,16,66,36,137
1748,0,16,66,36,118
1749,0,52,0,14,66
1751,0,19,0,14,33
1753,36,31,19,16,102
1754,20,31,19,16,86
1755,0,31,19,16,66
1756,15,35,34,15,99
1757,0,35,34,15,84
1758,0,16,34,15,65
1759,0,34,0,15,49
1760,0,19,0,15,34
1763,18,16,15,17,66
1764,0,16,15,17,48
1765,0,49,33,18,100
1766,0,34,33,18,85
1767,0,17,33,18,68
1768,33,18,15,19,85
1769,0,33,15,19,67
1770,0,18,15,19,52
1772,19,50,0,16,85
1774,15,19,0,16,50
1775,19,16,15,19,69
1777,34,34,0,15,83
1778,19,34,0,15,68
1779,0,34,0,15,49
1781,33,33,16,34,116
1782,0,18,15,18,51
1783,0,33,16,34,83
1785,0,50,0,33,83
1786,15,19,0,33,67
1787,0,19,0,33,52
1789,18,17,0,17,52
1791,0,32,68,15,115
1793,19,31,33,36,119
1794,14,17,33,36,100
1795,17,18,15,36,86
1797,15,36,15,34,100
1798,36,15,15,19,85
1799,20,15,15,19,69
1800,0,15,15,19,49
1801,0,34,16,18,68
1802,0,19,16,18,53
1803,34,49,67,16,166
1806,0,33,67,16,116
1807,0,18,67,16,101
1808,34,15,18,16,83
1810,0,15,18,16,49
1811,0,34,54,17,105
1812,32,19,19,17,87
1813,0,35,19,17,71
1814,0,19,19,17,55
1817,0,29,83,18,130
1818,18,33,17,17,85
1819,0,33,17,17,67
1823,16,18,16,33,83
1825,0,49,16,19,84
1826,0,33,16,19,68
1828,0,16,52,18,86
1829,0,34,18,18,70
1830,15,36,15,15,81
1832,0,18,15,15,48
1833,30,35,16,16,97
1834,0,15,16,19,50
1835,0,35,16,16,67
1838,16,34,18,16,84
1839,18,16,18,16,68
1840,50,49,0,18,117
1842,16,49,0,18,83
1843,0,49,0,18,67
1844,0,33,0,18,51
1847,0,50,15,17,82
1848,35,15,17,35,102
1850,0,15,17,35,67
1851,0,52,16,15,83
1852,35,16,15,19,85
1854,31,19,47,19,116
1855,0,34,47,19,100
1856,0,19,47,19,85
1857,33,33,0,16,82
1858,18,33,0,16,67
1859,14,19,0,16,49
1860,19,35,30,34,118
1861,0,35,30,34,99
1862,0,19,30,34,83
1863,0,30,34,16,80
1864,15,34,0,16,65
1865,0,34,0,16,50
1866,18,35,33,15,101
1867,16,19,33,15,83
1868,0,19,33,15,67
1869,0,33,0,15,48
1870,65,19,16,18,118
1872,0,18,0,33,51
1873,33,34,0,16,83
1875,0,34,0,16,50
1876,0,18,0,16,34
1878,0,16,18,15,49
1879,0,33,0,18,51
1880,0,15,0,18,33
1881,0,51,34,15,100
1882,0,33,34,15,82
1883,18,16,50,18,102
1884,0,16,50,18,84
1885,0,33,17,18,68
1886,0,15,17,18,50
1887,0,35,15,35,85
1888,0,18,15,35,68
1889,15,35,0,15,65
1890,0,35,0,15,50
1891,20,15,49,19,103
1892,0,15,49,19,83
1893,0,34,15,19,68
1894,0,16,15,19,50
1895,0,34,84,15,133
1896,19,50,15,19,103
1897,16,34,15,19,84
1899,19,15,19,15,68
1900,0,15,19,15,49
1901,0,34,16,18,68
1902,0,15,16,18,49
1904,33,19,51,16,119
1905,0,34,51,16,101
1906,0,19,51,16,86
1907,0,51,16,16,83
1908,0,35,16,16,67
1909,20,16,47,19,102
1911,0,31,16,19,66
1912,0,15,16,19,50
1913,16,19,48,18,101
1914,19,32,16,18,85
1915,32,34,16,18,100
1917,0,34,16,18,68
1918,18,34,50,15,117
1919,0,34,50,15,99
1923,0,31,19,14,64
1924,15,33,51,34,133
1926,14,36,15,34,99
1927,0,36,15,34,85
1928,0,19,15,34,68
1930,0,34,16,34,84
1932,0,16,15,19,50
1933,0,34,17,33,84
1934,19,50,16,16,101
1936,15,18,16,16,65
1938,0,16,68,16,100
1940,0,33,19,16,68
1944,15,52,16,34,117
1945,18,34,16,34,102
1946,0,34,16,34,84
1948,0,16,0,34,50
1949,34,49,17,34,134
1951,16,33,17,34,100
1955,0,34,0,16,50
1957,0,49,16,18,83
1958,0,33,16,18,67
1959,18,34,16,18,86
1960,16,18,16,18,68
1961,34,35,0,19,88
1962,0,16,18,17,51
1964,0,17,0,19,36
1965,49,16,18,16,99
1967,19,16,18,16,69
1969,0,34,17,17,68
1970,0,16,17,17,50
1971,17,17,0,16,50
1972,17,48,19,15,99
1974,0,32,19,15,66
1975,17,19,49,15,100
1976,0,19,49,15,83
1978,0,34,15,18,67
1980,0,15,18,16,49
1981,0,34,16,16,66
1982,0,16,16,16,48
1985,0,20,14,18,52
1986,14,18,100,16,148
1987,0,18,100,16,134
1988,0,16,18,16,50
1989,0,34,50,16,100
1990,47,19,16,19,101
1991,0,50,16,19,85
1992,15,19,16,19,69
1993,19,16,0,19,54
1994,0,16,0,19,35
1997,20,16,16,17,69
1999,16,17,51,33,117
2000,0,17,51,33,101
2001,0,33,51,17,101
2002,18,51,0,17,86
2003,0,51,0,17,68
2004,13,20,0,17,50
2005,20,17,32,16,85
2006,17,32,66,34,149
2007,0,32,66,34,132
2008,0,16,66,34,116
2009,0,50,16,34,100
2010,0,34,16,34,84
2011,18,16,0,34,68
2013,0,34,0,17,51
2014,19,33,34,16,102
2015,0,33,34,16,83
2016,0,16,34,16,66
2018,19,48,0,18,85
2025,0,50,0,33,83
2026,0,34,0,33,67
2027,19,33,0,17,69
2028,33,17,0,16,66
2029,18,17,0,16,51
2030,0,17,0,16,33
2031,0,50,34,16,100
2033,18,15,19,16,68
2034,15,35,49,17,116
2035,19,16,49,17,101
2036,0,16,49,17,82
2037,31,18,32,19,100
2039,18,17,15,19,69
2040,0,17,15,19,51
2043,0,50,49,16,115
2045,0,19,49,16,84
2046,16,33,0,16,65
2047,0,33,0,16,49
2049,16,19,0,15,50
2050,0,19,0,15,34
2052,0,16,50,19,85
2053,0,34,16,19,69
2054,15,35,65,33,148
2055,0,35,65,33,133
2056,0,19,65,33,117
2058,0,34,15,33,82
2059,34,33,16,19,102
2060,0,15,84,18,117
2061,0,33,16,19,68
2062,0,18,16,19,53
2063,51,18,16,15,100
2064,0,19,16,18,53
2067,0,31,0,17,48
2068,15,35,66,16,132
2069,0,35,66,16,117
2070,0,18,66,16,100
2071,0,36,12,18,66
2072,20,30,34,16,100
2073,30,34,16,34,114
2074,18,34,16,34,102
2075,0,34,16,34,84
2078,0,34,15,16,65
2080,0,31,19,16,66
2081,16,19,33,32,100
2082,0,19,33,32,84
2083,0,33,66,18,117
2084,0,17,66,18,101
2085,0,51,15,18,84
2086,0,36,15,18,69
2087,0,19,15,18,52
2088,0,15,18,16,49
2090,0,16,17,16,49
2092,16,32,19,16,83
2093,0,32,19,16,67
2094,0,16,19,16,51
2095,19,16,0,16,51
2096,16,50,15,17,98
2097,0,50,15,17,82
2098,0,34,15,17,66
2100,32,34,0,17,83
2102,0,34,0,17,51
2103,18,17,16,16,67
2104,0,17,16,16,49
2105,0,32,0,19,51
2106,16,34,19,15,84
2107,0,34,19,15,68
2108,0,15,19,15,49
2111,34,49,0,35,118
2112,18,49,0,35,102
2113,0,49,0,35,84
2114,0,33,0,35,68
2115,33,20,16,16,85
2116,0,35,16,16,67
2117,0,20,16,16,52
2119,16,34,0,15,65
2121,19,15,0,34,68
2122,0,15,0,34,49
2123,0,34,50,18,102
2124,18,37,47,16,118
2125,0,37,47,16,100
2127,0,31,47,20,98
2128,18,32,66,33,149
2130,16,35,0,15,66
2131,0,35,0,15,50
2132,0,20,0,15,35
2133,0,31,16,17,64
2134,16,50,19,15,100
2135,0,50,19,15,84
2137,0,17,19,15,51
2138,0,19,15,16,50
2139,0,31,16,19,66
2140,0,16,16,19,51
2141,0,35,15,18,68
2144,18,33,15,18,84
2145,66,35,32,16,149
2146,18,33,15,20,86
2148,33,20,32,16,101
2149,0,35,32,16,83
2151,0,32,0,16,48
2152,19,50,0,34,103
2154,0,34,0,34,68
2155,18,34,0,16,68
2156,0,34,0,16,50
2157,19,16,0,33,68
2160,18,34,16,33,101
2161,0,34,16,33,83
2162,18,49,32,18,117
2163,0,49,32,18,99
2164,0,33,32,18,83
2165,18,16,16,18,68
2166,0,16,16,18,50
2167,34,35,16,34,119
2169,0,35,16,34,85
2170,18,50,15,35,118
2171,0,50,15,35,100
2172,15,19,15,35,84
2173,19,15,50,19,103
2176,19,34,16,18,87
2177,0,34,16,18,68
2178,0,19,16,18,53
2179,0,34,15,16,65
2180,18,31,15,16,80
2181,0,31,15,16,62
2182,16,50,15,17,98
2183,0,50,15,17,82
2184,0,35,15,17,67
2185,34,17,16,18,85
2186,15,17,16,18,66
2187,0,17,16,18,51
2188,0,34,0,34,68
2190,34,33,0,34,101
2191,0,18,0,33,51
2192,0,33,0,34,67
2193,18,34,35,15,102
2194,34,16,49,19,118
2195,18,16,49,19,102
2197,0,34,15,19,68
2198,0,15,15,19,49
2199,0,34,17,15,66
2200,0,19,17,15,51
2202,0,15,16,18,49
2203,0,34,35,16,85
2204,18,35,33,15,101
2205,0,35,33,15,83
2206,0,19,33,15,67
2207,0,33,98,16,147
2208,0,17,98,16,131
2209,0,31,16,19,66
2211,16,19,16,16,67
2212,19,32,0,16,67
2213,0,32,0,16,48
2215,0,33,18,15,66
2216,0,17,18,15,50
2217,33,34,49,18,134
2220,15,33,16,18,82
2221,0,33,16,18,67
2222,18,34,16,18,86
2224,18,34,0,17,69
2225,0,34,0,17,51
2226,35,16,85,15,151
2227,0,33,85,15,133
2228,0,16,85,15,116
2230,18,51,65,16,150
2231,0,51,65,16,132
2232,15,20,65,16,116
2233,20,15,15,35,85
2234,15,50,0,16,81
2235,0,50,0,16,66
2237,19,16,52,15,102
2238,16,33,19,15,83
2239,0,33,19,15,67
2240,0,16,19,15,50
2242,15,34,47,19,115
2243,0,34,47,19,100
2248,19,34,0,17,70
2249,0,34,0,17,51
2250,18,32,18,16,84
2251,17,15,18,16,66
2252,0,15,18,16,49
2253,34,35,15,16,100
2254,16,35,15,16,82
2256,0,19,15,16,50
2257,0,31,49,19,99
2259,0,34,34,16,84
2260,18,34,16,16,84
2261,34,32,16,18,100
2262,19,32,16,18,85
2268,0,35,65,18,118
2269,19,16,16,18,69
2271,16,18,15,18,67
2272,18,33,16,33,100
2273,0,33,16,33,82
2274,18,49,17,34,118
2275,49,17,15,19,100
2276,15,18,17,34,84
2277,18,17,15,19,69
2278,0,17,15,19,51
2279,0,34,0,15,49
2280,0,19,0,15,34
2281,0,34,0,16,50
2284,32,19,16,15,82
2287,31,35,34,14,114
2288,15,35,34,14,98
2289,0,35,34,14,83
2290,0,18,34,14,66
2291,34,48,0,17,99
2292,18,48,0,17,83
2293,0,48,0,17,65
2294,0,34,0,17,51
2295,18,17,16,35,86
2296,17,51,33,16,117
2297,0,51,33,16,100
2298,0,35,33,16,84
2299,19,17,16,16,68
2300,17,32,16,35,100
2301,0,32,16,35,83
2302,0,16,16,35,67
2303,0,51,17,16,84
2308,0,31,18,19,68
2310,18,49,17,17,101
2311,19,30,17,17,83
2312,0,30,17,17,64
2313,17,17,17,35,86
2314,0,17,17,35,69
2315,0,52,17,16,85
2316,0,35,17,16,68
2317,19,17,16,15,67
2318,33,15,17,18,83
2319,16,15,17,18,66
2322,0,18,0,16,34
2323,0,32,0,19,51
2326,16,33,16,16,81
2327,0,33,16,16,65
2328,16,32,0,16,64
2329,16,16,0,16,48
2330,0,16,0,16,32
2331,0,33,19,15,67
2332,0,17,19,15,51
2333,0,34,67,17,118
2334,15,51,16,17,99
2335,0,51,16,17,84
2336,16,19,16,17,68
2339,17,16,16,19,68
2340,0,16,16,19,51
2341,16,19,15,35,85
2342,0,19,15,35,69
2343,0,50,0,16,66
2344,35,16,0,15,66
2346,0,16,0,15,31
2347,15,35,16,33,99
2348,16,19,16,33,84
2349,19,16,50,18,103
2352,18,35,0,16,69
2353,35,33,15,18,101
2354,18,33,15,18,84
2355,0,33,15,18,66
2356,0,17,15,18,50
2357,15,18,16,34,83
2358,18,50,16,34,118
2360,15,19,16,34,84
2363,34,34,65,18,151
2364,19,34,65,18,136
2365,16,18,65,18,117
2366,0,18,65,18,101
2367,0,49,16,18,83
2372,0,17,15,18,50
2373,0,33,50,15,98
2374,0,18,50,15,83
2375,31,34,16,18,99
2376,0,15,19,15,49
2377,19,15,16,18,68
2378,15,34,50,19,118
2379,0,34,50,19,103
2380,18,34,35,31,118
2381,0,34,35,31,100
2382,0,18,35,31,84
2384,19,31,0,33,83
2385,0,31,0,33,64
2387,0,33,0,16,49
2388,0,18,0,16,34
2390,0,38,12,34,84
2391,22,12,117,34,185
2392,0,12,117,34,163
2394,18,35,116,16,185
2395,0,35,116,16,167
2396,0,19,116,16,151
2397,16,32,0,34,82
2398,14,18,0,34,66
2399,18,34,16,18,86
2400,0,34,16,18,68
2401,34,34,16,18,102
2404,50,50,16,33,149
2405,0,34,66,33,133
2407,31,19,16,33,99
2408,15,19,16,33,83
2411,0,33,17,34,84
2412,18,51,15,33,117
2413,0,51,15,33,99
2414,15,19,15,33,82
2415,0,19,15,33,67
2417,0,33,0,34,67
2418,33,18,35,15,101
2419,34,35,0,15,84
2420,18,35,0,15,68
2421,0,35,0,15,50
2422,19,49,49,34,151
2423,15,34,49,34,132
2424,0,34,49,34,117
2425,19,34,15,34,102
2427,0,19,15,34,68
2428,0,15,15,19,49
2429,0,34,16,18,68
2430,0,19,16,18,53
2431,0,34,16,33,83
2432,18,49,16,19,102
2433,0,49,16,19,84
2434,33,35,14,22,104
2435,18,35,14,22,89
2436,0,35,14,22,71
2437,19,36,29,19,103
2438,0,36,29,19,84
2439,22,13,16,19,70
2440,0,13,16,19,48
2441,0,35,64,35,134
2443,0,49,15,35,99
2444,34,15,51,17,117
2445,19,15,51,17,102
2446,15,35,16,17,83
2447,16,19,16,17,68
2448,19,33,64,19,135
2449,0,33,64,19,116
2450,17,50,14,19,100
2451,0,50,14,19,83
2453,32,19,16,35,102
2454,0,33,16,35,84
2456,0,16,16,19,51
2457,16,19,0,15,50
2458,34,18,15,34,101
2459,0,33,15,34,82
2462,34,34,115,18,201
2463,18,34,115,18,185
2464,34,16,0,33,83
2465,19,16,0,33,68
2466,0,16,0,33,49
2468,18,51,15,18,102
2469,0,51,15,18,84
2471,19,15,18,17,69
2475,50,33,0,18,101
2476,0,34,0,33,67
2479,0,18,0,18,36
2481,32,34,66,16,148
2482,19,34,66,16,135
2483,15,19,66,16,116
2484,19,34,0,32,85
2485,0,34,0,32,66
2486,0,18,0,32,50
2487,0,32,0,16,48
2488,0,20,0,16,36
2489,16,34,0,16,66
2490,0,34,0,16,50
2492,0,16,0,34,50
2493,0,34,0,16,50
2494,18,32,0,19,69
2495,0,32,0,19,51
2496,0,16,0,19,35
2497,0,35,34,15,84
2498,0,16,34,15,65
2499,15,19,49,16,99
2500,19,49,0,16,84
2501,0,49,0,16,65
2502,0,34,0,16,50
2503,18,16,0,16,50
2504,0,16,0,16,32
2506,0,19,16,33,68
2508,15,18,33,34,100
2509,18,17,16,34,85
2510,0,17,16,34,67
2511,0,50,0,16,66
2512,15,19,0,16,50
2513,19,16,16,18,69
2516,0,18,0,16,34
2518,34,33,49,34,150
2520,0,33,49,34,116
2521,18,16,33,34,101
2522,16,33,16,18,83
2523,0,33,16,18,67
2524,14,34,0,16,64
2525,16,18,0,16,50
2526,0,18,0,16,34
2527,0,35,17,15,67
2529,17,15,16,34,82
2530,31,34,15,19,99
2533,18,34,65,35,152
2534,34,15,50,35,134
2535,19,15,50,35,119
2536,50,50,0,17,117
2537,0,35,15,35,85
2538,33,35,0,17,85
2539,15,35,0,17,67
2541,19,17,0,15,51
2542,0,17,0,15,32
2543,0,48,0,19,67
2544,0,33,0,19,52
2545,18,19,16,16,69
2548,16,34,82,34,166
2550,19,32,100,35,186
2552,0,17,100,35,152
2553,0,50,0,34,84
2554,32,34,0,16,82
2556,34,16,0,35,85
2557,18,16,0,35,69
2559,0,35,31,20,86
2561,0,31,50,19,100
2562,0,15,50,19,84
2563,20,15,50,33,118
2564,0,15,50,33,98
2566,0,19,16,33,68
2567,0,49,0,16,65
2568,0,33,0,16,49
2569,0,18,0,16,34
2570,0,16,17,17,50
2573,33,51,32,34,150
2574,18,51,32,34,135
2575,0,51,32,34,117
2577,19,17,15,34,85
2578,32,34,16,34,116
2580,16,18,16,34,84
2581,34,34,67,34,169
2582,0,16,16,18,50
2583,16,18,67,34,135
2584,18,51,16,34,119
2586,16,20,16,34,86
2587,0,20,16,34,70
2588,16,34,65,16,131
2589,15,19,65,16,115
2590,0,19,65,16,100
2591,0,50,15,16,81
2592,0,34,15,16,65
2593,19,15,16,17,67
2594,15,33,84,18,150
2595,16,17,84,18,135
2596,0,17,84,18,119
2597,0,52,16,16,84
2598,15,19,16,16,66
2599,19,16,16,18,69
2600,0,16,16,18,50
2601,16,18,17,15,66
2602,0,18,17,15,50
2603,32,34,0,16,82
2604,15,34,0,16,65
2606,17,32,16,20,85
2608,0,16,16,20,52
2609,16,20,16,16,68
2611,0,32,16,16,64
2612,16,32,69,17,134
2613,0,32,69,17,118
2614,16,50,19,17,102
2615,0,50,19,17,86
2617,18,19,17,16,70
2618,19,33,14,19,85
2619,17,16,14,19,66
2622,19,33,15,19,86
2623,17,16,15,19,67
2624,0,16,15,19,50
2625,34,31,16,19,100
2626,19,31,16,19,85
2627,0,31,16,19,66
2628,15,35,0,16,66
2629,35,32,19,15,101
2632,0,16,19,15,50
2633,34,34,18,17,103
2635,34,35,0,16,85
2637,0,35,0,16,51
2638,17,31,15,20,83
2639,0,31,15,20,66
2640,0,15,15,20,50
2641,0,35,0,16,51
2642,20,31,0,19,70
2644,0,15,0,19,34
2645,0,34,0,16,50
2647,0,35,48,36,119
2648,0,19,48,36,103
2649,14,19,51,31,115
2650,0,19,51,31,101
2651,0,51,0,31,82
2652,16,20,0,31,67
2654,0,31,16,19,66
2655,18,16,0,19,53
2656,0,16,0,19,35
2657,0,35,0,15,50
2658,0,16,0,15,31
2659,0,34,33,16,83
2661,0,33,0,16,49
2663,0,31,16,19,66
2664,0,15,16,19,50
2665,35,50,16,18,119
2666,19,50,16,18,103
2669,19,16,0,18,53
2671,0,34,17,16,67
2672,0,16,17,16,49
2673,33,34,15,19,101
2675,0,34,15,19,68
2678,19,34,0,31,84
2679,0,34,0,31,65
2680,19,31,116,19,185
2681,0,31,116,19,166
2683,0,34,15,21,70
2684,19,36,11,20,86
2685,0,36,11,20,67
2687,11,20,15,19,65
2688,0,20,15,19,54
2689,15,19,13,20,67
2690,0,19,13,20,52
2691,0,33,16,15,64
2692,20,31,51,18,120
2694,15,35,16,18,84
2695,35,34,17,14,100
2696,0,18,16,18,52
2697,0,34,17,14,65
2698,18,31,16,18,83
2700,0,14,16,18,48
2701,0,34,0,34,68
2702,0,18,0,34,52
2703,34,52,14,18,118
2704,18,52,14,18,102
2705,32,20,14,18,84
2706,0,37,14,18,69
2707,0,20,14,18,52
2710,16,34,34,16,100
2711,0,34,34,16,84
2712,19,34,0,16,69
2713,0,34,0,16,50
2714,19,32,16,18,85
2716,32,18,16,16,82
2717,0,34,16,16,66
2718,0,18,16,16,50
2719,0,32,167,32,231
2722,0,18,16,35,69
2723,0,51,16,34,101
2724,15,20,16,34,85
2726,0,16,15,19,50
2727,0,34,0,16,50
2729,0,32,0,32,64
2730,0,16,0,32,48
2731,0,50,16,21,87
2732,16,18,16,21,71
2734,0,16,83,17,116
2735,0,36,0,16,52
2736,0,15,0,16,31
2737,16,31,17,19,83
2738,0,31,17,19,67
2739,53,15,0,16,84
2741,0,34,0,16,50
2742,0,15,0,16,31
2743,0,36,15,32,83
2745,0,47,0,34,81
2746,0,32,0,34,66
2747,18,34,0,16,68
2749,18,16,35,15,84
2750,16,35,0,15,66
2751,0,35,0,15,50
2752,19,34,15,34,102
2754,0,19,15,34,68
2755,15,34,0,16,65
2756,34,16,35,16,101
2757,19,16,35,16,86
2758,16,35,49,15,115
2759,0,35,49,15,99
2760,20,49,0,15,84
2761,0,49,0,15,64
2763,0,19,0,15,34
2767,0,32,0,35,67
2768,18,35,33,34,120
2770,19,33,0,34,86
2771,0,33,0,34,67
2772,0,18,0,34,52
2774,0,19,16,15,50
2775,0,31,50,19,100
2776,0,15,50,19,84
2780,19,33,15,34,101
2782,18,49,15,19,101
2783,15,34,15,19,83
2784,0,34,15,19,68
2785,18,34,16,18,86
2786,0,34,16,18,68
2787,0,19,16,18,53
2788,0,16,18,18,52
2789,0,36,14,34,84
2790,0,18,14,34,66
2791,0,48,0,15,63
2792,0,34,0,15,49
2793,19,15,0,18,52
2794,0,15,0,18,33
2798,0,19,16,34,69
2799,0,50,16,15,81
2800,0,34,16,15,65
2802,0,16,15,19,50
2803,0,34,15,18,67
2804,0,19,15,18,52
2805,0,33,16,15,64
2806,0,18,16,15,49
2807,31,36,16,33,116
2808,15,36,16,33,100
2810,0,16,16,33,65
2811,0,49,15,16,80
2812,15,18,15,16,64
2813,18,31,20,15,84
2814,0,31,20,15,66
2815,16,20,15,35,86
2816,0,20,15,35,70
2817,15,35,15,16,81
2819,19,15,16,19,69
2821,0,35,64,18,117
2822,0,19,64,18,101
2823,49,33,15,19,116
2827,0,18,15,19,52
2828,0,34,15,35,84
2829,19,15,16,19,69
2830,83,34,15,19,151
2831,35,33,17,17,102
2832,19,33,17,17,86
2833,0,33,17,17,67
2834,0,18,17,17,52
2835,0,34,15,19,68
2836,17,34,51,15,117
2837,15,19,51,15,100
2838,0,19,51,15,85
2839,30,21,0,15,66
2841,21,15,0,16,52
2842,0,15,0,16,31
2844,0,15,19,15,49
2845,0,34,0,35,69
2849,31,51,0,18,100
2850,15,51,0,18,84
2851,33,18,0,18,69
2852,13,18,0,18,49
2855,0,32,15,18,65
2856,0,15,15,18,48
2857,68,34,14,19,135
2858,18,35,48,19,120
2859,0,35,48,19,102
2860,20,34,14,19,87
2861,0,34,14,19,67
2863,14,19,15,34,82
2865,0,49,0,17,66
2866,0,34,0,17,51
2867,18,17,0,15,50
2869,0,35,0,15,50
2870,0,20,0,15,35
2871,0,30,0,34,64
2872,49,34,0,18,101
2873,0,34,0,34,68
2874,18,34,0,18,70
2875,0,34,0,18,52
2876,18,34,0,15,67
2879,0,34,15,18,67
2880,0,19,15,18,52
2881,33,49,15,18,115
2882,18,49,15,18,100
2883,0,49,15,18,82
2885,19,33,0,19,71
2886,0,33,0,19,52
2887,18,19,0,15,52
2888,0,19,0,15,34
2889,0,30,0,35,65
2890,0,15,0,35,50
2891,0,35,0,15,50
2892,19,34,65,16,134
2893,0,34,65,16,115
2895,0,50,15,16,81
2896,18,20,15,16,69
2897,0,20,15,16,51
2899,0,33,66,18,117
2901,17,17,0,16,50
2903,0,32,0,18,50
2904,16,34,0,32,82
2905,0,34,0,32,66
2906,0,16,0,32,48
2907,0,51,31,20,102
2908,0,35,31,20,86
2909,0,19,31,20,70
2910,15,36,47,19,117
2911,0,36,47,19,102
2912,20,31,85,16,152
2913,16,15,85,16,132
2914,0,15,85,16,116
2916,19,32,18,16,85
2917,0,32,18,16,66
2918,15,34,34,16,99
2922,34,16,100,34,184
2924,0,16,100,34,150
2926,16,49,17,34,116
2927,15,34,17,34,100
2928,17,17,17,34,85
2930,0,17,16,18,51
2932,18,35,15,31,99
2934,0,18,15,31,64
2936,15,16,0,18,49
2937,16,36,15,16,83
2939,0,18,15,16,49
2942,0,19,15,19,53
2943,0,34,15,17,66
2945,0,32,34,36,102
2946,0,17,34,36,87
2947,0,34,0,36,70
2949,0,36,45,19,100
2951,0,30,50,19,99
2952,18,34,16,19,87
2954,19,35,50,15,119
2955,0,35,50,15,100
2957,0,31,50,16,97
2959,0,34,16,16,66
2960,0,15,16,16,47
2962,0,16,19,16,51
2963,0,35,16,16,67
2964,0,16,16,16,48
2967,35,33,64,18,150
2968,68,33,15,18,134
2972,15,18,15,18,66
2973,18,33,16,18,85
2975,18,34,65,17,134
2976,0,34,65,17,116
2977,51,16,33,19,119
2978,0,33,16,33,82
2979,18,16,33,19,86
2980,0,16,33,19,68
2981,0,33,0,19,52
2984,0,15,16,19,50
2987,0,34,0,16,50
2988,18,32,17,33,100
2989,0,32,17,33,82
2990,0,16,17,33,66
2993,19,34,0,16,69
2995,19,16,16,19,70
2996,0,16,16,19,51
2999,0,30,34,17,81
3000,14,34,0,17,65
3002,15,36,14,18,83
3003,0,36,14,18,68
3004,0,19,14,18,51
3005,14,18,34,15,81
3006,18,34,0,15,67
3008,19,49,48,19,135
3010,0,34,48,19,101
3011,19,33,15,19,86
3012,0,33,15,19,67
3014,0,34,16,34,84
3015,0,19,16,34,69
3016,0,16,15,19,50
3017,0,34,16,34,84
3018,0,19,16,34,69
3019,0,50,15,35,100
3021,50,19,15,34,118
3022,0,15,16,19,50
3023,0,35,15,34,84
3024,0,19,15,34,68
3027,18,34,0,33,85
3031,18,17,0,33,68
3032,0,17,0,33,50
3033,33,34,0,16,83
3034,18,34,0,16,68
3037,0,32,18,33,83
3039,33,18,15,20,86
3040,15,18,15,20,68
3042,15,36,0,16,67
3043,0,36,0,16,52
3044,0,16,0,16,32
3047,0,33,18,16,67
3051,34,34,34,16,118
3053,0,34,34,16,84
3054,0,18,34,16,68
3055,0,34,0,16,50
3056,19,50,0,16,85
3057,0,50,0,16,66
3060,0,16,0,15,31
3062,0,34,15,18,67
3063,51,17,18,16,102
3064,0,33,17,18,68
3065,18,17,18,16,69
3066,0,17,18,16,51
3067,0,34,17,15,66
3070,15,51,15,19,100
3071,0,51,15,19,85
3073,18,34,17,15,84
3074,15,19,17,15,66
3075,0,19,17,15,51
3077,0,49,16,18,83
3078,34,16,18,32,100
3080,0,16,18,32,66
3082,0,32,101,33,166
3083,17,17,18,17,69
3084,0,17,18,17,52
3085,0,35,17,14,66
3086,0,17,17,14,48
3089,18,33,34,17,102
3090,0,33,34,17,84
3091,0,18,34,17,69
3092,0,34,0,17,51
3093,0,19,0,17,36
3096,0,15,17,19,51
3097,0,36,0,15,51
3098,0,19,0,15,34
3099,0,48,0,34,82
3100,33,34,34,17,118
3103,34,35,0,16,85
3106,0,17,0,16,33
3108,0,16,15,19,50
3109,0,34,0,18,52
3110,19,49,53,15,136
3113,18,18,35,15,86
3116,0,20,0,15,35
3120,0,18,0,33,51
3121,0,33,17,34,84
3123,0,51,0,32,83
3124,15,19,0,32,66
3125,19,32,84,34,169
3126,0,32,84,34,150
3127,0,17,84,34,135
3129,19,15,0,19,53
3130,15,34,0,34,83
3131,0,34,0,34,68
3132,0,15,0,34,49
3134,18,34,15,33,100
3135,0,34,15,33,82
3136,18,48,0,35,101
3137,30,18,0,35,83
3138,15,18,0,35,68
3140,0,35,0,16,51
3141,0,19,0,16,35
3142,0,16,0,16,32
3143,0,35,0,16,51
3144,0,19,0,16,35
3145,0,31,0,34,65
3146,15,34,0,33,82
3147,0,34,0,33,67
3148,18,33,16,18,85
3149,0,33,16,18,67
3150,34,18,16,18,86
3151,0,34,16,18,68
3155,0,49,0,16,65
3156,34,16,0,34,84
3159,0,34,51,16,101
3160,18,51,16,16,101
3162,15,19,16,16,66
3164,0,16,16,16,48
3165,0,32,0,22,54
3166,0,16,0,22,38
3167,0,34,15,20,69
3168,27,20,47,19,113
3169,15,20,47,19,101
3170,20,32,34,16,102
3171,0,32,34,16,82
3172,15,34,0,16,65
3175,0,32,0,35,67
3177,0,35,32,34,101
3178,0,19,32,34,85
3179,0,32,0,34,66
3180,0,16,0,34,50
3181,0,34,16,34,84
3186,0,16,16,34,66
3187,0,50,0,17,67
3191,18,16,0,17,51
3193,0,50,15,17,82
3195,19,15,0,17,51
3197,17,18,16,34,85
3200,15,19,17,16,67
3202,17,32,16,35,100
3204,0,16,16,35,67
3205,32,19,64,20,135
3206,16,19,64,20,119
3207,0,19,64,20,103
3208,0,16,17,15,48
3211,16,20,47,19,102
3212,20,32,15,19,86
3213,16,16,15,19,66
3215,0,34,16,17,67
3217,0,33,16,34,83
3219,0,50,16,17,83
3220,34,16,17,18,85
3221,19,16,17,18,70
3222,16,35,31,19,101
3223,17,18,31,19,85
3224,0,18,31,19,68
3225,0,31,19,15,65
3226,16,34,15,20,85
3227,19,15,15,20,69
3228,15,35,49,16,115
3229,35,32,17,16,100
3230,20,32,17,16,85
3232,16,33,17,35,101
3234,0,16,17,35,68
3235,0,52,14,19,85
3236,0,35,14,19,68
3237,20,33,0,16,69
3238,0,33,0,16,49
3239,0,19,0,16,35
3240,0,16,50,16,82
3241,0,32,50,18,100
3244,0,16,16,18,50
3247,0,34,0,15,49
3248,19,49,18,14,100
3252,0,18,33,16,67
3253,65,34,16,18,133
3254,0,19,0,16,35
3256,16,34,16,18,84
3257,0,34,16,18,68
3258,18,34,15,35,102
3259,34,50,33,16,133
3260,18,50,33,16,117
3261,0,50,33,16,99
3263,53,16,67,15,151
3265,0,34,67,15,116
3267,0,51,16,15,82
3268,0,35,16,15,66
3269,19,16,15,34,84
3270,0,16,15,34,65
3272,0,34,16,18,68
3273,18,16,106,12,152
3277,0,51,22,12,85
3278,14,18,22,12,66
3279,18,22,12,16,68
3280,0,22,12,16,50
3281,0,28,134,16,178
3282,0,16,134,16,166
3283,0,34,50,34,118
3285,0,34,16,34,84
3286,18,50,16,16,100
3287,0,50,16,16,82
3288,0,34,16,16,66
3289,0,19,16,16,51
3296,0,18,16,34,68
3297,0,50,16,16,82
3298,34,16,16,18,84
3299,19,16,16,18,69
3300,32,18,15,19,84
3301,0,34,15,19,68
3302,0,18,15,19,52
3303,0,34,16,15,65
3304,19,31,19,15,84
3305,0,31,19,15,65
3306,0,15,19,15,49
3307,19,15,49,18,101
3308,15,34,15,18,82
3309,0,34,15,18,67
3310,0,18,15,18,51
3312,0,18,16,17,51
3313,0,33,16,18,67
3314,0,17,16,18,51
3315,0,34,16,18,68
3316,0,18,16,18,52
3317,51,15,18,34,118
3318,18,32,18,34,102
3319,0,32,18,34,84
3321,18,34,16,33,101
3322,0,34,16,33,83
3323,20,16,15,18,69
3324,0,16,15,18,49
3325,0,33,16,16,65
3326,0,18,16,16,50
3327,0,32,20,15,67
3328,0,16,20,15,51
3329,0,35,15,18,68
3330,15,33,15,18,81
3331,15,18,15,18,66
3332,33,18,16,19,86
3334,0,18,16,19,53
3337,0,33,15,18,66
3339,33,32,0,33,98
3341,32,33,0,17,82
3343,0,33,0,17,50
3344,0,18,0,17,35
3345,0,51,0,32,83
3346,0,34,0,32,66
3347,18,32,17,35,102
3351,35,32,0,35,102
3354,15,35,0,16,66
3356,19,49,16,18,102
3357,49,16,18,16,99
3358,0,33,16,18,67
3359,18,16,18,16,68
3360,16,34,16,18,84
3361,0,34,16,18,68
3362,0,16,16,18,50
3364,18,32,0,17,67
3366,0,16,0,17,33
3367,0,51,15,35,101
3369,19,15,16,19,69
3370,0,15,16,19,50
3372,19,49,0,35,103
3373,16,33,0,35,84
3375,18,35,32,18,103
3376,0,35,32,18,85
3378,32,18,0,16,66
3379,18,18,0,16,52
3380,0,18,0,16,34
3382,0,31,39,16,86
3384,0,18,184,16,218
3389,0,33,0,16,49
3390,33,35,15,18,101
3391,0,51,15,18,84
3392,0,35,15,18,68
3393,34,34,0,16,84
3395,50,35,31,19,135
3396,16,51,31,19,117
3397,0,51,31,19,101
3398,35,16,15,19,85
3399,19,16,15,19,69
3401,15,19,17,15,66
3403,32,34,16,18,100
3404,15,34,16,18,83
3406,18,34,0,17,69
3407,34,33,82,18,167
3410,0,16,82,18,116
3411,32,35,49,33,149
3412,34,16,49,33,132
3414,0,16,49,33,98
3415,15,18,16,33,82
3416,0,18,16,33,67
3418,15,18,50,16,99
3420,16,18,16,16,66
3421,0,18,16,16,50
3423,16,35,15,17,83
3424,0,35,15,17,67
3425,18,15,17,17,67
3426,0,15,17,17,49
3427,0,34,18,34,86
3428,0,17,18,34,69
3432,0,15,15,18,48
3433,15,18,0,20,53
3434,18,51,15,19,103
3435,0,51,15,19,85
3437,18,15,19,16,68
3439,0,35,0,16,51
3440,32,34,16,16,98
3441,0,50,16,16,82
3442,34,16,16,34,100
3445,0,50,50,34,134
3447,18,34,16,34,102
3448,0,34,16,34,84
3450,0,16,15,19,50
3451,0,34,34,15,83
3453,16,18,0,15,49
3454,0,18,0,15,33
3456,16,35,100,16,167
3457,0,35,100,16,151
3458,0,15,100,16,131
3459,0,50,31,19,100
3461,18,16,15,19,68
3462,0,16,15,19,50
3463,0,34,0,16,50
3464,0,19,0,16,35
3465,0,32,16,19,67
3466,16,35,0,16,67
3467,0,35,0,16,51
3468,19,33,0,16,68
3469,0,33,0,16,49
3470,0,17,0,16,33
3471,16,17,0,34,67
3472,0,17,0,34,51
3473,0,34,0,17,51
3474,19,32,0,18,69
3475,0,32,0,18,50
3476,0,15,0,18,33
3478,16,35,31,34,116
3480,0,19,31,34,84
3481,0,31,0,34,65
3482,16,34,18,15,83
3483,0,34,18,15,67
3486,15,35,16,32,98
3487,0,35,16,32,83
3488,19,48,34,33,134
3492,34,33,67,31,165
3493,0,49,67,31,147
3494,0,33,67,31,131
3495,18,17,17,16,68
3496,0,17,17,16,50
3497,0,33,17,31,81
3499,0,48,21,15,84
3500,31,21,15,16,83
3501,16,21,15,16,68
3502,21,31,17,16,85
3504,16,33,16,19,84
3505,0,33,16,19,68
3507,35,31,51,16,133
3508,19,31,51,16,117
3509,16,15,51,16,98
3510,15,34,50,32,131
3511,0,34,50,32,116
3512,16,33,17,32,98
3513,17,16,17,32,82
3517,16,20,32,17,85
3518,0,20,32,17,69
3522,0,16,0,34,50
3523,16,18,16,34,84
3525,0,50,15,18,83
3526,34,15,52,16,117
3527,18,15,52,16,101
3530,16,34,48,17,115
3531,0,34,48,17,99
3533,0,33,15,17,65
3537,19,34,14,19,86
3538,14,20,14,19,67
3539,20,33,13,19,85
3540,0,33,13,19,65
3541,19,32,17,17,85
3542,32,17,17,17,83
3543,0,19,17,17,53
3546,17,33,0,16,66
3547,15,18,0,16,49
3548,0,18,0,16,34
3549,0,50,0,34,84
3551,19,34,0,17,70
3553,19,17,50,15,101
3554,0,17,50,15,82
3555,0,31,19,15,65
3556,0,15,19,15,49
3559,0,34,16,35,85
3561,0,51,0,16,67
3562,15,20,0,16,51
3563,0,20,0,16,36
3564,0,16,32,34,82
3565,16,16,34,32,98
3566,0,16,34,32,82
3569,32,35,16,34,117
3571,0,35,16,34,85
3572,18,50,65,19,152
3573,0,50,65,19,134
3574,0,34,65,19,118
3575,18,16,15,18,67
3576,31,18,16,19,84
3577,0,33,16,19,68
3578,0,18,16,19,53
3582,0,18,15,19,52
3583,15,19,15,34,83
3584,19,49,0,17,85
3587,0,20,0,17,37
3588,0,17,0,33,50
3590,18,33,0,16,67
3591,0,33,0,16,49
3592,0,15,0,16,31
3593,34,50,15,18,117
3595,16,34,15,18,83
3596,0,34,15,18,67
3597,19,15,18,16,68
3598,0,15,18,16,49
3599,18,16,0,18,52
3602,0,16,0,15,31
3603,0,49,0,34,83
3604,68,16,33,34,151
3605,18,34,0,16,68
3606,0,34,0,16,50
3608,16,33,0,34,83
3609,0,33,0,34,67
3610,18,34,34,33,119
3611,0,34,34,33,101
3612,18,34,0,33,85
3614,51,34,15,19,119
3615,0,33,84,33,150
3616,18,34,15,19,86
3617,0,34,15,19,68
3618,18,34,64,19,135
3622,15,18,15,19,67
3623,18,34,16,16,84
3624,0,34,16,16,66
3626,0,16,16,33,65
3627,0,49,16,18,83
3629,18,34,51,16,119
3630,0,34,51,16,101
3631,52,17,98,19,186
3633,19,17,98,19,153
3635,0,37,0,12,49
3636,21,46,15,19,101
3637,0,46,15,19,80
3638,0,34,15,19,68
3639,19,34,16,32,101
3641,19,16,48,18,101
3642,0,16,48,18,82
3643,0,32,16,18,66
3644,18,34,0,16,68
3645,0,34,0,16,50
3646,18,34,15,18,85
3647,0,34,15,18,67
3648,0,18,15,18,51
3650,50,35,16,33,134
3651,0,32,0,35,67
3652,0,15,0,35,50
3653,0,35,16,33,84
3654,19,49,0,34,102
3658,34,15,0,19,68
3661,0,34,0,18,52
3664,0,15,0,34,49
3669,0,34,15,19,68
3672,0,19,15,18,52
3673,0,33,15,19,67
3674,18,34,64,19,135
3675,49,34,50,34,167
3676,0,19,64,19,102
3678,34,34,16,34,118
3682,0,16,15,19,50
3684,0,19,16,18,53
3685,16,18,20,13,67
3686,18,33,15,33,99
3688,13,48,184,33,278
3689,0,48,184,33,265
3691,0,18,184,33,235
3692,33,20,0,15,68
3693,37,31,15,18,101
3694,0,20,0,15,35
3697,65,20,15,33,133
3698,18,52,15,33,118
3699,32,20,15,33,100
3700,16,20,15,33,84
3702,15,33,17,34,99
3703,0,33,17,34,84
3705,0,51,16,16,83
3708,0,16,65,19,100
3709,0,49,35,33,117
3710,33,35,0,33,101
3711,17,35,0,33,85
3712,0,35,0,33,68
3713,19,33,16,33,101
3714,0,33,16,33,82
3715,19,16,33,18,86
3716,16,51,33,16,116
3717,0,51,33,16,100
3718,20,18,33,16,87
3719,0,18,33,16,67
3720,0,33,0,16,49
3722,16,35,15,34,100
3723,35,49,16,19,119
3724,19,49,16,19,103
3725,0,49,16,19,84
3726,16,18,16,19,69
3727,0,18,16,19,53
3728,35,16,16,33,100
3729,0,35,16,33,84
3731,0,49,15,18,82
3735,18,16,19,15,68
3736,0,16,19,15,50
3737,19,15,51,16,101
3739,0,36,31,16,83
3740,17,31,35,16,99
3741,0,31,35,16,82
3742,0,16,35,16,67
3744,0,19,0,16,35
3745,0,31,0,19,50
3746,0,15,0,19,34
3750,18,33,35,16,102
3751,0,33,35,16,84
3752,0,17,35,16,68
3753,0,35,0,16,51
3754,19,32,0,16,67
3755,0,32,0,16,48
3756,0,16,0,16,32
3757,0,35,0,15,50
3758,0,19,0,15,34
3760,0,16,19,15,50
3761,0,34,34,33,101
3762,15,34,0,33,82
3763,0,34,0,33,67
3766,18,34,0,15,67
3768,18,32,15,19,84
3769,15,17,15,19,66
3770,0,17,15,19,51
3771,15,19,16,19,69
3772,19,35,0,16,70
3774,19,31,0,16,66
3775,0,31,0,16,47
3777,0,51,0,34,85
3780,0,34,33,16,83
3781,19,15,34,34,102
3782,0,15,34,34,83
3783,18,16,15,19,68
3784,0,16,15,19,50
3785,34,51,13,19,117
3786,19,51,13,19,102
3788,0,35,13,19,67
3789,20,32,0,17,69
3791,19,17,0,31,67
3792,0,17,0,31,48
3793,12,38,16,16,82
3794,19,19,16,16,70
3795,0,19,16,16,51
3796,0,16,16,17,49
3797,0,33,67,16,116
3798,0,17,67,16,100
3800,16,19,16,16,67
3801,0,19,16,16,51
3802,16,33,34,16,99
3803,0,33,34,16,83
3804,0,17,34,16,67
3806,35,17,16,32,100
3807,0,33,16,32,81
3808,0,17,16,32,65
3809,0,48,0,17,65
3810,16,16,0,17,49
3811,50,36,0,16,102
3812,0,34,36,16,86
3814,0,36,0,16,52
3816,0,16,0,17,33
3817,0,32,19,14,65
3818,0,15,19,14,48
3819,33,34,17,33,117
3822,0,18,17,33,68
3827,0,19,16,18,53
3829,18,16,0,16,50
3830,0,16,0,16,32
3831,0,50,81,19,150
3832,0,34,81,19,134
3833,18,32,0,36,86
3834,32,36,13,19,100
3835,18,36,13,19,86
3836,0,36,13,19,68
3837,20,32,16,18,86
3838,13,19,16,18,66
3839,0,19,16,18,53
3841,33,51,34,17,135
3842,33,33,34,17,117
3843,0,51,34,17,102
3844,0,33,34,17,84
3845,39,30,83,17,169
3846,0,21,13,17,51
3847,0,30,83,17,130
3850,15,51,17,15,98
3851,0,51,17,15,83
3852,15,19,17,15,66
3853,0,19,17,15,51
3854,0,17,15,34,66
3855,0,49,16,34,99
3857,19,16,49,18,102
3860,18,33,16,18,85
3861,0,33,16,18,67
3864,0,18,16,18,52
3865,0,34,82,16,132
3866,0,18,82,16,116
3867,0,49,33,16,98
3868,16,18,33,16,83
3870,18,31,0,19,68
3871,0,31,0,19,50
3873,0,34,17,18,69
3874,0,15,17,18,50
3876,18,31,66,19,134
3878,0,15,66,19,100
3879,0,51,15,19,85
3880,0,32,15,19,66
3881,0,18,15,19,52
3882,0,34,65,19,118
3883,0,19,65,19,103
3885,18,15,16,19,68
3886,0,15,16,19,50
3888,19,32,0,16,67
3890,16,33,0,17,66
3892,0,17,0,17,34
3893,0,33,17,31,81
3894,0,16,17,31,64
3896,15,16,0,21,52
3897,0,16,0,21,37
3899,0,31,0,18,49
3900,15,35,33,15,98
3901,35,33,33,16,117
3903,0,33,33,16,82
3905,0,33,0,16,49
3907,0,50,32,18,100
3909,19,16,16,18,69
3910,0,16,16,18,50
3911,16,18,16,34,84
3912,18,50,16,16,100
3914,34,16,16,19,85
3915,19,16,16,19,70
3917,0,35,15,19,69
3918,0,19,15,19,53
3919,0,34,0,16,50
3920,19,31,0,16,66
3922,0,15,0,16,31
3923,0,50,15,18,83
3925,18,33,17,18,86
3926,0,33,17,18,68
3927,18,17,18,15,68
3928,0,17,18,15,50
3929,18,15,50,19,102
3930,30,20,15,19,84
3931,0,35,15,19,69
3932,20,34,17,15,86
3933,0,34,17,15,66
3935,32,33,17,15,97
3937,0,33,17,15,65
3939,0,32,0,19,51
3942,14,34,133,19,200
3943,0,34,133,19,186
3944,0,14,133,19,166
3945,0,34,0,34,68
3946,15,34,37,12,98
3947,0,34,37,12,83
3950,22,28,19,15,84
3951,28,34,67,33,162
3952,0,16,19,15,50
3953,0,34,67,33,134
3955,35,32,0,33,100
3956,19,32,0,33,84
3957,32,33,0,32,97
3958,16,33,0,32,81
3959,0,33,0,32,65
3960,18,51,15,19,103
3961,16,35,15,19,85
3962,0,35,15,19,69
3964,0,15,19,17,51
3966,17,33,80,18,148
3967,0,33,80,18,131
3970,0,14,18,16,48
3973,0,33,17,18,68
3974,0,18,17,18,53
3975,0,35,16,33,84
3976,34,33,16,18,101
3978,0,33,16,18,67
3980,16,34,0,16,66
3981,18,16,0,16,50
3983,0,50,15,18,83
3984,0,34,15,18,67
3986,33,16,0,19,68
3987,18,16,0,19,53
3988,0,16,0,19,35
3990,0,32,15,20,67
3991,18,35,30,17,100
3992,0,35,30,17,82
3993,20,30,17,35,102
3994,0,30,17,35,82
3995,17,17,0,35,69
3996,0,17,0,35,52
3997,0,35,84,16,135
3999,0,51,15,18,84
4000,16,19,15,18,68
4002,0,15,18,16,49
4005,0,33,35,15,83
4006,18,35,0,15,68
4007,0,35,0,15,50
4008,19,31,0,16,66
4010,0,16,0,16,32
4011,0,36,64,18,118
4012,0,20,64,18,102
4014,33,16,18,17,84
4016,0,16,18,17,51
4019,34,34,15,18,101
4020,19,34,15,18,86
4021,0,34,15,18,67
4022,34,18,15,33,100
4023,0,33,15,33,81
4024,0,18,15,33,66
4026,0,33,15,19,67
4027,19,34,0,16,69
4028,0,34,0,16,50
4029,19,16,0,18,53
4030,0,16,0,18,34
4031,0,34,35,15,84
4032,16,35,48,15,114
4033,0,35,48,15,98
4034,0,19,48,15,82
4035,0,48,0,15,63
4036,0,33,0,15,48
4037,0,18,0,15,33
4042,20,31,69,14,134
4043,15,16,69,14,114
4045,0,50,19,14,83
4046,34,19,14,33,100
4047,18,19,14,33,84
4048,0,19,14,33,66
4049,30,17,19,33,99
4051,50,19,49,16,134
4052,0,19,82,16,117
4053,0,33,49,16,98
4055,34,31,0,19,84
4057,0,31,0,19,50
4058,0,16,0,19,35
4060,0,16,0,33,49
4061,14,19,66,34,133
4062,0,19,66,34,119
4063,16,17,115,35,183
4064,17,33,0,34,84
4065,0,33,0,34,67
4066,18,34,0,17,69
4067,0,34,0,17,51
4068,19,33,65,18,135
4069,0,33,65,18,116
4070,16,50,15,18,99
4071,15,35,15,18,83
4072,0,35,15,18,68
4073,19,33,16,18,86
4074,0,33,16,18,67
4075,18,16,18,33,85
4076,0,16,18,33,67
4077,0,51,0,16,67
4081,0,34,15,19,68
4082,19,34,0,15,68
4083,0,34,0,15,49
4084,19,49,0,34,102
4085,0,49,0,34,83
4087,18,34,15,19,86
4089,19,15,19,15,68
4090,0,15,19,15,49
4093,0,34,84,17,135
4094,0,18,84,17,119
4095,17,15,52,17,101
4096,0,15,52,17,84
4098,20,33,16,16,85
4100,0,17,16,16,49
4101,0,32,16,19,67
4103,0,35,17,15,67
4104,0,19,17,15,51
4105,0,32,16,16,64
4106,0,15,16,16,47
4107,0,32,17,16,65
4108,16,33,20,14,83
4109,0,33,20,14,67
4110,16,34,0,17,67
4111,34,34,15,20,103
4112,0,14,0,17,31
4114,17,35,0,17,69
4115,0,35,0,17,52
4116,20,33,15,17,85
4117,17,16,15,17,65
4119,32,50,0,16,98
4120,0,17,16,34,67
4121,31,19,0,16,66
4122,15,19,0,16,50
4123,19,16,53,15,103
4124,0,16,53,15,84
4127,0,35,15,19,69
4128,15,34,14,19,82
4129,0,34,14,19,67
4130,19,33,16,32,100
4131,0,33,16,32,81
4133,16,32,50,36,134
4135,18,34,16,36,104
4137,0,18,16,36,70
4138,16,36,16,15,83
4139,16,20,16,15,67
4140,0,20,16,15,51
4142,15,35,14,19,83
4144,19,33,49,33,134
4146,19,34,64,17,134
4147,0,34,64,17,115
4148,0,19,64,17,100
4149,30,18,16,17,81
4150,33,33,19,34,119
4152,33,19,14,20,86
4153,17,19,14,20,70
4154,0,19,14,20,53
4155,0,34,16,17,67
4158,0,17,48,16,81
4161,0,33,83,18,134
4162,16,34,67,17,134
4164,16,33,16,18,83
4165,0,33,16,18,67
4166,18,34,17,33,102
4168,18,50,51,16,135
4169,0,50,51,16,117
4170,0,33,51,16,100
4173,35,32,100,16,183
4175,0,32,100,16,148
4177,0,50,15,18,83
4178,15,19,15,18,67
4179,19,33,17,16,85
4180,0,33,17,16,66
4181,18,17,16,34,85
4182,0,17,16,34,67
4183,0,50,0,16,66
4186,0,16,19,15,50
4187,0,34,15,20,69
4188,0,15,15,20,50
4189,0,35,0,17,52
4190,20,31,0,34,85
4191,0,31,0,34,65
4193,0,34,0,33,67
4195,15,18,0,16,49
4196,0,18,0,16,34
4197,0,35,15,34,84
4198,0,19,15,34,68
4199,31,18,34,33,116
4201,0,18,34,33,85
4202,0,34,0,33,67
4203,19,33,0,16,68
4204,0,33,0,16,49
4206,0,16,16,34,66
4207,16,34,16,18,84
4208,34,16,18,16,84
4209,18,16,18,16,68
4212,16,36,0,30,82
4213,0,36,0,30,66
4214,50,18,15,18,101
4216,18,18,15,18,69
4217,0,18,15,18,51
4218,15,18,68,16,117
4220,34,15,19,16,84
4223,0,35,16,33,84
4225,49,16,67,19,151
4226,0,33,16,33,82
4227,34,52,15,19,120
4228,16,52,15,19,102
4229,0,52,15,19,86
4231,0,19,15,19,53
4232,34,15,51,33,133
4233,34,35,65,16,150
4234,0,15,51,33,99
4235,0,35,65,16,116
4236,19,49,16,16,100
4237,30,19,16,16,81
4238,14,19,16,16,65
4239,19,16,0,16,51
4242,0,34,34,16,84
4244,0,16,34,34,84
4245,18,16,15,19,68
4247,34,32,100,18,184
4248,0,19,16,16,51
4249,0,32,100,18,150
4250,16,35,0,16,67
4251,0,35,0,16,51
4253,16,34,33,16,99
4255,19,15,18,16,68
4257,18,16,16,34,84
4259,0,50,32,19,101
4260,15,19,32,19,85
4263,0,35,65,34,134
4264,19,33,14,18,84
4265,15,18,14,18,65
4266,0,18,14,18,50
4268,18,34,17,33,102
4269,0,34,17,33,84
4270,18,50,16,35,119
4271,17,33,16,35,101
4273,19,16,16,19,70
4276,0,19,17,15,51
4277,0,32,35,16,83
4279,0,35,0,16,51
4282,15,34,16,18,83
4283,0,34,16,18,68
4285,34,53,0,14,101
4286,18,53,0,14,85
4287,0,53,0,14,67
4288,0,36,0,14,50
4290,14,49,15,18,96
4291,0,49,15,18,82
4292,0,33,15,18,66
4293,18,33,0,35,86
4296,0,35,30,18,83
4297,19,15,15,18,67
4298,0,15,15,18,48
4300,85,34,0,18,137
4301,0,36,15,16,67
4302,0,19,15,16,50
4305,0,34,0,18,52
4309,0,47,118,18,183
4310,31,20,15,18,84
4312,0,20,15,18,53
4314,0,18,65,18,101
4315,31,17,51,18,117
4317,17,35,16,18,86
4319,18,16,69,15,118
4320,0,16,69,15,100
4321,0,34,82,19,135
4322,0,16,82,19,117
4324,20,31,16,19,86
4326,0,16,16,19,51
4328,19,49,0,16,84
4330,0,34,0,16,50
4331,18,16,16,18,68
4332,0,16,16,18,50
4334,18,50,33,34,135
4336,0,34,33,34,101
4337,18,33,0,34,85
4338,15,18,0,34,67
4340,0,34,0,15,49
4341,19,15,19,15,68
4343,0,34,35,16,85
4344,0,15,35,16,66
4346,19,34,0,14,67
4349,14,35,48,35,132
4350,0,35,48,35,118
4351,19,15,0,19,53
4352,0,15,0,19,34
4353,0,33,50,19,102
4354,0,14,50,19,83
4355,0,35,15,19,69
4356,19,34,47,18,118
4359,0,32,15,18,65
4360,16,33,0,16,65
4361,0,33,0,16,49
4363,0,35,0,16,51
4364,0,19,0,16,35
4365,0,32,34,31,97
4367,34,47,17,19,117
4368,19,47,17,19,102
4369,31,16,17,19,83
4371,52,34,15,19,120
4376,0,15,19,15,49
4377,0,34,49,18,101
4378,0,15,49,18,82
4379,33,34,0,16,83
4381,0,34,0,16,50
4385,34,34,0,16,84
4386,16,34,0,16,66
4387,0,34,0,16,50
4388,18,49,0,34,101
4389,0,49,0,34,83
4390,0,33,0,34,67
4392,0,34,16,35,85
4393,18,16,16,19,69
4394,16,35,0,30,81
4395,16,19,0,30,65
4396,19,50,16,16,101
4397,30,20,16,16,82
4398,16,20,16,16,68
4399,0,20,16,16,52
4402,0,17,16,34,67
4404,34,17,16,17,84
4406,0,17,16,17,50
4408,0,17,0,35,52
4409,0,35,0,16,51
4410,0,20,0,16,36
4411,0,49,16,16,81
4412,33,16,16,16,81
4414,0,16,16,16,48
4419,0,32,16,34,82
4421,0,50,16,18,84
4422,16,18,16,18,68
4423,18,16,50,34,118
4424,0,16,50,34,100
4425,0,34,16,34,84
4427,0,50,0,17,67
4428,0,34,0,17,51
4429,18,17,16,17,68
4431,0,33,16,35,84
4432,17,51,16,16,100
4433,0,51,16,16,83
4434,35,16,16,35,102
4436,0,16,16,35,67
4437,0,51,15,34,100
4438,0,35,15,34,84
4440,0,15,16,18,49
4441,16,18,132,19,185
4442,18,34,16,18,86
4444,18,34,16,33,101
4445,0,34,16,33,83
4446,0,18,16,33,67
4447,0,49,15,19,83
4449,19,15,19,17,70
4450,0,15,19,17,51
4451,69,49,15,19,152
4452,0,17,48,34,99
4454,0,18,15,34,67
4455,0,49,15,19,83
4456,0,34,15,19,68
4457,18,15,19,16,68
4459,19,16,15,21,71
4460,0,16,15,21,52
4461,0,36,14,17,67
4462,21,31,0,17,69
4464,17,33,16,34,100
4466,48,18,17,16,99
4468,16,18,17,16,67
4470,17,50,15,19,101
4471,16,34,15,19,84
4472,0,34,15,19,68
4473,19,34,15,16,84
4474,0,34,15,16,65
4476,15,35,13,18,81
4477,0,35,13,18,66
4478,0,19,13,18,50
4480,0,18,19,16,53
4482,0,16,16,31,63
4483,16,31,19,16,82
4484,0,31,19,16,66
4486,19,35,16,31,101
4489,16,31,16,20,83
4490,0,31,16,20,67
4491,17,36,15,34,102
4493,0,20,15,34,69
4494,0,15,49,19,83
4495,0,34,15,19,68
4496,18,34,16,34,102
4497,0,34,16,34,84
4499,0,50,16,34,100
4500,15,19,16,34,84
4501,0,19,16,34,69
4502,0,16,15,19,50
4503,0,34,32,18,84
4504,19,32,18,16,85
4506,34,16,15,19,84
4507,0,34,15,19,68
4508,0,16,15,19,50
4510,19,33,15,36,103
4511,0,33,15,36,84
4512,0,18,15,36,69
4514,16,20,15,16,67
4515,20,15,16,32,83
4516,0,15,16,32,63
4517,16,32,0,19,67
4518,0,32,0,19,51
4519,17,19,33,18,87
4521,0,33,18,15,66
4523,18,15,16,18,67
4526,0,18,17,35,70
4528,35,15,15,19,84
4530,15,34,16,15,80
4532,19,31,19,14,83
4533,31,33,16,18,98
4534,15,33,16,18,82
4536,14,34,52,15,115
4538,18,34,18,15,85
4539,0,34,18,15,67
4540,15,33,15,19,82
4541,0,33,15,19,67
4542,15,34,16,19,84
4543,0,34,16,19,69
4544,19,35,16,15,85
4545,0,35,16,15,66
4547,0,31,15,16,62
4548,0,15,15,16,46
4549,15,36,16,18,85
4550,0,36,16,18,70
4552,0,16,18,15,49
4555,18,15,0,19,52
4556,0,15,0,19,34
4557,0,34,16,34,84
4559,32,18,0,16,66
4560,34,16,0,34,84
4561,18,16,0,34,68
4565,36,31,15,19,101
4566,17,31,15,19,82
4569,34,50,16,16,116
4572,16,19,16,16,67
4573,19,16,65,18,118
4574,32,33,83,18,166
4576,33,34,16,18,101
4577,52,16,0,18,86
4579,0,18,16,18,52
4580,16,33,50,18,117
4581,0,33,50,18,101
4582,0,15,50,18,83
4583,18,16,16,18,68
4584,0,16,16,18,50
4585,16,18,0,16,50
4586,34,34,31,16,115
4587,16,34,31,16,97
4589,18,16,15,16,65
4590,16,51,15,18,100
4591,0,51,15,18,84
4592,16,20,15,18,69
4593,0,20,15,18,53
4594,33,16,49,19,117
4597,0,34,15,19,68
4600,19,33,81,19,152
4601,33,34,0,15,82
4602,16,34,0,15,65
4603,0,34,0,15,49
4606,0,17,15,19,51
4607,15,19,16,31,81
4608,19,47,34,19,119
4609,0,47,34,19,100
4611,0,16,34,19,69
4612,20,33,71,12,136
4613,0,33,71,12,116
4615,16,37,0,18,71
4617,22,18,0,12,52
4618,0,18,0,12,30
4619,0,28,0,35,63
4621,0,35,65,18,118
4622,19,48,17,18,102
4624,0,33,17,18,68
4627,18,17,16,15,66
4628,0,17,16,15,48
4629,0,31,16,18,65
4633,0,34,0,15,49
4634,18,34,0,15,67
4636,34,34,0,34,102
4637,0,49,0,34,83
4638,34,34,0,16,84
4639,18,34,0,16,68
4640,0,34,0,16,50
4641,19,16,0,16,51
4645,33,51,0,17,101
4646,19,51,0,17,87
4647,0,51,0,17,68
4649,19,17,0,15,51
4650,0,17,0,15,32
4652,0,31,0,19,50
4653,16,19,33,34,102
4655,0,33,0,34,67
4657,16,18,0,15,49
4658,0,18,0,15,33
4660,0,19,35,15,69
4661,15,20,0,15,50
4663,65,50,16,18,149
4664,0,16,0,34,50
4665,0,34,0,15,49
4667,0,50,16,18,84
4669,19,16,100,15,150
4670,0,16,100,15,131
4676,16,35,30,20,101
4677,15,20,30,20,85
4678,0,20,30,20,70
4679,0,30,0,20,50
4682,0,16,16,32,64
4683,0,48,19,15,82
4684,14,18,19,15,66
4685,18,19,15,16,68
4686,0,19,15,16,50
4687,31,51,15,19,116
4688,0,16,0,18,34
4689,0,51,15,19,85
4691,18,34,16,33,101
4694,0,16,14,19,49
4695,0,33,17,16,66
4697,0,33,86,17,136
4700,17,33,84,16,150
4701,0,33,84,16,133
4702,0,16,84,16,116
4705,0,32,19,16,67
4707,0,35,17,16,68
4708,16,33,17,17,83
4709,0,33,17,17,67
4710,0,16,17,17,50
4711,0,34,15,16,65
4712,0,17,15,16,48
4713,15,16,52,16,99
4715,0,33,19,16,68
4716,16,35,49,16,116
4717,0,35,49,16,100
4720,33,16,19,16,84
4721,0,32,19,16,67
4722,16,35,18,18,87
4723,0,35,18,18,71
4725,0,36,16,15,67
4727,0,31,16,16,63
4728,0,15,16,16,47
4729,32,34,50,18,134
4730,0,16,50,18,84
4731,0,34,50,18,102
4732,15,34,16,18,83
4733,0,34,16,18,68
4734,18,34,16,15,83
4736,18,31,50,18,117
4738,15,35,15,18,83
4739,0,35,15,18,68
4741,0,33,16,16,65
4742,18,32,20,15,85
4745,35,33,16,18,102
4746,15,33,16,18,82
4747,0,33,16,18,67
4748,18,34,16,16,84
4749,0,34,16,16,66
4750,18,32,18,18,86
4751,0,32,18,18,68
4752,0,16,18,18,52
4753,0,36,48,15,99
4755,48,15,20,15,98
4756,17,31,20,15,83
4757,16,15,20,15,66
4758,0,15,20,15,50
4759,0,35,52,15,102
4762,0,16,51,18,85
4763,0,35,16,18,69
4765,0,34,15,19,68
4766,18,34,16,16,84
4767,0,34,16,16,66
4768,0,19,16,16,51
4769,0,32,50,16,98
4770,16,34,16,16,82
4772,17,32,17,16,82
4773,0,32,17,16,65
4774,0,16,17,16,49
4775,0,33,19,15,67
4777,0,34,18,18,70
4778,15,36,12,19,82
4779,0,36,12,19,67
4781,0,31,35,15,81
4782,19,35,15,16,85
4783,0,35,15,16,66
4785,31,35,14,19,99
4787,15,20,14,19,68
4788,0,20,14,19,53
4792,0,15,0,19,34
4793,19,15,16,17,67
4795,0,33,16,18,67
4797,0,34,0,16,50
4798,0,18,0,16,34
4799,31,34,20,15,100
4800,0,15,19,15,49
4801,0,34,20,15,69
4802,15,35,16,18,84
4803,0,35,16,18,69
4806,0,18,15,16,49
4808,0,16,19,15,50
4809,0,34,15,19,68
4810,0,15,15,19,49
4811,0,34,15,18,67
4812,19,33,16,18,86
4813,0,33,16,18,67
4814,0,18,16,18,52
4819,0,34,0,16,50
4820,15,32,19,15,81
4821,0,32,19,15,66
4822,0,16,19,15,50
4825,0,34,49,17,100
4826,0,16,49,17,82
4827,0,33,33,16,82
4828,15,33,0,16,64
4831,0,35,16,15,66
4832,0,19,16,15,50
4833,0,31,35,15,81
4834,34,16,49,19,118
4835,0,35,49,19,103
4836,0,16,49,19,84
4837,0,35,14,19,68
4839,14,19,15,15,63
4840,0,19,15,15,49
4842,0,15,20,15,50
4843,0,35,50,18,103
4844,0,15,50,18,83
4845,0,35,15,18,68
4846,18,33,16,16,83
4847,33,32,16,19,100
4849,0,32,16,19,67
4851,35,31,16,19,101
4854,15,35,16,18,84
4855,0,35,16,18,69
4856,0,19,16,18,53
4857,0,34,15,15,64
4858,18,30,70,16,134
4859,0,30,70,16,116
4860,15,35,16,19,85
4861,0,35,16,19,70
4862,0,16,16,19,51
4863,16,19,80,18,133
4864,0,19,80,18,117
4865,0,31,18,15,64
4866,33,15,16,18,82
4870,18,35,0,16,69
4871,17,18,0,16,51
4872,0,18,0,16,34
4874,15,34,16,18,83
4875,34,34,0,16,84
4876,15,34,0,16,65
4877,34,32,84,17,167
4878,18,32,84,17,151
4880,0,16,84,17,117
4881,0,33,16,20,69
4887,16,18,17,13,64
4888,18,30,0,19,67
4889,0,30,0,19,49
4891,0,35,20,14,69
4893,34,33,0,19,86
4894,47,33,0,19,99
4895,0,33,0,19,52
4898,0,14,0,19,33
4901,0,34,16,16,66
4902,0,18,16,16,50
4903,16,16,51,15,98
4904,0,16,51,15,82
4905,32,34,16,19,101
4906,16,34,16,19,85
4907,0,34,16,19,69
4908,15,35,0,15,65
4909,16,19,0,15,50
4910,19,31,17,17,84
4911,0,31,17,17,65
4914,0,17,50,16,83
4915,33,33,0,20,86
4916,16,33,0,20,69
4917,0,33,0,20,53
4918,16,34,52,15,117
4920,0,14,52,15,81
4922,15,33,16,19,83
4924,15,35,16,15,81
4925,0,35,16,15,66
4926,19,31,19,16,85
4927,0,31,19,16,66
4928,15,35,0,15,65
4929,0,35,0,15,50
4930,16,34,15,18,83
4931,15,19,15,18,67
4933,0,33,16,16,65
4934,0,18,16,16,50
4935,0,32,51,15,98
4936,16,34,17,15,82
4937,0,34,17,15,66
4938,0,15,17,15,47
4942,0,20,15,16,51
4943,0,31,16,20,67
4944,16,36,15,15,82
4945,16,20,15,15,66
4946,20,30,18,15,83
4947,0,30,18,15,63
4948,15,33,0,21,69
4950,15,36,0,16,67
4952,0,15,0,16,31
4953,0,32,16,18,66
4954,0,16,16,18,50
4956,18,34,0,15,67
4957,0,34,0,15,49
4958,18,34,49,16,117
4959,0,34,49,16,99
4960,0,19,49,16,84
4961,0,30,19,16,65
4962,15,35,15,19,84
4963,0,35,15,19,69
4964,0,16,15,19,50
4965,0,34,31,18,83
4966,19,31,0,18,68
4968,0,15,0,18,33
4969,0,35,0,17,52
4970,0,17,0,17,34
4971,0,32,0,19,51
4972,0,15,0,19,34
4974,0,17,15,16,48
4978,16,35,15,18,84
4979,15,20,15,18,68
4980,0,20,15,18,53
4981,0,33,67,15,115
4982,18,33,15,19,85
4985,0,34,0,15,49
4986,19,33,49,17,118
4987,15,18,49,17,99
4988,18,30,19,17,84
4989,0,30,19,17,66
4991,36,31,0,20,87
4992,17,31,0,20,68
4995,0,36,0,16,52
4997,16,16,49,17,98
4999,0,33,51,15,99
5000,17,33,18,15,83
5003,18,15,0,18,51
5004,0,15,0,18,33
5006,0,15,0,17,32
5007,0,34,20,15,69
5008,0,17,20,15,52
5010,15,32,17,16,80
5013,0,33,51,16,100
5014,0,16,51,16,83
5015,0,36,15,16,67
5016,0,16,15,16,47
5019,0,36,14,17,67
5020,0,19,14,17,50
5021,31,34,0,17,82
5022,17,34,0,17,68
5023,0,34,0,17,51
5024,0,19,0,17,36
5026,0,16,0,16,32
5027,0,35,0,15,50
5028,0,19,0,15,34
5029,0,31,0,17,48
5030,16,33,84,18,151
5032,35,16,49,18,118
5033,19,16,49,18,102
5034,16,34,15,18,83
5035,0,34,15,18,67
5036,17,33,16,18,84
5037,33,34,15,19,101
5040,18,34,46,19,117
5042,19,30,50,18,117
5044,14,35,15,18,82
5045,0,35,15,18,68
5046,19,33,0,17,69
5047,0,33,0,17,50
5049,0,32,35,16,83
5050,0,15,35,16,66
5052,18,34,0,15,67
5053,0,34,0,15,49
5055,0,31,51,16,98
5057,0,36,47,19,102
5058,18,31,51,18,118
5060,0,16,51,18,85
5061,0,35,16,18,69
5062,19,34,16,18,87
5064,18,34,15,14,81
5065,0,34,15,14,63
5066,33,14,52,19,118
5067,29,37,15,19,100
5068,14,37,15,19,85
5070,18,34,15,16,83
5071,0,34,15,16,65
5072,19,31,50,17,117
5075,35,32,18,15,100
5076,19,32,18,15,84
5077,0,32,18,15,65
5078,17,33,0,16,66
5079,0,33,0,16,49
5080,15,33,16,19,83
5081,0,33,16,19,68
5083,16,19,31,18,84
5084,19,31,34,16,100
5085,0,31,34,16,81
5088,0,16,0,16,32
5090,0,19,0,17,36
5091,0,32,19,14,65
5092,0,15,19,14,48
5093,33,32,19,15,99
5094,14,32,19,15,80
5095,0,32,19,15,66
5096,0,16,19,15,50
5097,0,34,0,19,53
5098,15,35,15,19,84
5100,50,31,19,15,115
5101,34,31,19,15,99
5102,19,31,19,15,84
5103,0,31,19,15,65
5105,0,34,50,18,102
5108,19,33,0,15,67
5109,0,33,0,15,48
5110,0,18,0,15,33
5111,15,19,63,17,114
5113,0,33,15,15,63
5114,18,30,0,17,65
5116,15,36,34,15,100
5117,36,34,0,15,85
5118,0,19,34,15,68
5119,0,34,0,15,49
5124,0,16,16,18,50
5125,16,18,17,18,69
5126,0,18,17,18,53
5127,0,35,16,15,66
5129,31,34,15,19,99
5130,0,15,19,15,49
5133,15,19,48,18,100
5134,19,32,50,18,119
5135,0,32,50,18,100
5136,0,16,50,18,84
5137,16,18,16,18,68
5138,18,34,49,16,117
5139,0,34,49,16,99
5141,0,31,18,16,65
5142,0,15,18,16,49
5143,18,16,50,16,100
5144,16,35,15,16,82
5145,0,35,15,16,66
5146,19,31,0,19,69
5147,15,16,0,19,50
5148,16,36,0,17,69
5149,0,36,0,17,53
5150,34,16,15,16,81
5152,0,16,15,16,47
5154,0,16,17,19,52
5155,0,36,15,18,69
5156,0,19,15,18,52
5158,49,35,15,19,118
5161,0,35,15,19,69
5162,0,16,15,19,50
5164,0,19,0,16,35
5165,16,15,68,18,117
5166,0,15,68,18,101
5167,0,35,33,18,86
5168,15,33,0,18,66
5169,0,33,0,18,51
5170,15,35,17,14,81
5171,0,35,17,14,66
5172,48,34,36,16,134
5175,0,34,36,16,86
5176,0,16,36,16,68
5177,0,36,0,16,52
5179,0,30,19,15,64
5181,0,34,16,18,68
5182,0,15,16,18,49
5183,0,34,32,18,84
5184,18,32,33,19,102
5185,0,32,33,19,84
5187,52,16,34,15,117
5188,0,15,0,19,34
5189,19,16,34,15,84
5190,0,16,34,15,65
5191,0,34,0,15,49
5192,33,16,86,16,151
5193,0,31,86,16,133
5194,0,16,86,16,118
5196,15,34,34,16,99
5197,0,34,34,16,84
5198,15,34,0,16,65
5201,0,32,18,15,65
5202,0,16,18,15,49
5203,0,33,0,17,50
5204,15,36,14,19,84
5205,0,36,14,19,69
5206,0,19,14,19,52
5207,0,33,0,15,48
5208,19,31,34,16,100
5209,15,16,34,16,81
5210,0,16,34,16,66
5211,34,35,14,18,101
5213,0,35,14,18,67
5215,32,35,64,16,147
5216,18,35,64,16,133
5218,19,31,18,15,83
5219,31,33,16,20,100
5220,15,33,16,20,84
5222,15,36,99,17,167
5223,16,20,99,17,152
5225,0,33,15,15,63
5229,36,33,49,18,136
5231,0,33,49,18,100
5232,0,16,49,18,83
5233,0,34,15,18,67
5234,15,33,16,18,82
5235,15,18,16,18,67
5236,18,34,0,15,67
5238,18,31,0,18,67
5239,0,31,0,18,49
5240,0,16,0,18,34
5241,18,16,16,19,69
5243,35,31,0,19,85
5244,19,31,0,19,69
5247,19,16,0,16,51
5248,16,32,18,15,81
5249,0,32,18,15,65
5250,0,16,18,15,49
5252,0,15,53,15,83
5253,0,34,66,19,119
5256,15,32,34,19,100
5257,0,32,34,19,85
5258,0,16,34,19,69
5260,0,15,19,15,49
5261,0,34,16,18,68
5262,31,18,33,15,97
5265,15,18,15,19,67
5266,0,18,15,19,52
5267,15,19,16,16,66
5268,0,19,16,16,51
5269,0,32,34,17,83
5271,0,34,0,17,51
5272,22,33,0,16,71
5273,17,16,0,16,49
5274,0,16,0,16,32
5275,34,31,19,15,99
5276,0,18,0,15,33
5278,16,34,20,15,85
5279,0,34,20,15,69
5282,30,20,0,14,64
5283,0,35,0,14,49
5284,0,20,0,14,34
5286,0,15,0,19,34
5289,0,34,0,17,51
5290,19,31,0,24,74
5293,0,37,16,16,69
5294,0,13,16,16,45
5297,17,16,0,16,49
5298,0,16,0,16,32
5299,0,33,16,19,68
5300,0,17,16,19,52
5301,0,35,16,16,67
5302,19,32,16,17,84
5303,0,32,16,17,65
5305,0,33,0,17,50
5306,17,33,32,18,100
5307,0,33,32,18,83
5308,16,32,0,18,66
5310,0,15,0,18,33
5312,0,17,15,19,51
5313,34,31,21,16,102
5315,16,15,21,16,68
5316,0,15,21,16,52
5317,0,37,0,16,53
5318,0,16,0,16,32
5322,0,18,35,15,68
5323,0,35,0,15,50
5324,19,30,19,16,84
5325,30,35,15,16,96
5326,0,15,19,16,50
5327,35,31,20,15,101
5328,16,31,20,15,82
5329,0,31,20,15,66
5330,16,35,0,19,70
5333,0,34,0,15,49
5335,0,35,0,13,48
5336,0,20,0,13,33
5337,63,34,18,16,131
5338,19,31,19,15,84
5339,0,31,19,15,65
5340,15,34,18,16,83
5341,0,34,18,16,68
5342,15,34,15,19,83
5343,34,34,15,19,102
5346,19,34,0,15,68
5347,0,34,0,15,49
5348,19,35,15,15,84
5349,0,35,15,15,65
5350,0,20,15,15,50
5351,15,15,52,15,97
5353,0,34,18,15,67
5355,18,15,19,15,67
5357,0,34,16,19,69
5358,15,35,30,19,99
5359,0,35,30,19,84
5361,0,30,0,19,49
5362,0,14,0,19,33
5364,0,15,0,16,31
5366,0,20,16,15,51
5367,0,31,0,16,47
5368,0,15,0,16,31
5369,0,35,17,15,67
5371,32,35,15,18,100
5372,15,35,15,18,83
5374,0,20,15,18,53
5375,0,33,0,16,49
5378,14,34,0,20,68
5380,0,15,0,20,35
5382,0,16,0,15,31
5385,0,34,116,14,164
5387,17,17,0,16,50
5388,0,17,0,16,33
5389,16,17,0,17,50
5390,0,17,0,17,34
5393,31,35,0,19,85
5394,0,14,35,19,68
5395,0,35,0,19,54
5397,19,15,0,15,49
5400,19,30,21,14,84
5401,0,30,21,14,65
5402,15,35,19,15,84
5403,0,35,19,15,69
5406,15,33,0,16,64
5407,0,33,0,16,49
5408,0,18,0,16,34
5411,0,33,0,15,48
5412,18,37,12,15,82
5413,0,37,12,15,64
5415,0,27,19,15,61
5416,15,34,19,14,82
5417,0,34,19,14,67
5418,15,33,0,16,64
5419,68,33,50,15,166
5421,0,35,15,18,68
5422,0,19,15,18,52
5425,0,34,16,15,65
5426,0,18,16,15,49
5427,0,31,19,15,65
5428,15,34,19,15,83
5429,0,34,19,15,68
5431,0,34,15,20,69
5432,0,15,15,20,50
5433,0,35,16,18,69
5434,0,20,16,18,54
5435,34,31,18,14,97
5436,34,15,18,14,81
5438,0,15,18,14,47
5440,0,14,20,15,49
5442,0,15,15,18,48
5444,18,34,52,15,119
5447,16,15,36,15,82
5448,0,15,36,15,66
5449,0,36,49,15,100
5450,15,30,34,19,98
5451,0,30,34,19,83
5453,0,34,34,20,88
5454,15,34,51,18,118
5455,0,34,51,18,103
5456,0,15,51,18,84
5457,35,34,0,17,86
5458,15,34,0,17,66
5459,0,34,0,17,51
5460,0,18,0,17,35
5461,0,32,15,19,66
5462,0,15,15,19,49
5464,0,19,0,15,34
5465,0,34,16,14,64
5466,0,19,16,14,49
5467,0,30,19,18,67
5468,14,37,0,15,66
5469,19,18,0,15,52
5470,0,18,0,15,33
5473,0,34,16,18,68
5474,0,19,16,18,53
5476,18,29,19,16,82
5479,19,16,18,15,68
5480,0,16,18,15,49
5481,18,15,19,14,66
5482,15,33,0,20,68
5483,0,33,0,20,53
5486,0,15,48,19,82
5487,0,33,34,15,82
5488,0,18,34,15,67
5489,0,34,33,16,83
5490,19,33,0,16,68
5492,18,32,0,15,65
5493,0,32,0,15,47
5494,0,16,0,15,31
5495,0,34,0,16,50
5497,0,35,0,15,50
5498,0,19,0,15,34
5499,0,30,33,20,83
5500,15,33,0,20,68
5501,0,33,0,20,53
5502,0,15,0,20,35
5504,16,33,0,16,65
5505,33,32,0,20,85
5506,34,16,0,20,70
5508,0,16,0,20,36
5509,0,35,32,17,84
5512,0,15,0,17,32
5513,0,32,53,15,100
5516,16,34,49,20,119
5519,19,14,16,20,69
5521,0,36,16,14,66
5522,0,20,16,14,50
5523,0,30,19,15,64
5524,0,14,19,15,48
5525,19,15,19,15,68
5528,15,33,16,19,83
5531,0,35,98,19,152
5534,0,19,51,15,85
5537,0,34,19,15,68
5538,0,15,19,15,49
5539,0,34,82,19,135
5541,0,34,0,15,49
5543,48,19,0,15,82
5544,0,19,14,19,52
5545,33,31,0,20,84
5546,19,31,0,20,70
5547,15,16,0,20,51
5548,0,16,0,20,36
5549,0,35,0,15,50
5550,0,15,0,15,30
5551,15,19,49,18,101
5553,0,33,16,18,67
5554,0,18,16,18,52
5555,16,18,0,15,49
5556,18,31,18,16,83
5557,0,31,18,16,65
5558,0,16,18,16,50
5561,0,34,15,18,67
5563,0,33,0,16,49
5564,18,35,0,15,68
5565,0,35,0,15,50
5567,0,30,19,15,64
5568,0,15,19,15,49
5569,0,34,19,16,69
5571,35,32,49,19,135
5572,16,32,49,19,116
5573,0,32,49,19,100
5574,35,15,15,19,84
5577,0,34,15,19,68
5578,19,34,14,19,86
5580,0,19,14,19,52
5582,0,19,16,16,51
5584,0,16,83,17,116
5587,31,33,16,19,99
5588,17,33,16,19,85
5589,0,33,16,19,68
5590,17,35,15,19,86
5593,34,31,17,16,98
5594,19,31,17,16,83
5595,16,15,17,16,64
5599,0,35,16,16,67
5600,0,19,16,16,51
5601,0,32,52,15,99
5602,0,16,52,15,83
5604,0,16,20,15,51
5605,0,35,17,15,67
5608,15,37,15,16,83
5610,20,31,17,16,84
5611,31,33,17,16,97
5613,0,33,17,16,66
5614,0,16,17,16,49
5615,17,16,16,17,66
5618,17,35,15,19,86
5620,53,31,0,20,104
5621,34,31,0,20,85
5622,19,31,0,20,70
5623,0,31,0,20,51
5625,0,35,17,15,67
5626,0,15,17,15,47
5629,35,32,51,17,135
5630,18,32,51,17,118
5631,0,32,51,17,100
5632,15,34,49,22,120
5633,0,34,49,22,105
5635,34,37,47,15,133
5637,15,22,47,15,99
5638,50,34,0,17,101
5640,18,34,0,17,69
5641,0,34,0,17,51
5642,0,15,0,17,32
5643,0,34,15,19,68
5644,17,34,15,16,82
5645,34,31,68,15,148
5646,19,31,68,15,133
5648,16,34,18,16,84
5652,16,35,31,16,98
5653,0,35,31,16,82
5654,0,20,31,16,67
5655,0,31,51,16,98
5657,0,36,15,16,67
5658,0,20,15,16,51
5661,68,32,16,19,135
5663,35,32,16,19,102
5664,19,32,16,19,86
5665,0,32,16,19,67
5666,0,15,16,19,50
5667,0,35,0,15,50
5668,19,34,15,18,86
5669,0,34,15,18,67
5671,0,33,0,15,48
5672,18,31,15,18,82
5673,15,16,15,18,64
5675,33,34,16,18,101
5677,0,34,16,18,68
5678,18,34,0,17,69
5679,34,32,18,17,101
5680,18,32,18,17,85
5681,0,32,18,17,67
5682,0,15,18,17,50
5684,17,33,15,18,83
5686,0,16,15,18,49
5687,33,33,0,14,80
5689,0,33,0,14,47
5690,0,17,0,14,31
5691,14,19,17,17,67
5693,17,17,17,16,67
5695,0,33,16,16,65
5697,0,32,35,15,82
5698,16,35,49,16,116
5699,0,35,49,16,100
5700,19,35,14,16,84
5703,30,33,67,20,150
5704,16,33,67,20,136
5705,33,36,15,16,100
5706,0,17,67,20,104
5707,17,19,15,16,67
5708,0,19,15,16,50
5709,31,35,18,15,99
5710,16,35,18,15,84
5712,48,32,0,19,99
5713,33,32,0,19,84
5715,0,32,0,19,51
5716,0,15,0,19,34
5717,0,35,17,15,67
5719,0,32,19,15,66
5721,34,34,34,15,117
5722,15,34,34,15,98
5723,0,34,34,15,83
5724,15,34,15,19,83
5729,31,34,15,18,98
5731,0,34,15,18,67
5732,0,15,15,18,48
5733,0,33,17,15,65
5736,0,15,54,15,84
5737,34,35,0,18,87
5738,15,35,0,18,68
5739,20,15,0,18,53
5741,0,32,19,17,68
5742,0,14,19,17,50
5743,0,36,48,15,99
5744,0,17,48,15,80
5746,16,31,17,19,83
5748,0,15,17,19,51
5751,0,33,51,14,98
5752,19,32,19,14,84
5753,0,32,19,14,65
5755,0,33,17,18,68
5756,14,35,16,18,83
5757,0,35,16,18,69
5758,0,18,16,18,52
5759,0,34,16,15,65
5760,49,35,0,16,100
5763,0,35,0,16,51
5765,16,16,0,16,48
5766,0,16,0,16,32
5767,0,33,19,15,67
5768,0,17,19,15,51
5769,0,34,100,16,150
5770,31,19,15,16,81
5773,0,31,0,19,50
5774,0,16,0,19,35
5778,0,17,0,16,33
5783,0,32,19,16,67
5784,16,35,84,14,149
5785,19,16,84,14,133
5786,0,16,84,14,114
5787,0,31,19,17,67
5788,15,36,31,19,101
5789,19,17,31,19,86
5791,0,31,0,19,50
5792,14,34,16,18,82
5793,50,18,18,16,102
5794,0,15,16,18,49
5795,0,34,18,16,68
5796,18,34,0,15,67
5797,34,33,33,17,117
5798,16,33,33,17,99
5799,0,33,33,17,83
5800,18,33,0,17,68
5801,18,15,0,17,50
5802,0,15,0,17,32
5803,34,31,0,17,82
5804,0,17,0,17,34
5805,0,31,0,17,48
5806,14,37,13,20,84
5807,0,37,13,20,70
5808,0,20,13,20,53
5809,13,20,31,18,82
5811,0,31,0,18,49
5813,0,34,16,18,68
5816,0,18,48,18,84
5817,0,33,15,18,66
5818,18,33,16,18,85
5819,15,18,16,18,67
5820,0,18,16,18,52
5821,0,34,17,14,65
5823,17,14,0,16,47
5824,14,35,16,16,81
5826,0,19,16,16,51
5827,16,16,36,14,82
5828,16,36,68,15,135
5829,0,36,68,15,119
5830,20,32,51,16,119
5831,0,32,51,16,99
5832,0,18,51,16,85
5834,20,31,0,16,67
5835,0,31,0,16,47
5836,0,16,0,16,32
5840,18,34,0,15,67
5842,19,34,0,15,68
5843,0,34,0,15,49
5844,19,31,34,16,100
5845,65,34,0,17,116
5846,0,16,34,16,66
5848,15,34,0,17,66
5849,0,34,0,17,51
5850,0,18,0,17,35
5854,0,15,0,21,36
5856,0,13,16,16,45
5857,0,32,0,16,48
5858,85,32,16,17,150
5859,16,20,15,18,69
5860,53,32,16,17,118
5861,33,32,16,17,98
5862,18,32,16,17,83
5863,0,32,16,17,65
5864,0,15,16,17,48
5865,33,35,0,14,82
5866,17,35,0,14,66
5867,0,35,0,14,49
5868,0,19,0,14,33
5869,0,30,0,18,48
5870,16,37,0,16,69
5871,0,37,0,16,53
5872,0,19,0,16,35
5874,14,36,15,18,83
5875,0,36,15,18,69
5876,19,33,0,16,68
5877,0,33,0,16,49
5880,0,16,18,15,49
5881,0,33,0,19,52
5882,15,35,49,18,117
5883,0,35,49,18,102
5884,0,16,49,18,83
5885,0,33,16,18,67
5886,52,33,34,15,134
5888,18,33,34,15,100
5889,0,33,34,15,82
5890,17,34,0,15,66
5891,34,31,0,19,84
5892,19,31,0,19,69
5893,0,31,0,19,50
5894,16,35,0,17,68
5896,0,16,0,17,33
5897,0,33,33,16,82
5898,16,33,51,15,115
5899,33,32,34,17,116
5900,17,32,34,17,100
5901,0,32,34,17,83
5902,16,34,0,17,67
5903,34,33,33,20,120
5904,15,33,33,20,101
5905,0,33,33,20,86
5906,0,16,33,20,69
5907,0,33,0,20,53
5909,0,33,14,22,69
5910,0,13,14,22,49
5911,0,36,0,17,53
5912,22,34,15,15,86
5914,17,30,0,18,65
5918,0,16,49,20,85
5919,34,35,17,14,100
5920,15,35,17,14,81
5922,20,31,16,19,86
5923,0,31,16,19,66
5924,14,35,16,18,83
5926,53,31,16,20,120
5927,34,31,16,20,101
5928,18,31,16,20,85
5930,32,20,16,14,82
5931,0,36,16,14,66
5935,0,36,16,15,67
5936,15,31,53,16,115
5937,0,31,53,16,100
5938,15,34,19,16,84
5941,0,35,0,15,50
5942,16,34,0,15,65
5945,0,31,18,17,66
5946,0,16,18,17,51
5947,18,17,97,19,151
5948,17,32,0,15,64
5949,0,32,0,15,47
5951,32,33,86,16,167
5952,0,17,33,19,69
5953,0,33,86,16,135
5954,14,34,0,19,67
5956,0,15,0,19,34
5957,0,34,18,16,68
5959,0,34,0,16,50
5960,16,35,0,16,67
5961,0,35,0,16,51
5962,35,16,34,15,100
5963,0,32,34,15,81
5964,16,34,0,15,65
5967,0,31,19,17,67
5970,0,17,34,16,67
5971,50,16,33,16,115
5973,0,32,33,16,81
5974,0,16,33,16,65
5976,18,35,16,15,84
5978,19,31,50,16,116
5979,0,31,50,16,97
5980,15,35,15,16,81
5981,0,35,15,16,66
5982,0,19,15,16,50
5983,15,16,0,18,49
5985,0,34,18,16,68
5986,0,16,18,16,50
5987,18,16,15,20,69
5988,0,16,15,20,51
5989,35,31,50,16,132
5990,20,31,50,16,117
5992,15,35,15,16,81
5993,0,35,15,16,66
5994,19,31,52,16,118
5995,0,31,52,16,99
5996,16,36,47,17,116
5997,0,36,47,17,100
