序号,发送->接收,接收->转发,转发->接收,接收->处理,总计
1,71,32,52,15,170
2,95,17,100,17,229
3,101,33,67,17,218
5,66,33,67,17,183
6,51,33,67,17,168
7,52,15,67,17,151
9,67,33,66,18,184
11,101,32,68,17,218
12,66,17,100,17,200
13,67,32,68,17,184
14,84,34,51,15,184
15,84,16,51,15,166
16,67,16,51,15,149
17,82,18,65,17,182
18,66,18,65,17,166
19,68,32,50,18,168
22,83,35,84,16,218
23,82,18,84,16,200
24,65,18,84,16,183
25,50,18,84,16,168
26,68,15,68,15,166
27,67,34,67,16,184
30,83,33,100,17,233
33,67,34,66,17,184
34,65,18,66,17,166
35,67,32,67,16,182
37,83,17,134,15,249
39,83,16,66,18,183
40,68,16,66,18,168
43,67,32,101,15,215
44,66,16,101,15,198
45,66,35,132,16,249
46,85,32,155,12,284
47,117,16,66,16,215
49,85,16,66,16,183
51,66,32,101,17,216
52,66,17,101,17,201
53,66,34,67,17,184
54,65,17,67,17,166
56,67,17,101,15,200
58,84,34,83,16,217
60,68,17,83,16,184
61,51,17,83,16,167
62,63,16,66,17,162
63,82,18,67,17,184
64,65,18,67,17,167
65,99,34,100,16,249
67,66,34,100,16,216
68,51,34,100,16,201
69,67,34,66,16,183
70,84,32,133,17,266
71,68,32,133,17,250
72,101,16,66,18,201
73,66,34,66,18,184
75,66,33,66,17,182
76,100,16,83,18,217
77,84,16,83,18,201
79,84,15,68,15,182
81,66,34,99,17,216
82,99,18,65,17,199
83,116,15,52,17,200
84,83,30,52,17,182
88,83,34,151,16,284
89,65,34,151,16,266
90,50,34,151,16,251
92,67,16,118,16,217
93,117,17,67,17,218
94,100,17,67,17,201
96,66,17,67,17,167
97,50,17,67,17,151
98,50,33,101,16,200
100,84,33,83,18,218
101,67,33,83,18,201
102,50,33,83,18,184
103,67,34,100,17,218
104,66,17,100,17,200
105,67,32,68,17,184
106,66,16,68,17,167
108,66,18,65,18,167
109,117,15,101,17,250
111,68,32,101,17,218
112,68,15,101,17,201
113,65,33,68,17,183
114,68,15,68,17,168
115,84,16,83,17,200
116,67,16,83,17,183
117,85,16,67,16,184
118,100,17,66,16,199
120,99,17,83,17,216
122,66,17,83,17,183
124,66,17,50,17,150
125,82,17,100,17,216
126,66,17,100,17,200
128,67,17,100,17,201
129,50,17,100,17,184
130,67,16,68,17,168
131,83,17,51,15,166
132,66,17,51,15,149
134,67,17,150,17,251
135,68,32,67,17,184
136,51,32,67,17,167
138,83,33,68,15,199
140,99,16,68,16,199
142,66,16,68,16,166
143,66,35,83,16,200
144,84,33,50,16,183
146,66,18,50,16,150
148,66,16,100,17,199
149,65,34,116,18,233
151,83,17,67,15,182
152,99,17,118,17,251
153,83,17,118,17,235
154,82,35,83,17,217
157,67,33,67,15,182
158,117,35,67,16,235
159,50,18,67,15,150
160,68,15,102,16,201
161,83,17,67,16,183
162,68,17,67,16,168
163,67,34,66,16,183
164,100,17,66,17,200
165,69,33,66,17,185
166,67,17,66,17,167
168,101,17,66,17,201
169,66,33,66,17,182
170,66,17,66,17,166
171,115,17,67,17,216
172,116,34,67,15,232
173,82,17,67,17,183
174,83,34,67,15,199
175,66,34,67,15,182
177,83,16,84,17,200
178,68,16,84,17,185
180,99,17,51,15,182
181,117,17,66,16,216
182,65,17,51,15,148
183,84,17,66,16,183
184,100,15,68,17,200
185,83,15,68,17,183
188,83,33,83,17,216
189,66,33,83,17,199
192,68,17,66,17,168
193,116,17,134,13,280
195,66,34,134,13,247
196,66,17,134,13,230
197,66,33,51,15,165
198,116,33,67,16,232
199,51,16,51,15,133
200,83,33,67,16,199
203,51,15,67,16,149
204,69,16,65,17,167
205,81,19,67,16,183
206,63,19,67,16,165
207,67,33,50,18,168
208,81,34,67,17,199
209,99,34,84,16,233
210,69,17,67,17,170
212,67,18,84,16,185
213,68,33,133,16,250
215,84,17,66,16,183
216,68,17,66,16,167
217,67,33,66,16,182
218,69,16,66,16,167
220,83,33,134,16,266
221,66,33,134,16,249
225,83,17,67,16,183
226,84,32,51,17,184
228,67,16,51,17,151
229,65,35,83,18,201
230,68,16,83,18,185
231,67,33,68,16,184
232,117,35,66,16,234
233,51,17,68,16,152
234,82,35,66,16,199
236,67,18,66,16,167
237,50,18,66,16,150
238,52,31,51,17,151
239,51,15,51,17,134
240,84,33,51,16,184
242,66,17,51,16,150
243,101,34,132,18,285
245,84,16,132,18,250
246,68,16,132,18,234
248,83,35,65,18,201
249,66,35,65,18,184
250,66,17,65,18,166
252,67,16,100,17,200
253,51,16,100,17,184
258,83,33,67,16,199
259,67,33,67,16,183
260,66,16,67,16,165
261,65,34,66,16,181
262,83,33,83,18,217
265,83,17,135,16,251
266,65,17,135,16,233
267,66,35,100,16,217
268,66,19,100,16,201
269,68,33,150,16,267
270,85,32,51,16,184
271,68,32,51,16,167
272,84,35,83,16,218
274,66,19,83,16,184
275,67,32,67,17,183
276,67,16,67,17,167
277,67,35,98,17,217
279,83,16,101,15,215
281,67,34,117,15,233
283,82,16,85,15,198
284,66,16,85,15,182
287,67,32,51,17,167
288,51,32,51,17,151
289,100,35,66,16,217
290,68,15,101,16,200
292,68,17,66,16,167
293,101,33,84,16,234
294,83,33,84,16,216
297,66,33,67,16,182
298,65,17,67,16,165
299,66,33,133,16,248
300,65,17,133,16,231
301,66,34,66,16,182
302,166,17,66,19,268
304,51,34,65,16,166
307,82,17,66,19,184
309,65,34,84,16,199
311,99,35,99,17,250
312,83,35,99,17,234
313,66,35,99,17,217
314,69,16,99,17,201
315,51,16,99,17,183
316,68,16,66,17,167
317,52,16,66,17,151
318,83,32,271,17,403
319,99,33,84,17,233
321,66,33,84,17,200
322,66,16,84,17,183
324,71,16,66,16,169
325,68,32,124,17,241
327,67,34,90,17,208
329,82,18,103,17,220
330,84,30,73,17,204
332,81,43,81,17,222
334,74,17,81,17,189
335,56,17,81,17,171
336,73,34,68,15,190
337,101,34,83,16,234
338,64,17,68,15,164
339,132,32,101,15,280
341,68,34,133,15,250
342,134,16,68,15,233
343,83,17,101,15,216
345,66,33,68,15,182
346,67,16,68,15,166
347,99,34,65,19,217
348,50,34,67,16,167
350,68,16,65,19,168
351,52,16,65,19,152
353,67,32,85,15,199
354,65,16,85,15,181
355,84,15,134,16,249
356,69,15,134,16,234
357,51,15,134,16,216
360,66,15,235,17,333
361,51,15,235,17,318
362,100,17,67,17,201
365,51,17,67,17,152
367,68,32,83,17,200
369,67,33,67,17,184
370,84,33,51,16,184
371,65,33,51,16,165
373,83,17,84,15,199
375,67,33,117,17,234
377,51,16,117,17,201
378,67,17,83,17,184
379,67,32,101,17,217
380,67,15,101,17,200
381,99,35,149,18,301
384,83,33,116,18,250
386,52,33,116,18,219
389,67,33,67,17,184
390,68,17,67,17,169
391,67,32,67,17,183
392,50,32,67,17,166
393,82,18,66,16,182
394,66,18,66,16,166
395,67,32,67,16,182
396,100,17,83,17,217
397,67,34,83,17,201
399,66,33,67,16,182
400,65,17,67,16,165
401,67,33,233,17,350
402,83,34,116,16,249
403,83,17,116,16,232
404,67,17,116,16,216
406,51,33,83,16,183
407,67,35,131,17,250
408,85,32,99,17,233
409,68,32,99,17,216
410,52,32,99,17,200
413,98,33,117,17,265
414,66,16,67,17,166
415,82,17,117,17,233
416,83,34,83,17,217
417,67,34,83,17,201
419,101,32,84,16,233
420,51,34,66,16,167
421,68,32,84,16,200
424,66,17,234,16,333
425,66,34,167,16,283
426,100,16,201,17,334
427,84,16,201,17,318
428,67,16,201,17,301
429,100,33,68,16,217
430,67,17,83,18,185
431,66,33,68,16,183
432,67,16,68,16,167
434,184,33,66,18,301
435,66,35,66,17,184
436,66,18,66,17,167
437,68,33,117,15,233
438,51,33,117,15,216
439,68,33,84,15,200
440,84,33,66,18,201
442,67,16,66,18,167
443,66,33,51,16,166
444,66,17,51,16,150
445,84,15,67,16,182
447,84,16,68,16,184
448,68,16,68,16,168
449,51,16,68,16,151
450,82,35,81,17,215
451,83,19,81,17,200
452,65,19,81,17,182
453,68,33,65,16,182
454,51,33,65,16,165
458,65,17,67,16,165
459,65,35,99,15,214
460,65,19,99,15,198
461,68,32,67,15,182
463,83,17,84,16,200
464,67,17,84,16,184
465,99,34,149,17,299
466,67,16,66,17,166
467,67,34,149,17,267
468,51,34,149,17,251
469,68,32,68,16,184
472,101,18,66,17,202
473,65,35,66,17,183
474,84,33,83,16,216
475,68,33,83,16,200
476,51,33,83,16,183
478,67,17,66,17,167
481,99,33,67,17,216
483,99,34,83,16,232
485,65,34,83,16,198
486,66,17,83,16,182
487,117,17,100,20,254
488,67,16,66,18,167
489,84,17,100,20,221
490,67,17,100,20,204
491,117,16,101,17,251
492,66,16,68,20,170
493,84,16,101,17,218
494,83,34,84,16,217
495,66,34,84,16,200
496,68,16,84,16,184
498,70,47,167,16,300
499,54,47,167,16,284
500,65,18,167,16,266
501,84,16,67,16,183
502,97,16,133,17,263
503,53,16,67,16,152
504,68,16,133,17,234
505,116,17,66,17,216
507,83,17,66,17,183
508,99,18,166,16,299
509,117,16,68,17,218
511,83,16,68,17,184
514,85,33,66,16,200
515,67,33,66,16,182
517,68,33,134,16,251
518,68,16,134,16,234
524,119,34,131,17,301
525,101,34,131,17,283
526,66,19,115,17,217
527,68,34,131,17,250
529,69,31,67,16,183
530,53,31,67,16,167
531,98,34,65,19,216
533,64,34,65,19,182
534,67,17,65,19,168
535,100,32,102,16,250
536,51,33,51,17,152
537,84,15,102,16,217
538,67,15,102,16,200
540,68,17,99,17,201
541,51,17,99,17,184
542,51,33,66,17,167
544,66,17,68,15,166
545,134,32,67,16,249
546,83,35,149,15,282
547,66,35,149,15,265
549,68,32,67,16,183
551,83,18,83,15,199
552,99,18,132,18,267
554,66,18,132,18,234
556,85,31,67,18,201
557,67,31,67,18,183
559,65,32,53,17,167
560,116,35,66,15,232
561,63,35,67,17,182
562,82,35,66,15,198
563,67,35,66,15,183
566,51,32,67,18,168
567,67,34,151,15,267
568,66,17,151,15,249
570,64,18,118,15,215
571,133,34,67,17,251
572,68,15,85,15,183
573,51,15,85,15,166
575,66,34,67,17,184
576,82,33,101,17,233
577,85,15,101,17,218
578,68,15,101,17,201
579,52,15,101,17,185
580,84,34,50,15,183
581,67,34,50,15,166
583,101,32,167,18,318
584,83,32,167,18,300
586,67,15,167,18,267
588,98,18,82,17,215
589,82,18,82,17,199
592,66,16,134,17,233
593,115,17,67,17,216
594,83,34,67,17,201
595,65,34,67,17,183
597,67,34,100,16,217
598,68,16,100,16,200
599,52,16,100,16,184
600,51,33,67,16,167
601,67,34,84,17,202
602,167,17,66,16,266
603,67,33,68,15,183
604,84,34,83,17,218
606,101,17,66,16,200
607,67,34,66,16,183
608,85,32,65,17,199
609,68,32,65,17,182
613,66,31,119,18,234
615,65,36,83,18,202
616,65,19,83,18,185
617,168,31,50,16,265
618,67,17,68,14,166
621,65,36,64,17,182
624,150,47,70,17,284
625,180,20,67,18,285
626,99,16,300,17,432
627,64,33,300,17,414
628,67,16,300,17,400
629,50,16,300,17,383
630,50,47,70,17,184
631,100,33,52,16,201
633,67,33,52,16,168
634,82,34,134,16,266
637,67,34,132,17,250
638,50,34,132,17,233
640,100,18,65,17,200
641,67,34,65,17,183
643,67,33,66,17,183
644,66,17,66,17,166
645,50,17,66,17,150
648,66,17,134,15,232
650,67,16,101,15,199
651,100,33,68,17,218
654,66,16,68,17,167
655,66,35,82,18,201
656,83,33,151,15,282
657,68,33,151,15,267
659,117,18,67,17,219
660,1299,16,67,17,1399
661,100,32,100,16,248
662,67,18,67,17,169
663,67,32,100,16,215
664,65,17,100,16,198
666,67,18,100,16,201
667,167,31,101,16,315
668,52,32,151,16,251
669,52,15,151,16,234
670,83,35,83,16,217
671,65,35,83,16,199
672,83,31,101,16,231
673,68,31,101,16,216
674,51,31,101,16,199
675,101,33,84,15,233
676,69,16,66,16,167
677,165,33,83,19,300
678,167,15,83,19,284
679,301,33,67,16,417
680,82,33,116,19,250
681,66,33,116,19,234
684,100,16,68,15,199
685,300,33,51,17,401
686,100,17,167,16,300
687,51,16,68,15,150
688,65,17,167,16,265
694,51,33,67,16,167
695,65,35,100,16,216
696,167,18,98,17,300
697,68,32,84,17,201
698,84,33,51,17,185
700,100,18,98,17,233
701,65,35,98,17,215
703,84,17,117,16,234
704,52,33,117,16,218
705,51,17,117,16,201
706,51,34,83,16,184
707,67,31,101,16,215
711,83,16,82,18,199
712,84,33,67,16,200
713,52,16,82,18,168
714,100,17,50,17,184
715,301,33,134,17,485
716,65,17,50,17,149
717,166,34,82,17,299
718,99,17,233,18,367
720,67,17,233,18,335
721,50,17,233,18,318
722,302,17,99,17,435
723,66,34,82,17,199
725,166,33,101,17,317
726,67,17,83,15,182
728,82,33,134,17,266
729,99,33,101,17,250
730,65,17,134,17,233
731,65,33,101,17,216
732,966,17,67,17,1067
733,100,35,99,17,251
736,84,32,67,17,200
737,101,34,66,17,218
738,300,16,66,19,401
740,66,17,66,17,166
743,100,34,83,16,233
744,301,16,82,17,416
745,66,34,83,16,199
747,549,18,68,16,651
748,149,33,68,17,267
749,101,32,66,19,218
750,50,34,81,17,182
751,67,32,66,19,184
752,67,16,66,19,168
753,535,32,133,17,717
754,99,17,52,16,184
755,98,35,82,17,232
756,65,17,52,16,150
758,69,16,82,17,184
759,550,18,83,16,667
760,52,33,133,16,234
762,66,16,68,14,164
763,66,33,67,16,182
764,65,17,67,16,165
765,66,35,65,18,184
767,68,32,100,16,216
771,65,33,100,17,215
772,51,33,100,17,201
773,100,34,68,16,218
774,68,16,102,16,202
775,67,34,68,16,185
776,115,36,132,16,299
777,50,18,68,16,152
778,82,36,132,16,266
779,66,36,132,16,250
780,67,19,132,16,234
781,68,32,133,17,250
782,166,18,83,16,283
783,52,16,133,17,218
785,98,34,83,16,231
786,98,18,83,16,215
787,66,34,83,16,199
788,67,18,83,16,184
790,51,33,66,17,167
791,50,17,66,17,150
792,168,16,51,16,251
793,83,16,67,16,182
794,100,17,66,18,201
795,166,34,116,17,333
797,300,33,168,16,517
798,67,16,51,16,150
799,67,33,67,16,183
801,66,34,116,17,233
802,67,16,116,17,216
804,51,33,100,16,200
805,116,19,99,16,250
806,65,18,99,17,199
809,83,17,67,16,183
810,67,17,67,16,167
811,99,34,84,16,233
812,67,17,168,16,268
813,82,17,84,16,199
815,100,34,67,16,217
816,51,33,67,16,167
817,67,34,67,16,184
818,66,18,67,16,167
819,67,33,100,17,217
820,84,34,153,29,300
822,168,15,55,29,267
823,67,34,119,29,249
824,66,18,119,29,232
825,100,32,55,29,216
826,52,32,87,29,200
828,100,17,151,15,283
829,64,35,151,15,265
831,67,20,178,17,282
832,99,18,65,19,201
833,55,47,65,19,186
834,66,18,65,19,168
835,67,33,234,15,349
836,63,17,234,15,329
837,99,34,68,16,217
838,51,32,66,17,166
839,65,34,68,16,183
842,66,16,117,19,218
844,83,33,67,15,198
847,101,35,131,18,285
848,100,19,131,18,268
849,65,35,131,18,249
850,65,19,131,18,233
851,100,32,66,18,216
852,84,32,66,18,200
853,68,32,66,18,184
855,166,32,68,20,286
856,100,16,51,16,183
857,66,32,51,16,165
858,100,17,82,18,217
859,66,35,82,18,201
860,516,34,133,16,699
862,67,16,68,20,171
863,155,46,83,17,301
864,168,15,83,17,283
866,84,20,63,17,184
867,68,20,63,17,168
868,101,15,83,17,216
869,54,46,83,17,200
871,51,15,83,17,166
872,63,17,132,17,229
875,149,17,67,16,249
876,66,17,66,17,166
877,66,34,83,16,199
879,51,17,83,16,167
881,101,32,67,16,216
882,66,18,99,16,199
883,67,32,67,16,182
886,66,17,67,16,166
889,83,17,85,15,200
890,100,18,66,16,200
893,67,32,67,17,183
894,67,16,67,17,167
895,85,15,66,18,184
897,99,33,84,18,234
901,66,35,67,15,183
902,50,35,67,15,167
903,51,17,67,15,150
904,51,32,217,17,317
906,66,18,66,18,168
907,67,32,150,17,266
908,117,33,83,17,250
911,66,33,83,17,199
912,102,16,66,17,201
913,101,34,66,16,217
914,69,16,66,17,168
915,67,34,66,16,183
917,300,34,99,17,450
918,82,34,166,17,299
919,100,32,52,16,200
920,50,34,166,17,267
922,51,32,52,16,151
924,66,18,83,16,183
925,166,34,99,17,316
926,84,33,67,16,200
928,51,33,67,16,167
929,99,34,99,17,249
930,66,16,67,16,165
931,66,34,99,17,216
935,67,32,101,16,216
936,101,15,67,16,199
937,65,34,67,16,182
938,68,15,67,16,166
939,66,34,116,16,232
942,82,33,100,16,231
943,67,33,100,16,216
946,66,18,66,16,166
948,101,16,69,32,218
949,100,33,68,16,217
950,68,16,69,32,185
951,66,33,68,16,183
953,103,32,116,16,267
954,65,20,81,17,183
956,151,34,66,17,268
957,68,34,98,18,218
958,52,34,98,18,202
960,66,17,100,17,200
962,100,16,85,17,218
963,498,34,67,16,615
964,168,17,131,17,333
965,66,34,84,18,202
967,66,33,51,18,168
969,168,33,165,18,384
970,67,17,131,17,232
975,66,33,165,18,282
976,99,16,117,16,248
977,97,34,83,16,230
978,67,16,117,16,216
979,65,34,83,16,198
982,100,17,66,19,202
983,67,34,66,19,186
986,65,16,53,15,149
987,66,34,134,16,250
988,67,16,134,16,233
989,85,15,67,16,183
991,101,34,67,16,218
993,67,34,67,16,184
995,100,34,66,17,217
997,101,33,100,16,250
999,67,33,100,16,216
1000,100,17,67,16,200
1001,67,33,67,16,183
1002,67,17,67,16,167
1003,66,34,65,17,182
1004,67,17,65,17,166
1005,100,32,68,16,216
1006,84,32,68,16,200
1007,99,34,83,24,240
1008,50,32,68,16,166
1009,65,34,83,24,206
1011,66,34,73,26,199
1012,67,17,73,26,183
1013,68,33,66,17,184
1014,100,24,60,16,200
1017,99,34,50,17,200
1018,100,17,50,17,184
1019,66,34,50,17,167
1020,67,17,50,17,151
1021,110,17,101,16,244
1025,50,17,101,16,184
1026,68,16,68,16,168
1030,65,19,148,16,248
1031,68,32,116,16,232
1033,66,33,83,16,198
1034,100,17,66,17,200
1035,81,17,66,17,181
1036,65,17,66,17,165
1038,67,17,150,15,249
1039,68,31,119,15,233
1040,83,34,100,17,234
1042,100,16,66,17,199
1044,68,16,66,17,167
1046,51,37,81,16,185
1047,71,29,68,16,184
1048,67,15,68,16,166
1051,62,35,83,15,195
1052,166,15,69,17,267
1054,51,33,65,18,167
1055,68,34,100,17,219
1056,65,18,100,17,200
1057,67,31,69,17,184
1058,67,15,69,17,168
1059,65,34,101,16,216
1060,118,33,82,18,251
1061,65,35,66,16,182
1062,84,33,82,18,217
1063,500,35,100,16,651
1065,68,33,117,16,234
1066,66,17,117,16,216
1067,66,32,85,16,199
1069,166,32,84,18,300
1070,66,18,98,18,200
1071,67,33,65,18,183
1072,101,16,134,16,267
1073,68,33,134,16,251
1074,68,16,134,16,234
1075,66,32,84,18,200
1076,316,34,66,16,432
1077,65,35,83,17,200
1081,65,37,66,17,185
1082,100,17,84,16,217
1083,67,33,84,16,200
1084,103,32,101,18,254
1086,101,15,101,18,235
1087,98,35,100,16,249
1088,168,15,118,16,317
1089,65,35,100,16,216
1090,83,34,66,16,199
1095,66,34,84,16,200
1096,67,16,84,16,183
1097,66,33,67,17,183
1098,549,33,100,16,698
1100,81,35,66,16,198
1101,65,35,66,16,182
1102,68,16,66,16,166
1103,168,33,82,18,301
1105,52,16,68,16,152
1106,66,16,86,30,198
1109,166,35,65,18,284
1111,51,17,82,18,168
1112,52,18,165,17,252
1113,51,47,100,18,216
1114,99,18,65,18,200
1117,67,31,52,17,167
1118,52,31,52,17,152
1119,100,35,83,16,234
1120,66,17,118,16,217
1121,65,35,83,16,199
1122,85,32,99,19,235
1124,52,32,99,19,202
1125,67,34,65,19,185
1126,66,17,65,19,167
1129,151,16,67,16,250
1131,65,34,84,17,200
1132,67,15,84,17,183
1133,51,15,84,17,167
1134,68,16,67,16,167
1135,68,32,51,16,167
1136,65,16,51,16,148
1137,84,17,67,17,185
1138,167,16,66,17,266
1140,67,16,52,16,151
1141,168,33,67,16,284
1143,84,16,66,17,183
1144,84,33,100,16,233
1147,66,33,67,16,182
1148,66,16,67,16,165
1150,66,16,50,18,150
1151,100,34,82,17,233
1155,167,35,65,17,284
1156,100,16,84,17,217
1159,66,33,51,17,167
1160,65,17,51,17,150
1161,66,35,65,17,183
1162,65,19,65,17,166
1163,84,17,66,16,183
1166,184,31,152,17,384
1167,99,33,51,13,196
1168,66,17,66,18,167
1169,82,17,51,13,163
1170,65,17,51,13,146
1172,83,31,152,17,283
1173,84,13,152,17,266
1175,99,34,100,16,249
1176,166,18,68,15,267
1177,66,34,100,16,216
1178,67,15,100,16,198
1180,98,18,68,15,199
1182,64,18,68,15,165
1183,67,33,101,17,218
1186,51,35,66,17,169
1188,52,32,51,17,152
1189,50,17,51,17,135
1192,68,17,65,18,168
1193,99,34,68,17,218
1194,918,32,101,16,1067
1196,66,16,68,17,167
1197,65,34,99,16,214
1198,84,34,65,16,199
1199,52,16,99,16,183
1200,50,34,65,16,165
1202,99,16,85,15,215
1204,67,16,85,15,183
1206,64,19,116,16,215
1207,67,31,151,17,266
1210,69,15,117,17,218
1212,100,16,167,16,299
1213,685,17,117,16,835
1214,66,16,167,16,265
1216,167,16,83,19,285
1218,83,34,66,16,199
1219,67,34,66,16,183
1220,67,17,66,16,166
1221,166,35,65,18,284
1222,67,16,83,19,185
1224,65,18,101,16,200
1225,66,33,68,16,183
1226,66,17,68,16,167
1227,67,35,65,18,185
1228,67,19,65,18,169
1229,68,33,82,17,200
1230,52,33,82,17,184
1233,115,17,134,16,282
1234,67,16,99,18,200
1236,100,15,102,16,233
1237,99,34,68,16,217
1238,100,15,68,16,199
1239,65,34,68,16,183
1241,300,35,83,17,435
1243,102,32,101,16,251
1245,84,16,101,16,217
1246,50,32,101,16,199
1247,51,16,101,16,184
1249,67,33,117,16,233
1250,67,17,117,16,217
1251,51,17,117,16,201
1254,66,17,168,14,265
1255,66,35,83,17,201
1256,100,16,51,17,184
1258,84,33,68,14,199
1260,102,17,65,18,202
1261,83,17,65,18,183
1263,165,35,66,17,283
1264,98,18,67,17,200
1266,64,18,67,17,166
1267,65,32,52,16,165
1269,815,16,51,17,899
1270,67,18,66,17,168
1273,301,33,69,17,420
1274,51,33,151,16,251
1275,66,33,69,14,182
1276,66,16,69,14,165
1277,100,35,65,16,216
1278,83,35,65,16,199
1279,167,33,84,18,302
1280,66,19,65,16,166
1282,100,16,66,18,200
1283,68,32,66,18,184
1284,68,16,66,18,168
1286,100,17,69,17,203
1289,66,33,53,15,167
1293,86,15,84,16,201
1294,51,32,84,16,183
1295,53,15,84,16,168
1296,50,34,66,16,166
1297,66,32,100,18,216
1298,165,16,52,17,250
1299,66,34,99,19,218
1301,66,36,63,19,184
1303,70,30,52,17,169
1305,283,17,82,19,401
1307,63,36,132,16,247
1308,68,17,132,16,233
1310,51,33,64,19,167
1313,65,32,51,17,165
1314,65,16,51,17,149
1315,64,35,68,15,182
1316,166,17,66,18,267
1317,67,33,82,19,201
1321,100,34,66,17,217
1322,67,17,66,18,168
1323,67,34,66,17,184
1324,85,32,100,16,233
1325,98,34,66,16,214
1327,100,33,84,16,233
1328,69,16,66,16,167
1329,83,16,84,16,199
1331,51,16,84,16,167
1332,82,35,133,16,266
1333,101,32,68,16,217
1334,65,19,133,16,233
1335,68,32,68,16,184
1336,67,16,68,16,167
1337,51,16,68,16,151
1338,100,19,65,16,200
1339,66,34,65,16,181
1340,100,17,65,18,200
1343,150,17,84,16,267
1344,52,32,51,17,152
1345,98,35,84,16,233
1346,100,17,84,16,217
1348,84,32,52,16,184
1349,284,17,82,17,400
1350,152,32,67,17,268
1351,67,34,133,17,251
1352,67,16,133,17,233
1353,66,34,64,18,182
1356,50,32,67,17,166
1357,66,32,52,17,167
1358,64,16,52,17,149
1359,64,35,66,18,183
1360,67,17,66,18,168
1361,67,34,82,17,200
1363,52,17,82,17,168
1364,51,32,136,14,233
1365,66,35,81,20,202
1366,165,20,81,18,284
1369,50,17,69,14,150
1370,66,18,65,18,167
1371,81,20,81,18,200
1372,86,31,85,15,217
1373,69,31,85,15,200
1375,99,34,132,16,281
1376,300,19,66,18,403
1379,68,32,68,16,184
1380,50,32,68,16,166
1381,51,15,68,16,150
1382,150,33,101,18,302
1384,64,19,166,18,267
1385,68,32,68,16,184
1386,84,33,101,18,236
1387,65,33,101,18,217
1388,301,18,99,16,434
1389,100,33,116,16,265
1390,84,33,116,16,249
1391,152,17,64,17,250
1392,52,33,116,16,217
1394,103,17,64,17,201
1395,165,35,99,16,315
1396,68,17,64,17,166
1397,51,17,64,17,149
1398,168,15,67,16,266
1400,65,16,134,16,231
1402,68,18,99,16,201
1404,68,15,67,16,166
1405,52,15,67,16,150
1406,50,33,102,16,201
1407,65,34,132,19,250
1409,51,16,132,19,218
1413,68,32,51,15,166
1414,52,32,51,15,150
1416,167,18,100,17,302
1417,64,34,84,16,198
1419,51,15,84,16,166
1420,83,34,100,17,234
1422,65,18,100,17,200
1423,68,32,68,17,185
1425,50,16,68,17,151
1426,50,34,116,18,218
1427,100,33,117,16,266
1430,52,33,117,16,218
1431,51,16,117,16,200
1434,65,18,66,16,165
1435,67,35,163,19,284
1436,102,16,68,15,201
1437,85,16,68,15,184
1438,84,32,83,17,216
1439,66,32,83,17,198
1440,102,17,64,19,202
1441,163,36,98,17,314
1442,67,17,64,19,167
1443,68,31,101,17,217
1446,64,17,185,16,282
1447,64,36,98,17,215
1448,85,32,117,16,250
1449,52,17,98,17,184
1451,68,33,84,16,201
1453,165,33,119,16,333
1456,66,18,117,16,217
1457,68,32,67,18,185
1458,67,16,67,18,168
1459,152,16,67,16,251
1460,50,33,119,16,218
1461,99,34,67,16,216
1462,65,18,85,16,184
1463,67,34,67,16,184
1465,102,33,64,17,216
1466,52,34,81,16,183
1467,283,17,150,17,467
1469,67,33,67,16,183
1471,66,31,52,15,164
1472,64,16,52,15,147
1476,52,31,119,16,218
1477,52,15,119,16,202
1479,67,32,150,17,266
1480,150,33,116,16,315
1481,51,17,150,17,235
1482,168,16,83,16,283
1483,64,35,149,16,264
1484,68,16,149,16,249
1486,51,33,116,16,216
1487,68,33,83,16,200
1488,66,16,83,16,181
1491,67,32,67,18,184
1492,50,32,67,18,167
1494,66,16,52,16,150
1495,65,34,83,18,200
1496,66,16,83,18,183
1498,100,18,99,16,233
1500,66,18,99,16,199
1501,68,33,66,16,183
1502,65,18,66,16,165
1504,51,34,81,17,183
1505,99,34,67,16,216
1508,51,34,67,16,168
1509,149,17,66,16,248
1510,65,17,84,17,183
1511,66,35,66,16,183
1512,68,17,66,16,167
1513,83,17,66,16,182
1514,167,17,67,16,267
1515,51,17,66,16,150
1516,83,33,68,15,199
1518,99,17,67,16,199
1519,66,33,67,16,182
1520,66,17,67,16,166
1521,66,35,215,17,333
1522,67,18,215,17,317
1525,101,32,117,17,267
1526,100,16,117,17,250
1527,66,32,117,17,232
1528,67,16,117,17,217
1529,100,33,50,17,200
1531,66,33,50,17,166
1532,67,16,50,17,150
1533,67,34,67,16,184
1535,67,33,67,16,183
1536,117,33,67,16,233
1538,83,33,67,16,199
1540,100,17,50,17,184
1541,100,34,66,17,217
1542,98,18,66,17,199
1543,66,34,66,17,183
1544,100,17,67,16,200
1545,67,33,67,16,183
1546,67,17,67,16,167
1547,50,17,67,16,150
1548,101,17,82,18,218
1549,66,34,82,18,200
1550,67,17,82,18,184
1552,83,33,85,15,216
1553,50,17,67,16,150
1554,484,32,68,16,600
1556,100,16,101,17,234
1557,484,16,117,16,633
1558,116,33,51,17,217
1559,167,34,65,18,284
1560,84,33,51,17,185
1561,66,33,51,17,167
1562,66,17,51,17,151
1564,82,34,65,18,199
1565,67,34,65,18,184
1567,51,17,65,18,151
1569,99,35,66,17,217
1570,66,16,69,14,165
1573,51,17,66,17,151
1574,85,32,66,18,201
1575,69,32,66,18,185
1576,100,17,66,16,199
1577,66,34,66,16,182
1578,67,17,66,16,166
1580,68,16,68,16,168
1581,166,35,76,25,302
1583,66,34,83,16,199
1586,50,32,111,25,218
1587,301,33,100,16,450
1588,68,17,76,25,186
1589,67,32,101,17,217
1590,67,16,101,17,201
1591,67,44,124,16,251
1592,66,27,124,16,233
1593,76,25,99,16,216
1594,85,32,100,17,234
1595,69,32,100,17,218
1596,52,32,100,17,201
1598,101,17,66,16,200
1599,99,33,100,16,248
1600,66,17,66,16,165
1602,66,17,100,16,199
1604,99,17,84,16,216
1607,100,33,67,16,216
1608,99,17,67,16,199
1609,67,33,67,16,183
1610,67,17,67,16,167
1611,67,33,151,17,268
1614,100,18,83,17,218
1616,66,18,83,17,184
1619,50,16,68,17,151
1621,83,17,66,15,181
1623,68,32,68,16,184
1624,50,32,68,16,166
1625,67,34,66,18,185
1626,66,17,66,18,167
1627,100,32,68,17,217
1629,68,32,68,17,185
1630,101,17,50,31,199
1632,69,17,50,31,167
1633,167,33,116,17,333
1634,66,18,67,16,167
1635,68,17,66,17,168
1636,50,17,66,17,150
1641,68,33,83,17,201
1642,168,17,83,16,284
1643,66,32,151,16,265
1644,100,17,66,16,199
1645,166,32,67,16,281
1646,67,17,66,16,166
1647,67,33,83,16,199
1648,67,17,83,16,183
1651,149,16,51,16,232
1652,66,16,67,16,165
1653,65,34,84,16,199
1654,66,16,84,16,182
1655,66,33,51,16,166
1657,51,16,51,16,134
1658,65,17,69,33,184
1659,84,16,68,17,185
1660,83,35,82,16,216
1661,51,16,68,17,152
1662,51,35,82,16,184
1664,51,33,99,17,200
1665,99,34,67,17,217
1667,64,34,67,17,182
1668,167,18,65,16,266
1670,66,16,117,16,215
1671,101,35,65,16,217
1672,67,16,84,16,183
1674,66,18,65,16,165
1675,101,32,117,17,267
1676,66,18,67,16,167
1677,68,32,117,17,234
1679,100,32,118,16,266
1680,85,32,118,16,251
1681,67,32,118,16,233
1682,51,32,118,16,217
1683,51,16,118,16,201
1684,51,34,100,16,201
1685,99,31,52,17,199
1686,83,31,52,17,183
1689,64,36,67,17,184
1691,151,16,67,17,251
1693,52,17,51,16,136
1694,83,33,67,17,200
1695,84,16,67,17,184
1696,51,33,67,17,168
1697,51,16,67,17,151
1698,151,34,81,17,283
1700,83,33,66,17,199
1701,166,34,51,32,283
1702,67,16,66,17,166
1703,52,16,66,17,151
1705,67,32,66,19,184
1707,66,34,51,32,183
1708,67,17,51,32,167
1709,98,19,66,15,198
1710,66,17,68,17,168
1711,66,19,66,15,166
1712,300,16,83,18,417
1713,51,49,82,17,199
1714,102,15,67,17,201
1715,68,32,67,17,184
1716,66,15,67,17,165
1718,66,17,100,17,200
1721,84,17,66,17,184
1722,84,33,66,17,200
1724,51,33,66,17,167
1727,66,33,117,18,234
1728,67,16,117,18,218
1729,66,35,82,18,201
1731,68,33,67,17,185
1732,66,18,67,17,168
1733,68,33,68,15,184
1734,51,33,68,15,167
1735,66,34,100,17,217
1736,67,18,100,17,202
1737,67,34,83,16,200
1738,84,32,51,16,183
1739,100,34,82,17,233
1740,67,17,51,16,151
1741,66,34,82,17,199
1742,83,33,66,16,198
1743,500,31,85,15,631
1744,51,33,66,16,166
1746,68,16,150,17,251
1748,98,18,83,17,216
1749,66,34,83,17,200
1751,67,32,68,17,184
1752,67,16,68,17,168
1753,50,16,68,17,151
1754,67,19,65,16,167
1756,166,18,83,18,285
1757,101,34,66,16,217
1758,51,33,84,16,184
1759,65,34,66,16,181
1760,66,18,66,16,166
1761,100,33,99,17,249
1764,68,16,99,17,200
1765,66,34,65,17,182
1766,101,18,66,15,200
1767,83,18,66,15,182
1768,66,18,66,15,165
1770,67,16,85,15,183
1771,65,35,65,18,183
1772,66,18,65,18,167
1774,51,34,98,18,201
1776,101,16,51,16,184
1777,65,34,51,16,166
1778,117,34,84,16,251
1779,65,33,118,16,232
1780,166,16,100,16,298
1781,67,34,84,16,201
1782,67,16,84,16,183
1783,51,16,84,16,167
1785,167,33,84,16,300
1788,83,33,68,15,199
1789,67,33,68,15,183
1790,99,17,84,16,216
1791,67,33,84,16,200
1794,66,19,65,16,166
1795,68,33,83,16,200
1796,67,18,83,16,184
1797,100,35,66,16,217
1798,68,16,67,17,168
1799,166,32,52,16,266
1800,66,19,66,16,167
1803,67,34,66,18,185
1804,101,16,52,16,185
1805,66,32,52,16,166
1807,66,34,83,16,199
1808,67,16,83,16,182
1810,50,34,65,18,167
1811,52,16,65,18,151
1812,150,33,101,16,300
1813,67,32,102,16,217
1814,99,17,67,16,199
1817,100,34,67,16,217
1819,169,32,66,17,284
1821,100,34,82,16,232
1822,51,33,66,17,167
1823,101,32,66,17,216
1825,67,32,66,17,182
1826,51,32,66,17,166
1827,299,33,70,31,433
1828,67,17,101,16,201
1829,98,35,100,15,248
1833,302,31,84,17,434
1834,85,32,83,16,216
1835,101,34,65,17,217
1837,66,34,65,17,182
1839,66,32,67,16,181
1840,65,17,67,16,165
1842,99,17,67,16,199
1845,67,36,82,17,202
1846,86,31,84,17,218
1847,70,31,84,17,202
1848,152,33,98,17,300
1849,67,33,51,17,168
1850,167,18,132,17,334
1851,82,17,82,16,197
1852,68,17,82,16,183
1853,68,33,98,17,216
1854,100,18,132,17,267
1857,82,16,84,16,198
1858,66,16,84,16,182
1860,67,16,67,17,167
1861,65,35,132,17,249
1862,166,16,85,16,283
1863,68,32,183,17,300
1864,67,16,183,17,283
1866,50,34,117,16,217
1867,98,34,133,18,283
1868,66,16,85,16,183
1869,66,34,133,18,251
1870,100,16,50,17,183
1873,85,16,66,18,185
1874,68,16,66,18,168
1876,50,33,68,17,168
1877,50,17,68,17,152
1878,167,16,66,16,265
1879,101,17,66,16,200
1880,68,17,66,17,168
1881,517,18,133,17,685
1882,52,17,66,16,151
1883,167,33,85,17,302
1885,165,35,67,16,283
1886,66,16,101,15,198
1887,50,16,101,15,182
1888,98,17,85,17,217
1891,66,35,67,16,184
1893,68,34,116,16,234
1894,67,19,116,16,218
1897,100,33,66,16,215
1898,52,33,66,17,168
1899,66,33,66,16,181
1900,66,17,66,16,165
1901,166,34,133,17,350
1902,67,16,83,18,184
1903,66,33,100,17,216
1904,67,16,100,17,200
1905,66,34,66,17,183
1906,99,18,133,17,267
1907,67,34,133,17,251
1911,66,35,115,17,233
1912,85,33,199,17,334
1913,67,33,199,17,316
1914,52,33,199,17,301
1915,167,34,66,17,284
1916,51,33,66,17,167
1919,66,33,66,17,182
1922,66,17,66,17,166
1923,67,32,84,17,200
1924,67,16,84,17,184
1925,66,34,50,17,167
1926,66,17,50,17,150
1927,66,34,99,16,215
1928,517,33,84,16,650
1929,51,17,99,16,183
1930,99,18,85,16,218
1932,100,16,52,16,184
1935,66,33,67,17,183
1936,67,17,67,17,168
1939,83,17,84,17,201
1940,101,16,68,16,201
1942,299,16,84,16,415
1943,100,33,84,32,249
1944,101,17,84,32,234
1946,168,49,66,16,299
1947,100,35,99,17,251
1948,51,32,52,32,167
1951,67,17,82,17,183
1954,66,17,66,16,165
1955,66,33,84,16,199
1956,82,33,67,18,200
1957,99,33,52,16,200
1958,99,17,52,16,184
1959,66,33,52,16,167
1960,100,16,83,17,216
1961,66,34,83,17,200
1963,85,16,66,17,184
1964,51,34,66,17,168
1966,67,15,51,17,150
1967,100,34,67,15,216
1968,65,17,166,17,265
1969,167,32,102,32,333
1973,66,35,65,17,183
1976,100,16,101,16,233
1978,101,16,68,16,201
1979,65,33,68,16,182
1980,67,16,68,16,167
1982,68,17,81,18,184
1983,101,33,67,15,216
1984,151,33,166,18,368
1985,68,33,67,15,183
1987,65,34,67,16,182
1989,100,34,83,16,233
1991,67,34,83,16,200
1992,66,19,83,16,184
1993,99,33,100,17,249
1994,50,32,100,18,200
1995,66,33,100,17,216
2000,50,33,84,15,182
2001,67,33,66,19,185
2002,499,17,84,15,615
2003,66,33,52,15,166
2005,66,33,85,16,200
2006,66,15,85,16,182
2007,66,34,51,16,167
2008,68,15,51,16,150
2013,51,16,83,17,167
2014,51,35,164,19,269
2015,68,33,99,17,217
2016,66,18,99,17,200
2018,66,17,67,17,167
2019,65,34,65,19,183
2020,50,34,65,19,168
2021,167,32,84,15,298
2022,68,16,68,15,167
2023,51,16,68,15,150
2025,65,36,65,18,184
2026,67,17,65,18,167
2027,68,32,84,15,199
2028,51,32,84,15,182
2029,51,17,84,15,167
2030,100,15,52,32,199
2031,65,33,52,32,182
2032,68,15,52,32,167
2033,99,19,131,18,267
2034,83,19,131,18,251
2035,85,49,82,18,234
2037,52,49,82,18,201
2039,68,34,66,16,184
2041,100,34,118,32,284
2042,51,32,134,18,235
2043,100,32,68,18,218
2044,66,18,118,32,234
2045,66,32,68,18,184
2046,66,16,68,18,168
2047,66,35,116,17,234
2048,300,18,84,31,433
2049,67,33,67,16,183
2050,51,33,67,16,167
2052,99,17,66,17,199
2054,67,17,66,17,167
2055,67,33,82,18,200
2056,65,17,82,18,182
2057,52,17,82,18,169
2058,100,16,67,16,199
2059,99,34,84,31,248
2060,99,18,84,31,232
2061,66,34,84,31,215
2062,167,49,83,18,317
2063,67,33,51,31,182
2065,149,18,83,18,268
2066,102,49,83,18,252
2068,68,49,83,18,218
2069,51,49,83,18,201
2070,66,18,83,18,185
2072,66,17,67,16,166
2074,52,33,100,17,202
2077,67,32,68,16,183
2079,66,34,115,18,233
2080,67,17,115,18,217
2081,83,17,81,18,199
2082,165,18,66,18,267
2083,51,17,81,18,167
2085,100,33,66,18,217
2086,149,33,101,16,299
2087,66,33,66,18,183
2088,101,15,117,17,250
2089,99,33,101,16,249
2091,66,33,101,16,216
2092,51,33,101,16,201
2093,66,34,67,16,183
2095,51,16,67,16,150
2098,66,17,165,7,255
2099,67,33,132,7,239
2100,66,17,132,7,222
2101,67,32,100,7,206
2102,82,35,105,16,238
2103,65,35,105,16,221
2104,101,16,156,16,289
2106,68,16,156,16,256
2108,170,35,100,16,321
2109,89,32,68,16,205
2110,537,34,67,17,655
2111,56,32,68,16,172
2112,56,33,118,17,224
2113,150,33,66,17,266
2114,65,35,100,16,216
2115,49,35,100,16,200
2116,68,33,131,18,250
2119,300,17,117,16,450
2120,66,34,64,18,182
2121,67,17,64,18,166
2122,67,32,66,17,182
2124,66,32,51,19,168
2125,66,15,51,19,151
2126,64,34,85,17,200
2127,66,16,85,17,184
2128,285,16,66,18,385
2129,66,19,131,17,233
2130,51,19,131,17,218
2131,52,33,66,16,167
2132,167,34,67,17,285
2133,85,33,84,16,218
2134,66,33,84,16,199
2136,66,32,101,17,216
2137,66,16,101,17,200
2138,65,34,67,17,183
2139,66,17,67,17,167
2140,66,34,66,18,184
2141,68,16,66,18,168
2142,152,15,83,17,267
2144,100,33,83,17,233
2145,66,16,68,16,166
2146,66,33,83,17,199
2147,117,32,51,16,216
2148,101,32,51,16,200
2150,68,32,51,16,167
2151,66,16,51,16,149
2153,66,17,67,18,168
2155,67,16,67,16,166
2157,68,16,84,15,183
2158,67,34,65,19,185
2159,67,16,65,19,167
2160,51,16,65,19,151
2162,66,33,102,15,216
2165,84,33,66,18,201
2166,52,16,99,18,185
2169,67,16,83,16,182
2171,65,17,101,17,200
2172,167,33,100,16,316
2173,166,16,100,16,298
2174,99,34,67,17,217
2175,68,16,67,16,167
2178,67,33,100,16,216
2179,67,16,100,16,199
2180,67,34,133,15,249
2181,283,33,101,16,433
2182,167,33,66,17,283
2183,50,33,83,17,183
2185,100,18,66,18,202
2186,100,33,66,17,216
2187,316,33,99,17,465
2188,151,15,167,16,349
2189,83,33,84,16,216
2190,100,33,167,16,316
2191,868,16,66,17,967
2192,84,15,167,16,282
2195,102,16,67,16,201
2196,283,16,169,16,484
2198,67,33,67,16,183
2199,66,17,67,16,166
2201,83,33,99,17,232
2203,100,17,133,18,268
2205,65,17,133,18,233
2206,1583,17,67,17,1684
2207,69,14,100,18,201
2211,82,32,51,17,182
2212,68,32,51,17,168
2213,51,32,51,17,151
2214,169,32,51,15,267
2215,50,34,131,20,235
2216,66,34,97,20,217
2217,551,32,118,16,717
2218,51,17,97,20,185
2219,100,16,51,15,182
2221,67,16,51,15,149
2222,66,31,69,16,182
2223,101,15,50,17,183
2224,63,35,50,17,165
2225,300,16,66,17,399
2228,85,17,101,17,220
2229,65,17,101,17,200
2230,50,17,101,17,185
2233,168,16,66,17,267
2234,67,34,66,16,183
2236,68,32,84,16,200
2237,50,32,84,16,182
2238,51,15,84,16,166
2240,99,33,118,16,266
2241,65,17,68,17,167
2243,99,18,166,16,299
2245,67,18,166,16,267
2246,85,15,118,16,234
2247,51,32,118,16,217
2248,52,15,118,16,201
2249,168,16,83,18,285
2250,65,34,67,16,182
2251,98,17,67,18,200
2252,67,33,67,18,185
2253,65,17,67,18,167
2255,67,16,83,18,184
2256,100,34,83,16,233
2257,102,16,83,16,217
2259,99,18,98,17,232
2261,67,18,98,17,200
2265,67,16,68,16,167
2266,98,35,67,15,215
2268,66,35,67,15,183
2270,68,33,99,18,218
2273,67,18,98,19,202
2274,67,33,132,17,249
2275,51,33,132,17,233
2276,67,32,100,17,216
2277,67,16,100,17,200
2278,65,33,67,17,182
2279,102,16,83,16,217
2280,65,35,83,16,199
2281,100,16,51,16,183
2282,84,16,51,16,167
2283,66,16,51,16,149
2284,67,33,100,18,218
2285,532,16,117,16,681
2286,65,34,66,18,183
2287,67,16,66,18,167
2289,84,32,84,17,217
2290,68,32,84,17,201
2291,68,14,84,17,183
2292,66,33,51,17,167
2293,67,15,51,17,150
2294,100,33,67,17,217
2296,68,33,67,17,185
2298,101,34,83,15,233
2299,83,34,83,15,215
2300,66,34,83,15,198
2302,50,17,83,15,165
2303,67,15,66,19,167
2305,66,16,52,15,149
2306,83,15,67,18,183
2307,66,15,67,18,166
2308,66,34,51,16,167
2309,68,15,51,16,150
2311,82,34,117,16,249
2314,169,31,68,16,284
2315,51,33,84,16,184
2316,167,34,101,16,318
2317,166,17,101,16,300
2318,69,33,99,16,217
2319,52,33,99,16,200
2320,100,34,101,16,251
2321,299,17,100,18,434
2322,64,34,101,16,215
2323,83,34,67,16,200
2324,298,33,152,18,501
2325,50,34,67,16,167
2326,117,18,65,17,217
2327,51,33,133,16,233
2330,67,33,66,16,182
2331,150,33,185,18,386
2333,67,16,134,18,235
2335,83,33,185,18,319
2336,66,33,185,18,302
2337,66,17,185,18,286
2338,67,33,152,18,270
2340,51,15,152,18,236
2341,102,16,66,18,202
2342,67,34,66,18,185
2343,67,16,66,18,167
2344,52,16,66,18,152
2345,83,33,167,17,300
2347,65,17,167,17,266
2348,284,16,150,17,467
2349,67,18,81,16,182
2350,166,34,51,16,267
2353,65,18,117,16,216
2356,100,32,84,18,234
2357,101,15,84,18,218
2358,66,32,84,18,200
2360,85,16,150,17,268
2362,51,16,150,17,234
2364,69,33,83,17,202
2365,65,18,83,17,183
2366,67,33,67,16,183
2367,51,33,67,16,167
2368,99,34,65,19,217
2369,101,17,65,19,202
2371,67,17,65,19,168
2372,151,14,67,17,249
2373,51,32,52,14,149
2374,99,33,67,17,216
2375,66,16,184,16,282
2377,117,32,67,17,233
2378,101,32,67,17,217
2379,84,32,67,17,200
2381,81,34,50,16,181
2382,101,33,85,15,234
2383,67,17,50,16,150
2384,82,17,85,15,199
2385,66,17,85,15,183
2388,166,35,65,17,283
2389,50,34,117,17,218
2390,67,33,133,17,250
2391,50,33,133,17,233
2393,66,16,51,17,150
2394,66,35,65,17,183
2395,66,17,65,17,165
2397,51,33,66,16,166
2398,51,17,66,16,150
2399,167,17,65,18,267
2400,99,33,51,17,200
2401,66,17,68,16,167
2402,99,35,65,18,217
2403,100,17,65,18,200
2404,701,33,67,17,818
2405,284,33,50,18,385
2407,52,33,66,17,168
2408,51,17,66,17,151
2409,66,16,51,16,149
2410,65,34,84,16,199
2412,299,33,67,17,416
2414,167,34,116,17,334
2415,83,33,67,16,199
2416,67,33,67,16,183
2417,67,16,67,16,166
2418,51,16,67,16,150
2419,51,33,50,18,152
2420,100,34,82,17,233
2422,67,34,82,17,200
2425,51,32,100,17,200
2426,99,34,67,17,217
2427,67,16,67,17,167
2428,82,17,67,17,183
2429,83,33,101,16,233
2430,100,34,67,16,217
2431,50,33,101,16,200
2432,67,34,67,16,184
2434,67,32,51,17,167
2435,51,32,51,17,151
2439,100,16,66,17,199
2440,101,33,67,17,218
2441,165,17,82,19,283
2442,66,33,67,17,183
2444,66,33,67,17,183
2445,65,17,67,17,166
2446,66,34,82,19,201
2450,51,16,68,16,151
2451,534,16,51,15,616
2452,50,17,115,19,201
2453,65,19,81,19,184
2454,84,15,134,17,250
2456,50,15,134,17,216
2457,85,34,65,17,201
2458,100,32,67,17,216
2460,69,32,67,17,185
2461,52,32,67,17,168
2462,66,33,51,17,167
2463,84,34,83,17,218
2465,51,34,83,17,185
2469,51,32,84,16,183
2470,83,17,101,16,217
2473,66,18,83,16,183
2474,68,32,51,16,167
2477,68,17,83,15,183
2478,67,32,51,15,165
2479,51,32,51,15,149
2480,51,16,51,15,133
2481,67,16,67,16,166
2482,66,32,67,16,181
2483,67,15,67,16,165
2484,51,15,67,16,149
2485,83,32,67,18,200
2486,67,32,67,18,184
2487,66,16,67,18,167
2488,51,16,67,18,152
2489,85,32,83,17,217
2491,83,33,67,16,199
2492,67,33,67,16,183
2493,151,34,67,15,267
2495,66,18,66,16,166
2496,68,32,84,17,201
2497,65,17,84,17,183
2502,66,35,66,16,183
2503,68,17,66,16,167
2505,51,31,102,15,199
2508,82,16,122,12,232
2510,102,32,55,12,201
2511,84,32,55,12,183
2512,99,35,67,16,217
2514,302,32,118,16,468
2515,83,32,68,16,199
2516,67,32,68,16,183
2518,55,12,68,16,151
2519,83,33,132,17,265
2520,67,33,132,17,249
2523,51,33,67,16,167
2524,99,34,115,18,266
2525,67,16,66,17,166
2526,66,34,115,18,233
2527,66,18,115,18,217
2531,100,17,166,17,300
2532,65,34,166,17,282
2534,67,34,132,17,250
2536,68,33,183,17,301
2537,84,32,67,17,200
2538,99,35,66,16,216
2540,533,34,66,17,650
2541,67,16,66,16,165
2542,67,32,84,17,200
2543,99,17,101,15,232
2544,101,35,133,16,285
2547,66,19,133,16,234
2549,67,17,66,18,168
2550,50,17,66,18,151
2552,66,32,118,16,232
2553,166,17,67,16,266
2554,66,35,83,16,200
2555,168,16,66,17,267
2556,67,32,150,17,266
2557,100,17,67,16,200
2559,299,17,66,18,400
2560,65,34,66,17,182
2561,67,16,66,17,166
2562,67,33,50,17,167
2563,51,33,50,17,151
2564,67,33,68,15,183
2566,66,34,66,17,183
2567,66,17,66,17,166
2572,66,34,66,18,184
2573,168,17,100,16,301
2574,66,33,168,16,283
2575,117,35,100,16,268
2577,83,35,100,16,234
2578,66,35,100,16,217
2579,84,32,68,16,200
2581,51,32,68,16,167
2583,86,31,115,16,248
2584,69,31,115,16,231
2586,101,33,65,18,217
2587,52,33,82,16,183
2588,97,33,83,16,229
2590,66,33,83,16,198
2591,67,16,83,16,182
2592,66,32,101,16,215
2593,100,16,67,16,199
2594,65,34,67,16,182
2595,66,16,67,16,165
2596,66,33,67,18,184
2597,67,16,67,18,168
2600,100,35,65,17,217
2602,85,17,65,17,184
2603,68,17,65,17,167
2605,168,17,82,16,283
2606,67,33,185,31,316
2607,66,16,185,31,298
2608,65,35,115,16,231
2609,66,18,115,16,215
2611,67,17,82,16,182
2612,68,32,85,31,216
2614,65,34,51,31,181
2615,67,16,51,31,165
2617,67,16,107,18,208
2618,85,31,108,17,241
2620,51,31,108,17,207
2621,91,32,68,16,207
2624,57,35,65,18,175
2625,99,17,84,16,216
2626,67,33,84,16,200
2627,67,17,84,16,184
2629,100,16,67,16,199
2630,65,34,67,16,182
2631,166,17,67,16,266
2633,117,33,67,16,233
2634,52,16,133,16,217
2635,99,17,67,16,199
2636,67,33,67,16,183
2637,98,19,66,16,199
2638,66,35,66,16,183
2639,65,19,66,16,166
2642,166,35,66,17,284
2644,166,34,83,16,299
2645,66,17,167,17,267
2646,50,17,167,17,251
2648,65,35,66,17,183
2649,66,18,66,17,167
2650,84,17,83,16,200
2652,52,17,83,16,168
2653,52,32,116,17,217
2654,66,34,82,17,199
2655,66,17,82,17,182
2656,165,33,85,16,299
2657,183,34,99,17,333
2658,51,16,99,17,183
2660,66,33,100,18,217
2661,517,33,65,18,633
2662,66,33,85,16,200
2663,82,34,99,17,232
2664,100,33,66,17,216
2666,67,33,66,17,183
2667,67,16,66,17,166
2669,50,34,82,18,184
2670,51,16,82,18,167
2673,65,19,65,16,165
2674,68,32,117,16,233
2675,66,18,117,16,217
2676,101,33,51,16,201
2677,51,33,67,17,168
2680,66,34,101,16,217
2681,167,18,66,16,267
2682,84,16,68,16,184
2683,68,16,68,16,168
2685,51,33,51,17,152
2686,66,35,66,16,183
2687,166,16,67,18,267
2688,68,33,65,18,184
2691,100,16,67,18,201
2692,98,35,66,16,215
2693,550,33,101,16,700
2694,65,35,66,16,182
2696,67,32,85,16,200
2697,549,34,67,16,666
2698,67,34,51,16,168
2699,150,33,67,16,266
2700,66,34,66,16,182
2701,102,16,149,17,284
2702,68,33,149,17,267
2703,67,16,149,17,249
2704,100,33,83,17,233
2705,51,33,67,16,167
2706,66,33,83,17,199
2709,85,33,82,19,219
2710,100,33,68,16,217
2712,100,33,101,14,248
2713,67,17,68,16,168
2714,66,33,101,14,214
2715,166,18,83,16,283
2717,151,33,101,16,301
2718,99,35,83,16,233
2719,551,33,66,16,666
2720,301,32,68,16,417
2722,99,32,101,16,248
2724,100,34,67,16,217
2725,101,16,67,16,200
2727,69,16,67,16,168
2728,66,35,166,16,283
2730,69,32,66,17,184
2735,66,16,68,16,166
2737,67,16,68,16,167
2738,83,17,66,16,182
2739,84,33,84,17,218
2740,101,33,68,15,217
2742,68,33,68,15,184
2743,99,19,99,16,233
2744,66,35,99,16,216
2745,66,19,99,16,200
2747,68,17,66,16,167
2748,101,33,82,16,232
2750,66,33,82,16,197
2752,66,33,65,19,183
2753,84,33,100,17,234
2754,99,32,68,17,216
2755,284,34,66,16,400
2757,66,16,68,17,167
2758,101,32,100,17,250
2759,101,16,100,17,234
2760,100,33,67,17,217
2761,68,16,100,17,201
2763,66,16,67,17,166
2764,149,17,66,16,248
2766,100,34,66,16,216
2767,83,34,66,16,199
2771,182,34,134,16,366
2774,66,33,118,16,233
2775,166,17,167,17,367
2776,167,34,67,16,284
2777,100,16,134,16,266
2778,66,34,134,16,250
2779,68,16,134,16,234
2780,100,34,67,16,217
2781,66,17,167,17,267
2782,101,34,67,16,218
2783,83,34,67,16,200
2784,67,34,67,16,184
2785,101,17,132,17,267
2786,101,34,82,16,233
2787,66,17,132,17,232
2788,101,32,66,17,216
2789,51,34,82,16,183
2793,100,16,68,16,200
2794,66,32,68,16,182
2795,66,16,68,16,166
2797,84,33,67,16,200
2798,67,33,67,16,183
2799,51,33,67,16,167
2800,68,34,66,17,185
2802,67,33,66,16,182
2803,66,19,66,16,167
2804,67,33,84,16,200
2805,84,33,84,16,217
2806,99,33,51,16,199
2809,66,17,51,16,150
2810,66,34,99,17,216
2811,100,16,150,15,281
2812,299,34,67,18,418
2814,51,16,150,15,232
2815,65,16,51,18,150
2816,65,34,84,15,198
2817,65,17,84,15,181
2818,66,35,98,18,217
2821,67,18,65,18,168
2822,84,15,52,16,167
2823,82,34,101,18,235
2825,49,34,101,18,202
2827,67,16,67,18,168
2828,52,16,67,18,153
2831,167,16,116,18,317
2832,67,34,83,16,200
2833,102,16,66,17,201
2834,283,17,133,17,450
2836,51,16,66,17,150
2837,66,16,116,18,216
2838,66,33,101,16,216
2839,165,18,149,17,349
2841,299,17,183,16,515
2842,50,17,67,16,150
2843,83,34,149,17,283
2844,83,18,149,17,267
2845,167,16,67,17,267
2846,67,33,133,17,250
2847,67,17,133,17,234
2848,50,17,133,17,217
2849,84,33,67,17,201
2850,66,33,67,17,183
2851,100,16,99,18,233
2852,66,33,99,18,216
2853,66,16,99,18,199
2855,100,17,65,21,203
2856,101,31,55,15,202
2857,67,17,65,21,170
2859,152,32,134,16,334
2860,167,32,68,16,283
2862,165,35,133,16,349
2863,86,32,134,16,268
2865,52,32,134,16,234
2866,168,34,66,16,284
2867,181,32,84,16,313
2869,66,19,133,16,234
2870,100,34,66,16,216
2871,67,17,100,16,200
2873,52,34,66,16,168
2874,67,32,84,16,199
2876,166,33,84,16,299
2877,100,17,66,17,200
2878,66,33,66,17,182
2879,66,17,66,17,166
2880,549,19,82,17,667
2882,66,33,84,16,199
2883,66,17,84,16,183
2886,50,18,100,16,184
2887,534,17,99,17,667
2888,68,32,51,17,168
2890,65,35,66,16,182
2892,67,33,99,17,216
2896,66,33,50,17,166
2900,50,16,51,16,133
2901,167,17,116,17,317
2903,99,17,68,16,200
2904,51,16,101,16,184
2906,100,34,82,17,233
2907,66,17,116,17,216
2909,85,31,68,16,200
2910,68,31,68,16,183
2911,51,31,68,16,166
2912,100,33,99,17,249
2913,50,35,66,16,167
2914,82,17,99,17,215
2915,66,17,99,17,199
2917,166,17,68,16,267
2918,66,33,83,16,198
2920,84,15,66,18,183
2922,100,32,101,17,250
2923,100,16,101,17,234
2924,67,32,101,17,217
2925,99,18,116,16,249
2927,301,15,117,18,451
2928,68,33,83,16,200
2929,52,33,83,16,184
2930,52,17,83,16,168
2931,100,17,66,18,201
2932,549,16,83,18,666
2933,66,17,66,18,167
2934,66,33,66,18,183
2935,299,18,82,18,417
2936,100,33,84,17,234
2938,84,15,84,17,200
2941,99,18,133,16,266
2942,51,15,117,18,201
2943,65,18,133,16,232
2944,84,17,100,16,217
2946,168,32,51,16,267
2947,51,33,67,16,167
2948,100,33,67,16,216
2949,66,18,82,18,184
2952,67,32,51,16,166
2955,166,16,83,18,283
2957,99,19,115,18,251
2958,51,16,67,16,150
2959,66,19,115,18,218
2960,99,33,68,17,217
2961,83,33,68,17,201
2962,67,33,68,17,185
2963,51,33,68,17,169
2964,65,33,52,17,167
2965,550,33,66,17,666
2966,66,35,116,16,233
2968,85,17,66,16,184
2969,51,34,66,16,167
2972,65,35,132,17,249
2974,298,33,151,16,498
2975,50,32,67,16,165
2976,51,16,67,16,150
2977,50,33,135,16,234
2978,99,33,68,16,216
2980,100,34,84,15,233
2981,66,17,68,16,167
2982,167,33,151,16,367
2983,83,34,65,18,200
2984,67,34,65,18,184
2985,85,32,101,16,234
2987,101,15,151,16,283
2989,101,17,66,16,200
2990,83,17,66,16,182
2991,67,17,66,16,166
2994,101,34,133,16,284
2995,66,17,66,17,166
2996,66,34,133,16,249
2997,100,16,67,17,200
2998,99,33,118,16,266
3000,66,33,118,16,233
3001,117,34,232,18,401
3003,83,34,232,18,367
3006,100,34,68,16,218
3007,65,16,67,17,165
3009,67,16,68,16,167
3010,50,16,68,16,150
3011,50,33,67,18,168
3012,67,35,98,18,218
3014,68,32,66,18,184
3015,51,32,66,18,167
3016,67,34,216,16,333
3019,150,33,99,17,299
3020,66,37,64,17,184
3022,69,31,67,16,183
3023,67,16,67,16,166
3024,101,34,98,18,251
3026,530,33,68,17,648
3027,66,17,98,18,199
3028,99,33,51,17,200
3029,66,16,66,18,166
3031,66,16,51,17,150
3032,65,33,68,17,183
3033,167,17,83,16,283
3035,67,17,83,17,184
3036,168,33,67,16,284
3037,51,33,117,16,217
3038,85,17,83,16,201
3040,50,17,83,16,166
3041,67,17,66,17,167
3043,50,33,67,16,166
3044,99,34,118,14,265
3045,100,17,118,14,249
3047,66,17,118,14,215
3048,166,33,68,17,284
3050,66,35,99,16,216
3051,166,17,150,17,350
3052,67,32,67,16,182
3053,102,14,68,17,201
3054,67,33,68,17,185
3056,150,16,83,17,266
3058,67,34,66,17,184
3061,51,33,83,17,184
3062,51,16,83,17,167
3063,101,17,65,18,201
3064,66,34,65,18,183
3065,66,17,65,18,166
3066,67,33,150,17,267
3068,300,33,68,15,416
3071,84,34,132,17,267
3072,101,31,51,17,200
3073,85,31,51,17,184
3074,100,35,66,17,218
3075,100,17,66,17,200
3076,65,35,66,17,183
3078,165,35,215,16,431
3079,65,17,199,17,298
3082,99,35,215,16,365
3083,67,16,68,15,166
3084,300,32,68,16,416
3085,67,17,215,16,315
3086,51,17,215,16,299
3088,68,32,50,17,167
3089,99,16,133,19,267
3090,65,33,133,19,250
3093,67,17,99,19,202
3094,50,17,99,19,185
3095,85,32,67,16,200
3097,52,32,67,16,167
3098,67,32,68,16,183
3099,101,16,117,15,249
3100,64,35,117,15,231
3101,68,16,117,15,216
3103,51,33,84,15,183
3104,68,33,51,15,167
3105,65,17,51,15,148
3106,66,34,99,17,216
3107,66,18,99,17,200
3108,67,32,67,17,183
3109,83,34,84,16,217
3110,66,34,84,16,200
3111,50,34,84,16,184
3112,66,33,51,16,166
3113,66,16,51,16,149
3114,51,16,51,16,134
3116,84,16,102,15,217
3117,67,16,102,15,200
3118,51,16,102,15,184
3119,68,16,101,15,200
3121,65,20,114,18,217
3122,488,16,84,18,606
3123,66,18,81,18,183
3125,101,17,83,33,234
3126,98,34,82,21,235
3127,66,17,83,33,199
3128,65,34,82,21,202
3129,66,18,82,21,187
3130,169,34,268,16,487
3132,67,49,88,17,221
3133,67,33,88,17,205
3134,103,34,268,16,421
3136,70,34,268,16,388
3138,55,33,100,17,205
3139,83,34,117,17,251
3140,67,34,117,17,235
3142,50,17,117,17,201
3146,66,33,84,18,201
3147,67,16,84,18,185
3149,67,17,67,16,167
3150,101,34,64,18,217
3151,100,18,64,18,200
3152,68,34,64,18,184
3153,66,18,64,18,166
3155,52,32,84,16,184
3157,66,16,100,17,199
3158,64,35,65,17,181
3159,66,17,65,17,165
3161,101,15,167,17,300
3164,65,34,51,16,166
3165,99,18,66,16,199
3167,66,18,66,16,166
3168,69,32,66,17,184
3169,52,32,66,17,167
3170,483,17,83,17,600
3172,66,32,68,16,182
3175,167,17,50,17,251
3176,100,32,84,17,233
3177,68,16,66,16,166
3178,168,33,49,17,267
3180,66,34,50,17,167
3182,100,33,49,17,199
3183,100,17,49,17,183
3184,68,33,49,17,167
3185,100,17,68,15,200
3187,100,17,118,16,251
3188,66,33,118,16,233
3189,66,17,118,16,217
3192,99,34,83,17,233
3193,52,31,68,17,168
3196,65,34,66,17,182
3199,51,33,100,16,200
3201,65,17,83,17,182
3202,66,34,100,16,216
3203,66,17,100,16,199
3204,116,17,84,17,234
3206,83,17,84,17,201
3207,66,17,84,17,184
3208,66,34,50,17,167
3211,101,17,67,16,201
3212,84,17,67,16,184
3214,99,35,81,19,234
3216,85,17,81,19,202
3217,67,17,81,19,184
3218,50,17,81,19,167
3219,67,17,100,15,199
3220,116,19,83,16,234
3221,67,17,116,16,216
3222,81,19,83,16,199
3224,166,33,184,17,400
3225,50,33,116,18,217
3226,66,33,101,15,215
3227,52,33,101,15,201
3228,66,33,68,15,182
3229,66,16,68,15,165
3231,119,32,66,18,235
3232,101,32,66,18,217
3233,84,32,66,18,200
3234,284,17,117,16,434
3235,117,32,100,18,267
3236,67,34,83,17,201
3238,66,32,100,18,216
3239,67,16,100,18,201
3241,67,17,83,17,184
3242,67,33,50,17,167
3243,67,17,50,17,151
3244,100,35,117,16,268
3245,100,17,117,16,250
3247,84,32,85,16,217
3249,50,32,85,16,183
3250,51,16,85,16,168
3252,65,34,66,18,183
3256,100,35,82,17,234
3258,101,17,114,19,251
3259,66,17,82,17,182
3262,101,33,67,17,218
3263,67,16,100,17,200
3265,100,14,52,17,183
3267,67,14,52,17,150
3269,101,17,99,18,235
3270,67,34,99,18,218
3271,83,33,84,33,233
3272,153,33,82,17,285
3273,50,33,84,33,200
3274,283,17,133,19,452
3275,167,16,83,17,283
3277,68,33,82,17,200
3278,51,33,82,17,183
3279,68,49,83,17,217
3280,52,49,83,17,201
3281,115,33,100,18,266
3282,51,16,83,17,167
3283,82,33,100,18,233
3284,67,33,100,18,218
3286,66,34,133,19,252
3287,66,17,133,19,235
3288,50,17,133,19,219
3289,67,16,51,16,150
3290,67,33,67,19,186
3291,66,17,67,19,169
3293,67,16,52,32,167
3294,501,32,117,17,667
3295,51,33,99,19,202
3296,86,48,133,17,284
3297,68,48,133,17,266
3298,299,35,132,17,483
3299,67,16,133,17,233
3300,51,16,133,17,217
3301,80,34,100,16,230
3304,51,15,100,16,182
3306,67,34,66,19,186
3307,66,16,66,19,167
3309,66,16,52,16,150
3310,67,33,84,16,200
3311,65,17,84,16,182
3312,166,35,67,16,284
3314,52,16,132,17,217
3315,168,16,117,17,318
3316,167,35,82,17,301
3317,81,35,67,16,199
3318,65,35,67,16,183
3319,50,35,67,16,168
3321,67,16,117,17,217
3322,67,35,82,17,201
3324,67,32,168,16,283
3326,67,34,80,20,201
3327,100,17,67,16,200
3328,66,33,67,16,182
3330,67,33,68,16,184
3331,97,20,150,16,283
3332,80,20,150,16,266
3333,84,34,116,16,250
3334,67,34,116,16,233
3335,50,34,116,16,216
3336,100,33,51,16,200
3342,66,34,66,18,184
3343,67,16,66,18,167
3344,151,16,133,17,317
3345,50,34,99,18,201
3346,68,32,67,18,185
3348,66,34,133,17,250
3349,167,19,65,17,268
3350,50,16,133,17,216
3352,67,35,65,17,184
3353,67,17,65,17,166
3354,51,17,65,17,150
3355,751,33,67,16,867
3356,69,31,102,16,218
3357,82,34,68,16,200
3358,65,34,68,16,183
3360,98,35,148,17,298
3362,102,31,134,18,285
3364,151,15,67,18,251
3366,51,15,134,18,218
3367,100,15,67,18,200
3368,65,33,67,18,183
3369,67,15,67,18,167
3370,52,15,67,18,152
3371,82,34,67,16,199
3372,66,34,67,16,183
3373,532,17,66,17,632
3374,67,34,66,18,185
3376,101,33,66,18,218
3377,51,33,51,16,151
3378,67,33,66,18,184
3379,65,17,66,18,166
3381,83,32,67,17,199
3383,533,17,116,18,684
3384,100,33,50,17,200
3385,99,16,50,17,182
3386,66,33,50,17,166
3387,99,17,133,16,265
3388,101,33,100,16,250
3393,101,16,300,16,433
3396,51,16,300,16,383
3397,99,17,82,18,216
3398,300,34,82,18,434
3399,65,17,82,18,182
3400,66,34,66,17,183
3401,66,17,66,17,166
3402,50,17,66,17,150
3403,99,18,134,16,267
3404,69,31,134,16,250
3406,66,34,66,17,183
3407,167,17,82,18,284
3408,65,33,167,15,280
3409,152,33,67,15,267
3410,67,33,116,18,234
3411,66,17,116,18,217
3413,67,17,82,18,184
3415,300,18,117,16,451
3417,66,18,66,16,166
3419,66,18,66,17,167
3420,100,33,51,16,200
3421,51,33,84,16,184
3422,66,33,51,16,166
3423,51,33,51,16,151
3424,100,33,68,33,234
3425,102,16,68,33,219
3427,68,16,68,33,185
3428,51,16,68,33,168
3430,67,34,83,16,200
3431,66,18,83,16,183
3432,68,33,66,17,184
3434,67,32,83,16,198
3435,51,32,83,16,182
3436,65,34,100,16,215
3438,66,33,67,16,182
3439,67,16,67,16,166
3441,100,16,100,16,232
3442,65,35,100,16,216
3443,67,16,100,16,199
3444,83,17,67,16,183
3445,100,17,83,18,218
3447,65,17,83,18,183
3448,66,34,67,16,183
3450,67,33,50,17,167
3451,51,33,50,17,151
3452,67,34,82,19,202
3453,67,18,82,19,186
3454,67,33,68,17,185
3455,51,33,68,17,169
3456,50,17,68,17,152
3458,101,17,115,17,250
3459,284,34,66,15,399
3460,68,17,115,17,217
3461,100,16,67,17,200
3462,53,48,67,17,185
3463,68,16,67,17,168
3464,65,33,84,17,199
3465,482,33,67,17,599
3466,67,34,67,17,185
3467,83,33,51,17,184
3468,151,17,66,15,249
3469,50,33,51,17,151
3470,84,17,66,17,184
3473,84,32,84,17,217
3474,100,34,99,17,250
3475,100,17,99,17,233
3477,66,17,99,17,199
3478,116,17,82,17,232
3479,166,17,67,16,266
3480,84,17,82,17,200
3484,67,34,67,16,184
3485,66,17,67,16,166
3489,50,34,82,18,184
3490,83,17,67,17,184
3491,51,33,67,17,168
3492,50,17,67,17,151
3493,68,15,52,16,151
3494,65,35,66,18,184
3495,66,18,66,18,168
3496,67,33,67,17,184
3498,168,33,68,15,284
3500,66,34,66,17,183
3502,51,16,66,17,150
3505,99,16,117,17,249
3506,66,33,117,17,233
3508,66,35,82,17,200
3509,534,16,51,15,616
3510,68,32,67,19,186
3511,66,17,67,19,169
3513,51,34,116,18,219
3515,67,17,133,16,233
3520,67,34,166,16,283
3524,66,33,68,16,183
3527,69,16,67,16,168
3529,101,17,83,16,217
3530,68,33,83,16,200
3532,100,32,67,18,217
3533,166,16,100,17,299
3534,149,16,100,17,282
3537,67,16,51,15,149
3538,83,16,100,17,216
3541,117,32,116,19,284
3542,168,32,68,17,285
3543,850,32,85,15,982
3545,82,35,81,19,217
3546,167,35,116,16,334
3547,66,18,81,19,184
3550,51,16,68,17,152
3551,67,16,101,16,200
3553,65,19,116,16,216
3554,68,32,84,16,200
3555,101,16,99,17,233
3556,167,33,67,17,284
3557,69,16,99,17,201
3558,2136,17,100,17,2270
3559,99,16,67,16,198
3560,100,33,67,17,217
3561,66,16,67,16,165
3563,66,17,67,17,167
3564,67,34,83,17,201
3565,150,33,68,32,283
3566,67,33,116,19,235
3567,51,33,116,19,219
3568,67,34,101,32,234
3569,67,17,101,32,217
3570,83,17,68,32,200
3571,51,33,68,32,184
3572,50,17,68,32,167
3573,66,18,66,17,167
3574,101,32,116,17,266
3575,66,19,65,20,170
3576,68,32,116,17,233
3577,52,32,116,17,217
3578,66,33,83,17,199
3579,167,17,67,16,267
3582,53,46,101,16,216
3583,66,16,101,16,199
3584,66,34,67,16,183
3586,66,35,64,18,183
3587,50,35,64,18,167
3588,69,32,132,18,251
3589,67,17,132,18,234
3590,67,32,85,15,199
3594,101,31,51,16,199
3595,284,32,68,16,400
3596,100,35,66,16,217
3597,67,15,51,16,149
3598,65,35,66,16,182
3599,68,17,66,16,167
3600,66,32,168,16,282
3601,66,16,168,16,266
3602,101,33,66,18,218
3603,99,17,66,18,200
3607,82,32,68,16,198
3608,99,35,234,16,384
3609,51,32,68,16,167
3610,66,35,234,16,351
3612,67,33,66,16,182
3613,67,17,66,16,166
3615,100,16,68,16,200
3619,50,33,67,17,167
3620,100,32,84,16,232
3621,84,32,84,16,216
3622,84,16,84,16,200
3624,51,16,84,16,167
3625,65,18,65,18,166
3627,51,33,67,17,168
3629,1039,32,66,17,1154
3630,65,35,82,18,200
3632,67,34,66,16,183
3633,284,32,67,20,403
3635,51,32,66,17,166
3636,66,34,65,17,182
3637,65,18,65,17,165
3638,66,32,66,18,182
3640,99,33,67,16,215
3641,50,33,100,16,199
3643,66,16,67,16,165
3644,66,35,99,20,220
3645,84,32,67,20,203
3647,51,32,67,20,170
3649,100,16,105,15,236
3650,67,32,105,15,219
3651,67,16,105,15,203
3652,67,20,85,15,187
3655,53,17,66,18,154
3657,152,17,149,17,335
3658,83,34,83,18,218
3660,49,34,83,18,184
3661,67,35,149,17,268
3663,101,34,83,17,235
3664,51,32,101,16,200
3665,67,34,83,17,201
3666,99,16,100,18,233
3667,66,32,100,18,216
3668,66,16,100,18,200
3669,550,16,267,18,851
3670,85,33,100,16,234
3671,51,16,83,17,167
3672,166,18,66,17,267
3676,67,17,183,16,283
3678,66,18,66,17,167
3679,68,33,67,16,184
3680,66,17,67,16,166
3681,66,33,100,17,216
3682,285,32,52,17,386
3683,66,34,66,17,183
3684,67,17,66,17,167
3686,167,16,67,17,267
3688,285,31,50,17,383
3689,66,34,199,18,317
3690,50,34,199,18,301
3691,98,35,166,16,315
3692,166,16,267,18,467
3693,66,35,166,16,283
3696,51,32,52,17,152
3701,100,34,83,18,235
3702,52,31,50,17,150
3703,67,34,83,18,202
3704,66,16,83,18,183
3705,65,33,99,19,216
3707,50,17,99,19,185
3708,83,34,65,18,200
3713,166,35,83,16,300
3714,166,19,83,16,284
3715,50,15,117,18,200
3716,117,35,83,16,251
3717,169,32,68,15,284
3718,98,19,83,16,216
3722,83,32,68,15,198
3723,68,32,68,15,183
3724,52,32,68,15,167
3726,68,16,82,17,183
3727,66,34,65,16,181
3729,68,32,84,16,200
3731,66,33,67,16,182
3733,100,32,137,29,298
3735,100,33,52,16,201
3737,67,33,52,16,168
3739,65,33,151,17,266
3740,82,35,116,17,250
3742,69,16,116,17,218
3743,52,16,116,17,201
3744,51,36,64,16,167
3745,71,29,51,17,168
3746,99,17,83,15,214
3749,179,19,65,16,279
3752,100,15,68,16,199
3756,100,17,83,18,218
3758,166,18,66,17,267
3759,68,33,68,17,186
3760,67,17,68,17,169
3761,65,33,67,17,182
3762,150,34,83,16,283
3763,66,35,66,17,184
3764,67,18,66,17,168
3765,68,32,67,16,183
3766,52,32,67,16,167
3767,52,15,67,16,150
3768,50,34,83,16,183
3769,66,33,117,19,235
3773,517,17,82,17,633
3774,152,30,52,16,250
3778,86,30,52,16,184
3780,53,30,52,16,151
3782,101,16,132,18,267
3783,63,35,132,18,248
3784,170,16,100,17,303
3786,51,34,165,17,267
3788,50,33,65,18,166
3789,67,32,100,17,216
3790,166,16,101,16,299
3792,82,35,83,17,217
3793,166,34,82,17,299
3794,67,17,83,17,184
3795,84,16,101,16,217
3796,68,16,101,16,201
3798,66,17,266,18,367
3799,66,34,82,17,199
3800,183,33,100,18,334
3801,68,33,115,17,233
3802,51,33,115,17,216
3803,67,33,82,17,199
3804,116,33,100,18,267
3805,66,33,200,16,315
3806,82,33,100,18,233
3807,66,33,100,18,217
3808,67,16,100,18,201
3809,66,33,118,16,233
3810,66,17,118,16,217
3812,66,20,81,16,183
3813,100,35,64,18,217
3814,54,30,67,16,167
3815,67,35,64,18,184
3816,68,17,64,18,167
3817,65,32,66,18,181
3821,98,35,82,18,233
3822,82,35,82,18,217
3823,66,35,82,18,201
3825,69,31,69,17,186
3827,117,18,65,16,216
3828,67,16,51,16,150
3830,85,33,99,18,235
3832,67,16,99,18,200
3833,51,16,99,18,184
3834,51,32,85,16,184
3836,64,17,101,16,198
3837,83,16,118,15,232
3838,67,16,118,15,216
3839,51,16,118,15,200
3841,101,33,66,19,219
3843,67,33,66,19,185
3844,65,17,66,19,167
3846,166,16,68,15,265
3847,166,34,66,16,282
3849,66,34,83,18,201
3853,67,34,66,16,183
3854,148,33,52,16,249
3855,67,34,99,18,218
3856,66,18,99,18,201
3857,68,32,67,18,185
3859,99,34,83,18,234
3860,50,33,52,16,151
3861,65,34,83,18,200
3865,52,16,100,16,184
3867,101,33,66,16,216
3868,65,18,148,19,250
3869,100,34,81,19,234
3870,150,33,52,17,252
3871,67,34,81,19,201
3873,67,32,68,17,184
3875,66,33,52,17,168
3876,50,33,52,17,152
3877,65,35,82,17,199
3879,85,17,65,16,183
3880,52,34,65,16,167
3881,100,34,66,17,217
3882,101,17,66,17,201
3884,65,17,66,17,165
3885,65,33,66,18,182
3887,100,33,167,17,317
3888,67,16,68,17,168
3889,66,33,167,17,283
3890,50,33,167,17,267
3891,66,35,132,17,250
3892,67,17,132,17,233
3894,51,33,66,17,167
3895,52,16,66,17,151
3897,66,33,67,16,182
3898,82,33,50,17,182
3899,66,33,50,17,166
3900,66,16,50,17,149
3901,66,34,100,16,216
3902,67,17,100,16,200
3903,167,33,100,16,316
3904,66,17,116,18,217
3905,50,17,116,18,201
3907,100,33,100,16,249
3911,165,35,65,18,283
3912,84,34,83,15,216
3913,67,34,83,15,199
3914,68,17,83,15,183
3915,51,17,83,15,166
3916,100,19,65,18,202
3918,65,19,65,18,167
3919,67,31,52,16,166
3921,66,34,67,16,183
3924,67,16,100,16,199
3925,52,16,100,16,184
3927,118,16,68,16,218
3928,65,17,50,16,148
3929,84,16,68,16,184
3930,317,32,66,16,431
3931,83,16,68,15,182
3932,51,32,68,15,166
3933,50,16,68,15,149
3934,84,32,66,17,199
3935,68,32,66,17,183
3936,52,32,66,17,167
3937,52,16,66,17,151
3939,66,32,68,17,183
3940,67,15,68,17,167
3941,116,18,83,15,232
3942,51,34,117,15,217
3943,833,32,100,18,983
3945,833,33,134,18,1018
3946,99,19,81,17,216
3947,66,35,81,17,199
3949,67,31,67,17,182
3950,66,15,67,17,165
3951,66,34,66,17,183
3952,50,34,66,17,167
3953,65,33,100,17,215
3955,67,33,67,17,184
3956,101,18,66,17,202
3957,66,35,66,17,184
3959,299,35,67,16,417
3961,67,34,101,16,218
3962,67,17,101,16,201
3963,83,15,69,16,183
3964,66,15,69,16,166
3965,101,34,83,16,234
3966,99,19,83,16,217
3967,67,34,83,16,200
3969,69,33,66,17,185
3972,102,16,67,16,201
3974,67,16,67,16,166
3976,51,33,66,19,169
3977,52,16,66,19,153
3978,83,32,51,16,182
3979,67,32,51,16,166
3980,66,16,51,16,149
3981,66,35,100,16,217
3982,69,16,100,16,201
3984,99,19,65,17,200
3986,64,19,65,17,165
3987,67,33,82,16,198
3990,552,32,68,16,668
3991,65,33,134,18,250
3994,66,16,52,16,150
3995,167,34,50,17,268
3997,67,34,101,16,218
3999,101,34,50,17,202
4000,50,33,168,15,266
4001,67,34,50,17,168
4002,67,16,50,17,150
4003,51,16,50,17,134
4004,84,33,67,15,199
4005,84,17,67,15,183
4006,50,33,67,15,165
4008,51,34,65,16,166
4009,67,33,83,16,199
4010,167,16,267,15,465
4011,99,35,82,16,232
4013,100,32,267,15,414
4015,67,32,267,15,381
4020,82,33,83,17,215
4021,66,33,83,17,199
4022,99,19,65,17,200
4024,149,35,98,20,302
4026,67,16,101,15,199
4027,67,33,68,15,183
4029,65,35,98,20,218
4031,50,18,98,20,186
4032,52,33,65,20,170
4033,101,32,69,16,218
4035,66,32,69,16,183
4036,51,32,69,16,168
4038,70,16,82,16,184
4040,68,16,116,17,217
4041,85,17,83,17,202
4042,149,33,101,16,299
4043,49,17,83,17,166
4045,100,33,101,16,250
4046,299,17,67,16,399
4047,67,33,101,16,217
4048,51,33,101,16,201
4049,51,17,101,16,185
4050,167,17,65,17,266
4051,65,35,115,17,232
4052,283,35,98,18,434
4053,101,33,65,17,216
4054,100,17,65,17,199
4055,69,33,65,17,184
4056,66,17,65,17,165
4058,53,32,135,16,236
4060,65,17,67,16,165
4061,65,34,68,16,183
4062,50,34,68,16,168
4063,84,16,67,16,183
4064,84,35,98,18,235
4065,51,16,67,16,150
4066,85,32,84,16,217
4068,51,32,84,16,183
4071,64,34,67,17,182
4072,66,16,67,17,166
4076,83,33,67,18,201
4077,167,33,68,16,284
4079,66,33,52,15,166
4081,66,34,66,18,184
4083,67,33,68,16,184
4085,100,35,133,16,284
4086,66,16,67,16,165
4087,101,32,85,16,234
4089,100,33,68,16,217
4093,99,34,66,18,217
4095,67,34,66,18,185
4096,69,16,66,18,169
4097,68,33,67,17,185
4099,67,33,83,16,199
4100,64,18,83,16,181
4101,66,34,133,16,249
4103,67,33,250,16,366
4104,301,18,100,17,436
4105,99,34,66,19,218
4106,149,32,52,16,249
4107,99,34,84,16,233
4108,65,17,66,19,167
4109,167,33,99,17,316
4110,168,16,99,17,300
4111,68,32,52,16,168
4112,51,32,52,16,151
4113,66,35,83,16,200
4115,84,16,99,17,216
4116,68,16,99,17,200
4117,102,32,68,17,219
4118,65,18,100,17,200
4120,150,33,84,19,286
4122,100,18,66,16,200
4123,65,35,66,16,182
4124,66,18,66,16,166
4126,51,33,84,19,187
4127,68,33,70,13,184
4128,68,16,70,13,167
4129,66,34,65,19,184
4130,167,14,102,16,299
4131,67,36,114,17,234
4132,86,29,66,19,200
4133,70,29,66,19,184
4134,54,29,66,19,168
4135,65,33,102,16,216
4136,67,14,102,16,199
4137,62,33,101,19,215
4138,66,16,101,19,202
4141,52,17,116,18,203
4143,69,32,69,17,187
4145,65,35,67,15,182
4147,101,33,64,17,215
4148,67,18,80,17,182
4149,102,32,68,17,219
4150,50,33,64,17,164
4151,67,32,68,17,184
4154,80,36,97,19,232
4155,64,36,97,19,216
4157,165,36,84,16,301
4159,101,32,68,14,215
4160,68,16,100,14,198
4162,99,17,84,16,216
4163,65,36,84,16,201
4164,67,17,84,16,184
4165,51,17,84,16,168
4166,316,35,65,16,432
4167,68,32,102,15,217
4168,101,16,81,17,215
4169,64,36,81,17,198
4170,299,18,83,17,417
4171,68,33,65,17,183
4174,65,17,84,15,181
4175,66,32,167,16,281
4177,65,33,119,15,232
4179,65,34,85,15,199
4180,84,35,65,16,200
4181,67,35,65,16,183
4183,69,33,83,17,202
4184,65,18,83,17,183
4185,100,33,117,17,267
4187,98,35,82,17,232
4190,66,17,82,17,182
4191,51,17,82,17,167
4192,168,16,50,17,251
4194,67,16,66,18,167
4195,66,33,67,16,182
4196,66,17,67,16,166
4197,50,17,67,16,150
4199,84,16,66,17,183
4200,68,16,66,17,167
4203,50,17,50,17,134
4204,301,14,85,15,415
4205,66,34,84,17,201
4206,67,17,84,17,185
4208,116,35,84,14,249
4209,66,34,66,17,183
4210,83,35,84,14,216
4211,84,17,84,14,199
4213,52,17,84,14,167
4214,68,14,53,14,149
4215,52,14,53,14,133
4217,65,33,85,15,198
4218,67,14,85,15,181
4219,53,14,85,15,167
4221,66,35,132,18,251
4222,66,16,132,18,232
4223,85,15,68,16,184
4225,52,15,68,16,151
4226,99,17,66,17,199
4227,83,17,66,17,183
4228,149,33,100,17,299
4229,51,17,66,17,151
4230,51,32,67,16,166
4231,65,34,85,16,200
4232,100,16,100,17,233
4236,65,17,67,17,166
4237,85,16,65,18,184
4239,300,35,131,17,483
4240,52,32,51,16,151
4243,65,34,67,16,182
4244,100,16,135,14,265
4245,51,16,67,16,150
4246,67,16,135,14,232
4247,101,34,67,14,216
4249,67,34,67,14,182
4250,66,18,67,14,165
4251,68,32,83,19,202
4252,83,35,131,17,266
4253,66,35,131,17,249
4254,99,18,51,16,184
4255,67,32,51,16,166
4256,150,32,51,16,249
4257,166,33,69,16,284
4259,83,16,65,18,182
4260,85,32,51,16,184
4262,100,16,69,16,201
4265,83,16,83,18,200
4267,51,16,83,18,168
4268,300,17,67,17,401
4269,69,32,50,17,168
4270,67,16,50,17,150
4271,51,16,50,17,134
4272,168,16,66,18,268
4274,66,17,98,18,199
4276,51,33,100,18,202
4278,68,16,66,18,168
4280,66,15,102,17,200
4281,65,35,67,17,184
4283,84,15,119,16,234
4284,68,15,119,16,218
4286,169,16,66,15,266
4287,67,34,133,15,249
4288,66,17,133,15,231
4289,303,30,85,15,433
4290,50,32,51,17,150
4293,67,33,65,18,183
4295,51,17,65,18,151
4296,97,17,70,14,198
4297,283,15,85,16,399
4298,65,17,70,14,166
4300,84,35,64,17,200
4301,50,17,65,18,150
4303,167,33,85,16,301
4308,101,15,85,16,217
4309,67,33,85,16,201
4311,151,16,83,18,268
4312,49,34,51,16,150
4315,67,34,83,18,202
4316,50,34,83,18,185
4317,51,16,83,18,168
4318,50,33,50,18,151
4320,83,34,82,16,215
4321,83,18,82,16,199
4323,50,18,82,16,166
4324,99,17,67,16,199
4326,100,16,152,15,283
4327,66,32,152,15,265
4328,99,18,66,17,200
4329,66,35,66,17,184
4331,67,34,83,15,199
4332,67,18,83,15,183
4336,67,16,68,16,167
4337,83,15,51,16,165
4338,67,15,51,16,149
4339,51,15,51,16,133
4340,67,17,83,16,183
4342,66,16,167,17,266
4343,51,16,167,17,251
4345,65,34,100,17,216
4347,667,33,67,17,784
4348,50,34,66,17,167
4349,301,33,50,16,400
4350,300,16,50,16,382
4351,67,33,118,15,233
4354,50,34,84,15,183
4357,66,35,66,17,184
4358,167,16,50,16,249
4360,68,15,67,16,166
4361,52,15,67,16,150
4362,167,16,100,17,300
4363,66,33,50,16,165
4364,66,16,50,16,148
4365,100,33,100,17,250
4366,51,33,67,18,169
4367,66,33,100,17,216
4368,66,16,100,17,199
4370,102,15,118,15,250
4371,85,15,118,15,233
4374,99,17,100,20,236
4376,65,17,100,20,202
4379,67,33,101,15,216
4380,83,34,134,16,267
4381,51,15,101,15,182
4382,50,34,134,16,234
4383,301,33,117,17,468
4385,54,13,67,17,151
4386,100,18,50,17,185
4387,150,17,133,17,317
4389,67,34,166,17,284
4390,67,17,166,17,267
4391,67,33,133,17,250
4392,68,17,133,17,235
4394,50,33,100,17,200
4397,83,17,117,17,234
4398,66,17,117,17,217
4400,67,16,84,17,184
4401,66,34,100,16,216
4404,66,17,133,16,232
4405,101,33,66,16,216
4406,84,33,66,16,199
4407,100,32,85,15,232
4408,100,16,85,15,216
4411,165,33,168,17,383
4412,66,16,66,17,165
4413,66,33,50,16,165
4414,116,33,168,17,334
4415,168,34,81,18,301
4417,66,33,168,17,284
4419,50,16,168,17,251
4420,117,33,99,17,266
4421,300,33,51,17,401
4422,85,33,99,17,234
4424,67,17,99,17,200
4425,100,33,99,17,249
4427,282,17,83,16,398
4428,65,18,99,17,199
4429,99,33,217,16,365
4430,66,16,134,16,232
4431,99,33,68,16,216
4432,68,16,217,16,317
4434,66,16,68,16,166
4435,66,33,51,17,167
4437,84,17,116,16,233
4438,67,17,116,16,216
4439,84,17,83,16,200
4442,301,15,67,17,400
4443,65,35,83,17,200
4444,66,18,83,17,184
4445,67,32,101,16,216
4446,67,16,101,16,200
4448,67,16,68,16,167
4449,83,17,84,15,199
4450,67,17,84,15,183
4451,167,34,167,17,385
4452,67,17,66,17,167
4453,100,34,67,17,218
4454,66,16,101,17,200
4455,65,34,67,17,183
4457,66,34,167,17,284
4458,50,34,167,17,268
4460,82,35,81,18,216
4461,67,35,81,18,201
4465,67,33,68,16,184
4467,65,34,99,17,215
4468,100,17,114,19,250
4469,67,34,114,19,234
4470,68,17,114,19,218
4471,101,32,100,16,249
4472,68,17,81,19,185
4473,67,32,100,16,215
4474,82,34,82,18,216
4475,65,34,82,18,199
4477,166,34,82,19,301
4480,151,33,68,14,266
4481,66,34,67,17,184
4482,67,18,67,17,169
4483,100,33,68,14,215
4484,167,19,65,17,268
4485,68,33,68,14,183
4486,52,33,68,14,167
4487,84,13,103,17,217
4488,99,19,65,17,200
4489,50,13,103,17,183
4490,66,19,65,17,167
4491,68,32,66,16,182
4492,51,32,66,16,165
4493,103,33,66,18,220
4495,98,33,51,16,198
4497,66,33,51,16,166
4498,51,33,51,16,151
4499,66,33,67,17,183
4500,66,16,67,17,166
4501,66,34,166,18,284
4502,84,33,184,16,317
4503,84,16,184,16,300
4504,166,18,99,17,300
4505,51,16,184,16,267
4506,66,17,67,16,166
4507,67,32,118,16,233
4508,66,16,118,16,216
4509,50,16,118,16,200
4510,100,16,100,18,234
4512,101,17,65,18,201
4513,67,35,65,18,185
4517,100,35,117,16,268
4518,66,16,51,17,150
4520,67,17,117,16,217
4521,51,17,117,16,201
4522,67,17,84,16,184
4523,51,17,84,16,168
4524,99,17,85,16,217
4525,66,33,85,16,200
4526,66,17,85,16,184
4527,100,32,68,17,217
4528,68,16,100,17,201
4530,51,32,68,17,168
4533,51,16,65,18,150
4536,66,15,51,16,148
4538,67,17,82,16,182
4540,50,32,100,17,199
4542,99,16,84,17,216
4543,98,34,67,17,216
4545,66,34,67,17,184
4546,83,34,66,18,201
4547,67,34,66,18,185
4548,50,34,66,18,168
4549,51,17,66,18,152
4550,65,17,99,18,199
4551,67,33,66,18,184
4552,67,16,66,18,167
4553,84,16,81,18,199
4554,68,16,81,18,183
4555,51,16,81,18,166
4556,50,32,67,16,165
4557,66,37,131,17,251
4559,151,14,52,17,234
4560,64,18,101,17,200
4561,67,35,66,17,185
4562,84,31,52,17,184
4565,101,34,149,16,300
4566,50,35,66,16,167
4567,83,17,149,16,265
4568,66,17,149,16,248
4569,52,17,149,16,234
4571,66,33,100,17,216
4572,65,17,100,17,199
4573,65,34,66,17,182
4574,67,16,66,17,166
4575,101,32,68,17,218
4576,101,16,68,17,202
4577,68,32,68,17,185
4578,99,18,99,16,232
4581,67,33,66,16,182
4582,66,18,66,16,166
4583,68,33,116,16,233
4584,51,33,116,16,216
4585,50,16,116,16,198
4587,100,32,86,15,233
4588,65,18,99,19,201
4589,166,34,67,16,283
4590,66,16,86,15,183
4591,99,34,66,18,217
4593,65,34,66,18,183
4594,83,34,67,16,200
4595,67,34,67,16,184
4596,101,15,100,17,233
4597,53,15,67,16,151
4599,300,35,99,16,450
4601,50,17,65,17,149
4603,100,35,67,16,218
4605,65,35,67,16,183
4606,66,18,67,16,167
4607,84,16,66,16,182
4608,84,34,83,15,216
4609,52,16,66,16,150
4610,1373,17,181,17,1588
4611,67,32,99,17,215
4612,66,16,99,17,198
4613,66,35,99,16,216
4614,65,19,99,16,199
4615,67,31,152,15,265
4616,67,15,152,15,249
4621,285,16,67,17,385
4623,51,17,66,17,151
4624,167,18,50,16,251
4625,66,33,102,16,217
4628,66,17,68,16,167
4629,101,34,81,18,234
4630,65,18,50,16,149
4631,68,34,81,18,201
4632,67,18,81,18,184
4633,50,18,81,18,167
4634,52,32,67,17,168
4635,50,16,67,17,150
4636,150,32,67,17,266
4638,83,33,66,17,199
4641,51,16,66,17,150
4642,167,18,66,17,268
4644,66,16,68,16,166
4645,550,17,67,16,650
4646,66,16,101,17,200
4647,67,35,66,17,185
4648,66,18,66,17,167
4649,68,33,66,16,183
4650,301,17,84,16,418
4652,67,17,85,14,183
4653,66,33,133,18,250
4654,67,16,133,18,234
4656,66,17,66,17,166
4657,66,33,102,16,217
4658,68,14,102,16,200
4659,52,14,102,16,184
4660,152,31,53,16,252
4662,1387,33,66,18,1504
4663,85,17,84,16,202
4664,67,17,84,16,184
4666,68,15,53,16,152
4667,101,34,83,16,234
4668,67,16,100,17,200
4669,66,34,83,16,199
4670,68,16,83,16,183
4671,53,16,83,16,168
4673,100,33,83,29,245
4674,65,17,67,16,165
4675,66,33,83,29,211
4676,51,33,83,29,196
4677,178,27,183,16,404
4678,67,17,78,10,172
4679,100,45,60,17,222
4680,66,17,105,17,205
4682,155,34,181,17,387
4683,78,27,183,16,304
4684,62,27,183,16,288
4686,106,17,181,17,321
4687,110,16,84,16,226
4688,1017,32,101,16,1166
4689,67,32,84,16,199
4690,100,16,51,16,183
4691,66,33,51,16,166
4692,66,16,51,16,149
4694,165,17,68,17,267
4695,67,33,66,16,182
4696,100,16,101,17,234
4697,100,33,68,17,218
4698,68,16,101,17,202
4701,66,35,216,17,334
4702,65,19,216,17,317
4703,101,33,83,16,233
4704,168,16,101,16,301
4705,151,16,101,16,284
4708,67,16,118,17,218
4710,66,16,101,16,199
4711,83,16,68,16,183
4714,100,17,65,18,200
4716,67,17,65,18,167
4718,51,33,166,16,266
4719,51,17,166,16,250
4721,65,34,68,15,182
4723,149,17,133,17,316
4724,102,16,67,16,201
4725,169,32,66,17,284
4726,68,16,67,16,167
4727,68,32,133,17,250
4728,99,19,82,16,216
4729,102,32,66,17,217
4731,67,32,66,17,182
4732,52,32,66,17,167
4733,67,33,200,18,318
4735,299,33,67,16,415
4737,99,35,99,18,251
4741,83,18,66,18,185
4742,51,33,66,18,168
4743,168,33,67,16,284
4745,300,34,82,17,433
4750,120,33,67,15,235
4753,83,17,67,15,182
4754,50,33,67,15,165
4759,67,34,82,17,200
4760,300,17,83,18,418
4761,101,34,66,17,218
4762,52,32,67,16,167
4763,66,34,66,17,183
4766,66,17,133,16,232
4768,67,17,67,16,167
4770,67,16,83,18,184
4771,66,34,134,17,251
4772,50,34,134,17,235
4773,67,33,83,18,201
4774,66,17,83,18,184
4775,101,32,102,16,251
4776,84,32,102,16,234
4777,67,32,102,16,217
4778,100,18,67,16,201
4779,66,35,67,16,184
4780,67,18,67,16,168
4783,168,33,67,16,284
4784,51,34,66,17,168
4785,67,33,100,15,215
4787,67,33,67,15,182
4788,283,33,51,17,384
4789,99,34,100,17,250
4791,66,34,100,17,217
4792,85,33,67,17,202
4793,517,15,51,17,600
4794,150,31,67,17,265
4795,67,32,52,14,165
4796,67,16,52,14,149
4797,65,35,83,15,198
4799,67,31,67,17,182
4804,81,34,67,16,198
4805,67,34,67,16,184
4806,50,34,67,16,167
4808,167,16,84,15,282
4810,84,35,98,18,235
4811,118,16,84,15,233
4814,68,16,84,15,183
4815,151,15,51,17,234
4816,68,15,52,15,150
4818,82,33,51,17,183
4820,150,33,116,18,317
4821,101,34,67,16,218
4823,67,34,67,16,184
4825,51,17,67,16,151
4826,52,33,116,18,219
4827,101,33,99,16,249
4828,67,17,82,18,184
4829,67,33,99,16,215
4831,50,17,99,16,182
4833,165,34,83,17,299
4834,84,32,101,16,233
4835,49,18,65,16,148
4836,99,17,68,16,200
4837,66,33,68,16,183
4838,66,17,68,16,167
4840,300,18,65,19,402
4841,67,34,100,16,217
4842,51,34,100,16,201
4845,67,33,116,18,234
4847,100,33,67,15,215
4849,100,33,83,16,232
4850,51,33,67,15,166
4853,66,34,65,19,184
4855,99,33,83,17,232
4856,150,33,67,16,266
4857,66,33,83,17,199
4859,65,35,65,17,182
4861,52,16,65,17,150
4862,51,33,67,16,167
4864,64,17,100,19,200
4867,67,33,51,15,166
4868,52,33,51,15,151
4870,83,34,85,16,218
4871,84,15,85,16,200
4872,68,15,85,16,184
4873,51,15,85,16,167
4874,84,32,135,16,267
4877,66,35,100,16,217
4881,100,35,83,17,235
4882,65,16,51,16,148
4883,65,35,83,17,200
4884,67,17,83,17,184
4885,84,16,68,16,184
4887,51,16,68,16,151
4888,100,17,98,19,234
4889,65,35,98,19,217
4890,67,17,98,19,201
4892,51,33,65,19,168
4893,102,31,55,13,201
4894,84,31,55,13,183
4895,67,31,55,13,166
4896,101,16,66,17,200
4898,68,16,66,17,167
4899,86,13,50,16,165
4900,70,13,50,16,149
4902,99,16,83,19,217
4903,66,33,83,19,201
4904,63,16,83,19,181
4906,151,31,68,17,267
4907,68,32,101,16,217
4909,67,35,149,16,267
4911,67,31,68,17,183
4912,52,31,68,17,168
4913,66,35,99,16,216
4914,85,33,66,16,200
4915,66,33,66,16,181
4917,68,33,66,18,185
4918,51,33,66,18,168
4919,99,33,101,17,250
4920,67,16,51,17,151
4921,66,33,101,17,217
4922,65,17,101,17,200
4923,66,35,66,17,184
4924,49,35,66,17,167
4925,51,17,66,17,151
4927,67,34,83,17,201
4930,67,16,67,16,166
4931,51,16,67,16,150
4932,101,17,70,14,202
4933,66,34,70,14,184
4934,66,17,70,14,167
4935,67,33,117,15,232
4937,104,31,64,18,217
4939,70,31,64,18,183
4940,54,31,64,18,167
4942,101,15,67,19,202
4943,95,34,117,18,264
4945,150,16,67,15,248
4946,48,34,117,18,217
4949,86,16,67,15,184
4951,52,16,67,15,150
4952,300,17,67,17,401
4954,65,18,65,18,166
4955,82,18,149,17,266
4956,101,15,117,17,250
4957,100,35,99,17,251
4958,101,17,99,17,234
4960,68,17,99,17,201
4962,66,18,82,15,181
4964,99,17,67,17,200
4965,65,34,67,17,183
4966,66,17,67,17,167
4967,149,16,83,17,265
4968,67,15,52,16,150
4969,51,15,52,16,134
4970,84,33,83,17,217
4972,83,35,65,16,199
4973,103,32,150,16,301
4974,100,18,150,16,284
4976,65,18,150,16,249
4977,100,32,101,17,250
4978,66,17,67,16,166
4980,67,16,101,17,201
4981,166,34,66,17,283
4982,84,34,98,17,233
4985,69,32,66,17,184
4987,66,34,66,17,183
4988,50,34,66,17,167
4989,98,34,84,16,232
4992,66,17,84,16,183
4996,50,35,132,16,233
4997,68,32,67,18,185
4998,67,16,67,18,168
4999,102,32,49,17,200
5000,101,16,49,17,183
5001,299,33,84,17,433
5002,101,15,68,16,200
5004,99,17,51,16,183
5006,65,17,51,16,149
5007,101,32,67,16,216
5010,101,18,115,16,250
5011,51,16,67,16,150
5013,67,32,99,18,216
5014,51,32,99,18,200
5018,66,16,101,16,199
5019,66,33,68,16,183
5020,101,17,65,19,202
5021,84,17,65,19,185
5022,67,17,65,19,168
5024,51,33,67,16,167
5025,68,32,51,17,168
5026,66,16,51,17,150
5027,84,16,116,16,232
5029,51,16,116,16,199
5032,100,16,83,17,216
5034,100,16,51,17,184
5035,67,32,51,17,167
5036,66,16,51,17,150
5038,65,18,116,16,215
5039,67,33,83,16,199
5040,84,33,66,17,200
5041,51,17,83,16,167
5042,51,33,66,17,167
5043,66,33,66,16,181
5044,66,17,66,16,165
5045,148,18,67,16,249
5048,50,33,84,17,184
5049,66,34,67,16,183
5050,99,18,67,16,200
5053,68,33,116,18,235
5054,85,34,82,18,219
5055,101,32,68,16,217
5056,51,34,82,18,185
5060,300,18,64,19,401
5061,100,33,65,17,215
5062,66,18,82,16,182
5064,51,33,65,17,166
5065,51,17,65,17,150
5066,51,33,67,16,167
5067,66,32,51,17,166
5068,99,18,67,15,199
5070,83,33,98,19,233
5073,166,36,82,16,300
5076,100,15,51,17,183
5077,49,17,68,15,149
5078,67,15,51,17,150
5079,83,17,82,16,198
5082,51,32,66,19,168
5083,51,17,66,19,153
5084,65,18,51,16,150
5085,66,32,101,16,215
5086,168,16,134,15,333
5087,66,35,116,16,233
5088,69,16,116,16,217
5095,66,33,68,15,182
5096,98,18,66,18,200
5098,66,18,66,18,168
5099,67,34,66,17,184
5102,52,32,51,16,151
5103,84,16,83,20,203
5104,68,16,83,20,187
5105,83,16,133,16,248
5108,66,17,67,16,166
5109,83,20,63,16,182
5110,66,20,63,16,165
5112,84,32,68,15,199
5114,99,17,67,17,200
5115,63,33,67,17,180
5116,65,17,67,17,166
5119,52,16,67,16,151
5120,101,18,82,17,218
5121,67,35,82,17,201
5122,65,18,82,17,182
5123,149,17,134,16,316
5124,52,32,50,17,151
5125,51,16,50,17,134
5126,84,33,134,16,267
5127,66,33,134,16,249
5128,66,17,134,16,233
5129,50,17,134,16,217
5131,82,19,66,16,183
5132,66,19,66,16,167
5137,115,17,67,17,216
5138,51,32,84,17,184
5139,99,34,132,17,282
5140,83,34,132,17,266
5141,66,34,132,17,249
5144,67,17,82,17,183
5145,67,34,116,17,234
5146,51,34,116,17,218
5148,67,16,84,17,184
5149,66,33,134,18,251
5150,65,17,134,18,234
5151,699,35,98,16,848
5152,49,34,67,16,166
5153,101,33,51,15,200
5154,68,17,182,18,285
5157,100,33,101,16,250
5158,66,17,116,18,217
5159,66,33,101,16,216
5160,68,15,101,16,200
5161,51,15,101,16,183
5162,50,34,67,16,167
5163,67,33,50,17,167
5164,116,33,66,17,232
5165,101,33,66,17,217
5167,83,17,66,17,183
5168,83,33,83,18,217
5169,50,17,66,17,150
5172,67,16,68,15,166
5176,66,18,115,18,217
5177,68,32,83,18,201
5178,51,32,83,18,184
5179,99,34,135,17,285
5181,115,18,66,17,216
5182,67,17,135,17,236
5183,167,35,98,16,316
5184,85,32,69,17,203
5185,68,32,69,17,186
5187,66,34,52,14,166
5188,68,16,52,14,150
5190,68,18,98,16,200
5191,167,34,103,15,319
5192,165,18,103,15,301
5193,99,34,67,18,218
5196,148,35,50,17,250
5197,67,34,103,15,219
5198,66,18,103,15,202
5199,101,35,50,17,203
5201,67,35,50,17,169
5202,337,16,67,16,436
5203,68,35,65,18,186
5205,81,17,117,17,232
5206,284,34,84,15,417
5207,100,33,68,16,217
5208,185,32,68,16,301
5209,83,15,68,16,182
5210,68,15,68,16,167
5211,51,15,68,16,150
5212,118,32,68,16,234
5215,68,32,68,16,184
5218,67,16,67,16,166
5219,84,16,84,15,199
5220,50,34,84,15,183
5221,52,16,84,15,167
5222,99,17,51,16,183
5223,67,33,51,16,167
5224,65,17,51,16,149
5225,84,15,68,15,182
5227,66,34,68,15,183
5230,165,16,67,17,265
5232,65,19,114,17,215
5233,68,32,234,16,350
5237,64,35,65,18,182
5239,67,32,51,17,167
5240,100,16,67,19,202
5241,100,35,83,17,235
5242,66,16,67,19,168
5244,85,32,99,18,234
5245,51,17,83,17,168
5246,102,16,64,18,200
5247,166,36,98,19,319
5248,68,16,64,18,166
5249,67,33,67,16,183
5251,51,17,67,16,151
5252,98,18,98,19,233
5253,64,36,98,19,217
5254,66,18,98,19,201
5256,64,17,100,16,197
5257,286,17,66,17,386
5258,51,34,66,16,167
5259,67,31,51,17,166
5260,67,15,51,17,150
5261,100,33,84,17,234
5262,168,16,84,17,285
5263,66,33,84,17,200
5266,99,16,84,17,216
5267,99,35,66,17,217
5268,184,33,83,17,317
5269,84,17,66,17,184
5271,117,17,98,18,250
5272,117,33,83,17,250
5273,166,33,119,15,333
5274,83,33,83,17,216
5275,66,33,83,17,199
5279,98,35,65,19,217
5280,67,14,119,15,215
5281,65,35,65,19,184
5285,100,34,84,16,234
5286,284,33,100,17,434
5287,65,34,84,16,199
5288,67,15,84,16,182
5289,100,34,116,17,267
5291,68,34,116,17,235
5292,65,18,116,17,216
5293,168,33,100,17,318
5295,66,34,50,17,167
5297,66,34,82,17,199
5298,50,34,82,17,183
5299,301,33,250,17,601
5302,50,33,101,16,200
5303,66,33,68,16,183
5304,100,17,233,16,366
5305,66,34,233,16,349
5306,66,17,233,16,332
5307,67,34,83,16,200
5308,300,17,101,16,434
5314,100,16,67,16,199
5315,99,33,85,16,233
5316,66,16,67,16,165
5317,66,33,85,16,200
5318,66,16,85,16,183
5319,66,34,51,16,167
5321,67,33,101,16,217
5322,66,17,101,16,200
5323,67,34,67,16,184
5324,50,34,67,16,167
5325,150,17,67,16,250
5327,65,36,67,16,184
5329,67,33,67,16,183
5331,52,17,67,16,152
5332,85,33,83,17,218
5333,167,33,82,18,300
5334,67,17,83,17,184
5338,65,19,66,17,167
5339,67,33,82,18,200
5340,51,33,82,18,184
5342,102,16,83,17,218
5343,66,33,83,17,199
5345,66,34,101,16,217
5346,65,18,101,16,200
5347,67,34,67,16,184
5349,68,32,51,15,166
5350,67,17,51,15,150
5351,66,35,82,16,199
5353,67,31,67,16,181
5354,117,33,67,16,233
5355,51,15,67,16,149
5356,82,33,67,16,198
5357,65,33,67,16,181
5358,66,16,67,16,165
5359,101,33,84,16,234
5360,117,33,51,16,217
5361,100,33,51,16,200
5362,99,17,51,16,183
5363,67,33,51,16,167
5365,66,35,98,17,216
5367,51,17,98,17,183
5368,68,16,66,17,167
5369,100,33,84,16,233
5370,49,33,117,16,215
5371,65,33,84,16,198
5373,83,17,83,18,201
5374,115,34,67,18,234
5375,150,18,66,17,251
5376,116,35,66,17,234
5378,83,35,66,17,201
5380,67,18,66,17,168
5381,301,34,67,16,418
5383,168,32,101,16,317
5384,68,16,99,17,200
5385,50,16,99,17,182
5387,51,17,99,16,183
5388,50,33,99,18,200
5390,66,16,101,16,199
5391,65,34,134,16,249
5394,50,33,101,16,200
5395,67,34,67,16,184
5397,167,34,182,16,399
5399,50,17,67,17,151
5401,67,33,149,17,266
5403,101,33,82,17,233
5406,51,33,82,17,183
5407,67,32,67,18,184
5408,66,16,67,18,167
5409,65,34,135,17,251
5412,66,17,66,17,166
5413,67,34,68,17,186
5414,99,16,53,14,182
5415,83,16,53,14,166
5416,67,16,53,14,150
5417,102,31,83,19,235
5418,65,19,65,17,166
5421,53,14,83,19,169
5422,50,34,68,16,168
5423,65,33,51,17,166
5424,65,16,51,17,149
5427,167,32,84,17,300
5428,67,17,82,16,182
5429,51,17,82,16,166
5432,50,33,83,20,186
5433,66,32,84,17,199
5434,100,16,101,16,233
5435,65,34,101,16,216
5437,103,30,83,17,233
5438,67,20,64,16,167
5439,84,17,83,17,201
5440,53,30,83,17,183
5441,50,17,83,17,167
5443,64,33,134,15,246
5444,100,17,150,16,283
5446,84,34,67,15,200
5447,66,34,67,15,182
5448,151,31,134,17,333
5449,67,32,84,16,199
5450,67,16,84,16,183
5451,66,35,65,18,184
5452,85,31,134,17,267
5453,98,34,100,17,249
5454,51,31,134,17,233
5455,100,35,65,17,217
5456,83,35,65,17,200
5457,765,34,66,18,883
5458,85,33,66,18,202
5459,52,17,65,17,151
5460,168,15,101,16,300
5461,68,32,152,16,268
5462,66,16,152,16,250
5463,99,33,101,16,249
5464,100,15,101,16,232
5465,165,35,67,16,283
5466,68,15,101,16,200
5468,66,18,167,16,267
5469,99,35,67,16,217
5470,66,15,51,17,149
5471,66,35,67,16,184
5472,85,33,149,19,286
5475,51,17,149,19,236
5476,83,33,101,14,231
5477,2483,16,67,17,2583
5478,67,17,101,14,199
5479,100,33,66,17,216
5480,67,17,99,17,200
5482,66,17,66,17,166
5483,66,35,82,16,199
5484,66,19,82,16,183
5485,99,34,67,16,216
5487,100,33,66,17,216
5489,65,33,66,17,181
5490,68,16,66,17,167
5491,67,34,99,18,218
5492,151,32,100,18,301
5493,99,35,116,16,266
5494,50,32,67,18,167
5495,167,34,132,17,350
5497,99,34,66,18,217
5498,101,16,66,18,201
5500,68,16,66,18,168
5502,66,18,132,17,233
5503,68,32,67,17,184
5504,66,16,67,17,166
5505,66,35,65,17,183
5506,50,35,65,17,167
5507,67,32,83,19,201
5508,51,32,83,19,185
5511,65,33,102,16,216
5512,151,33,116,16,316
5513,66,36,66,16,184
5514,66,19,66,16,167
5518,52,33,116,16,217
5519,99,32,67,16,214
5520,96,16,67,16,195
5522,66,16,67,16,165
5523,98,34,68,17,217
5524,66,16,67,17,166
5526,67,16,68,17,168
5531,68,33,84,14,199
5533,52,16,84,14,166
5534,51,32,66,19,168
5535,65,33,101,17,216
5536,65,16,101,17,199
5537,84,14,68,17,183
5538,82,35,83,18,218
5539,168,34,115,21,338
5540,68,16,83,18,185
5541,52,16,83,18,169
5543,68,34,99,18,219
5544,66,17,99,18,200
5547,101,32,50,21,204
5548,51,33,149,17,250
5551,65,34,83,17,199
5553,166,34,66,16,282
5555,50,21,63,17,151
5556,53,30,133,16,232
5557,67,33,67,16,183
5558,84,34,66,16,200
5559,63,34,66,16,179
5560,50,34,66,16,166
5561,100,33,99,17,249
5562,51,33,165,18,267
5563,100,34,98,18,250
5564,50,33,99,17,199
5567,67,33,83,16,199
5568,67,17,83,16,183
5570,150,33,267,16,466
5572,300,17,99,16,432
5573,65,34,133,18,250
5575,51,16,133,18,218
5576,50,33,267,16,366
5579,151,17,82,16,266
5580,167,17,99,16,299
5581,100,35,82,16,233
5582,67,16,51,17,151
5583,85,17,82,16,200
5584,67,17,82,16,182
5592,68,15,67,16,166
5594,66,16,85,17,184
5595,101,32,102,16,251
5596,65,17,67,15,164
5598,67,16,102,16,201
5599,67,35,67,16,185
5600,84,34,66,16,200
5601,67,34,66,16,183
5602,101,17,67,16,201
5603,169,33,67,15,284
5604,300,16,67,16,399
5605,67,33,199,18,317
5609,283,16,67,17,383
5610,67,17,67,15,166
5611,50,17,67,15,149
5613,100,32,51,15,198
5614,67,17,83,15,182
5615,150,15,84,17,266
5616,52,32,51,15,150
5617,67,33,67,16,183
5618,66,16,67,16,165
5619,299,32,52,16,399
5620,101,16,67,17,201
5621,51,15,84,17,167
5622,99,18,66,18,201
5623,101,33,51,17,202
5625,68,33,51,17,169
5626,66,17,51,17,151
5627,50,17,51,17,135
5628,68,16,67,18,169
5629,66,35,50,14,165
5630,68,17,50,14,149
5631,51,17,50,14,132
5632,51,32,168,16,267
5633,85,14,52,16,167
5634,67,14,52,16,149
5635,50,14,52,16,132
5637,67,33,68,16,184
5638,82,33,167,18,300
5639,52,16,68,16,152
5640,100,19,65,16,200
5641,101,34,64,17,216
5642,65,19,65,16,165
5643,68,34,64,17,183
5644,166,17,84,15,282
5645,51,18,64,17,150
5646,53,31,67,18,169
5647,65,33,52,16,166
5648,99,17,84,15,215
5650,65,17,84,15,181
5651,67,34,50,15,166
5652,69,16,50,15,150
5653,100,33,53,16,202
5654,101,15,53,16,185
5655,301,32,68,15,416
5656,66,15,53,16,150
5659,86,16,83,15,200
5661,53,16,83,15,167
5663,66,32,86,15,199
5664,64,16,86,15,181
5666,98,19,65,18,200
5667,51,15,52,15,133
5668,168,17,65,18,268
5669,86,15,68,15,184
5671,535,32,102,15,684
5673,65,35,65,18,183
5674,66,17,65,18,166
5675,51,17,65,18,151
5677,100,35,115,18,268
5678,67,15,150,18,250
5679,65,35,115,18,233
5680,551,34,100,16,701
5682,83,32,50,18,183
5684,50,32,50,18,150
5686,67,16,66,19,168
5687,66,34,68,15,183
5689,50,18,68,15,151
5690,66,16,135,13,230
5691,66,36,64,18,184
5692,69,17,64,18,168
5693,68,32,67,13,180
5695,51,17,67,13,148
5697,64,35,83,16,198
5698,67,17,83,16,183
5700,101,17,184,18,320
5701,67,34,184,18,303
5702,100,16,101,16,233
5703,66,33,101,16,216
5706,50,35,66,16,167
5707,167,35,115,16,333
5708,51,32,84,18,185
5710,65,18,100,16,199
5711,99,35,115,16,265
5712,51,33,150,16,250
5715,68,32,83,16,199
5716,52,32,83,16,183
5717,67,32,67,16,182
5718,66,16,67,16,165
5721,816,17,66,16,915
5723,99,34,85,15,233
5724,51,32,52,17,152
5726,167,15,67,18,267
5727,66,35,65,17,183
5728,68,17,65,17,167
5730,52,33,69,13,167
5731,68,32,67,18,185
5733,65,37,98,16,216
5734,300,17,84,17,418
5736,82,35,81,17,215
5737,67,35,81,17,200
5739,114,16,83,17,230
5741,100,33,101,16,250
5742,66,16,83,17,182
5743,65,33,101,16,215
5744,66,17,101,16,200
5745,100,32,84,17,233
5747,100,34,67,17,218
5748,67,17,84,17,185
5749,67,34,67,17,185
5750,67,17,67,17,168
5751,66,33,66,18,183
5752,101,17,65,18,201
5753,67,34,65,18,184
5754,67,17,65,18,167
5755,67,32,67,17,183
5758,182,35,66,16,299
5759,65,34,66,18,183
5760,66,16,66,18,166
5761,84,18,82,19,203
5762,66,18,82,19,185
5763,100,35,66,16,217
5765,66,35,66,16,183
5766,67,17,66,16,166
5767,165,33,67,16,281
5769,51,19,97,19,186
5770,52,31,66,19,168
5771,99,33,67,16,215
5772,100,16,67,16,199
5773,97,33,69,15,214
5774,101,14,69,15,199
5775,66,33,69,15,183
5776,101,16,67,17,201
5777,167,35,98,17,317
5778,99,19,98,18,234
5779,102,32,66,18,218
5781,69,32,66,18,185
5782,66,17,66,18,167
5783,67,35,98,17,217
5784,86,31,101,16,234
5785,67,31,101,16,215
5786,101,17,66,16,200
5788,67,17,66,16,166
5789,66,32,68,15,181
5790,99,17,117,16,249
5791,67,34,117,16,234
5793,166,33,67,19,285
5794,50,34,166,19,269
5795,68,32,67,18,185
5796,518,32,101,17,668
5797,82,18,51,17,168
5798,66,18,51,17,152
5799,66,33,67,19,185
5803,100,31,52,17,200
5804,68,15,66,17,166
5805,67,31,52,17,167
5806,68,12,52,17,149
5807,98,34,67,16,215
5809,66,34,67,16,183
5813,150,17,51,17,235
5814,67,17,166,17,267
5815,101,32,51,17,201
5816,66,18,83,17,184
5817,68,32,51,17,168
5819,49,17,51,17,134
5820,85,33,133,17,268
5821,83,17,133,17,250
5825,99,32,200,20,351
5826,66,17,67,17,167
5827,66,32,200,20,318
5828,150,32,100,20,302
5832,84,32,100,20,236
5833,52,16,66,16,150
5834,117,33,53,14,217
5835,82,17,133,16,248
5836,82,33,53,14,182
5838,65,17,53,14,149
5840,103,14,83,18,218
5841,51,15,67,16,149
5842,101,16,68,18,203
5844,98,18,52,15,183
5847,67,34,84,16,201
5848,84,33,67,17,201
5849,68,33,67,17,185
5850,52,33,67,17,169
5852,102,16,67,17,202
5853,68,32,67,17,184
5854,166,15,102,16,299
5855,67,33,51,15,166
5856,51,33,51,15,150
5857,80,19,65,18,182
5859,67,32,102,16,217
5860,67,15,102,16,200
5862,51,33,85,16,185
5863,83,17,50,16,166
5864,66,17,50,16,149
5865,84,18,65,16,183
5866,101,16,98,19,234
5867,51,18,65,16,150
5868,67,16,98,19,200
5869,50,16,98,19,183
5870,50,33,65,19,167
5871,298,33,84,17,432
5872,65,17,51,17,150
5873,66,32,66,21,185
5874,65,16,66,21,168
5875,65,36,132,17,250
5876,68,17,132,17,234
5877,51,17,132,17,217
5880,68,14,67,17,166
5881,83,15,67,17,182
5882,299,16,117,16,448
5884,81,33,84,17,215
5885,84,16,84,17,201
5887,51,16,84,17,168
5888,66,16,51,17,150
5890,49,35,67,16,167
5892,84,34,84,14,216
5895,67,32,117,16,232
5896,67,16,117,16,216
5897,183,16,118,16,333
5898,65,15,85,16,181
5899,165,34,84,16,299
5900,68,14,67,19,168
5901,66,35,134,16,251
5902,66,18,134,16,234
5903,101,34,84,16,235
5904,65,16,118,16,215
5906,50,34,84,16,184
5908,50,32,101,17,200
5909,51,15,101,17,184
5910,748,34,67,16,865
5911,68,32,50,16,166
5915,65,33,201,17,316
5916,66,16,201,17,300
5917,50,16,201,17,284
5918,67,16,85,16,184
5919,67,32,69,16,184
5920,66,16,69,16,167
5921,66,34,51,17,168
5922,517,32,85,16,650
5923,167,33,133,17,350
5924,69,16,131,18,234
5925,69,33,98,18,218
5927,101,33,133,17,284
5928,82,33,133,17,265
5930,99,16,69,16,200
5931,98,35,66,17,216
5932,100,17,66,17,200
5934,66,17,66,17,166
5935,101,32,84,17,234
5937,69,32,84,17,202
5939,66,33,51,17,167
5941,165,35,66,15,281
5942,100,17,67,16,200
5943,66,35,67,16,184
5944,84,32,51,16,183
5945,100,35,66,15,216
5946,52,32,51,16,151
5947,168,35,82,16,301
5948,84,32,85,16,217
5949,67,32,85,16,200
5950,52,32,85,16,185
5951,152,16,66,16,250
5953,66,35,82,16,199
5954,65,20,82,16,183
5955,85,16,66,16,183
5956,300,18,83,16,417
5958,118,33,67,17,235
5960,82,33,67,17,199
5962,50,33,67,17,167
5963,67,34,82,18,201
5965,51,16,82,18,167
5966,51,33,67,16,167
5967,167,32,52,16,267
5970,84,33,66,18,201
5971,67,33,66,18,184
5972,83,32,52,16,183
5973,68,32,52,16,168
5974,167,18,66,16,267
5975,65,34,68,16,183
5977,150,18,115,16,299
5978,168,16,83,16,283
5979,168,33,101,16,318
5980,66,18,66,16,166
5981,68,34,115,16,233
5982,66,18,115,16,215
5983,100,33,101,16,250
5984,68,16,83,16,183
5988,65,18,67,16,166
5990,67,16,117,18,218
5991,50,16,117,18,201
5992,50,35,82,18,185
5995,117,18,99,16,250
5998,66,18,99,16,199
