序号,发送->接收,接收->转发,转发->接收,接收->处理,总计
1,95,34,68,17,214
2,72,17,68,17,174
3,99,17,52,15,183
5,66,17,52,15,150
6,67,35,67,15,184
7,66,19,67,15,167
9,52,32,167,17,268
11,120,31,102,15,268
12,82,19,98,17,216
13,84,31,102,15,232
14,69,31,102,15,217
15,68,15,102,15,200
16,65,34,68,15,182
17,117,35,82,20,254
18,65,33,69,15,182
19,65,17,69,15,166
22,102,33,66,16,217
23,134,20,79,17,250
24,69,33,66,16,184
25,52,33,66,16,167
26,82,20,79,17,198
27,87,31,65,17,200
30,66,32,69,14,181
33,82,36,67,13,198
34,65,36,67,13,181
35,85,32,67,15,199
37,53,32,67,15,167
39,69,17,65,15,166
40,67,32,66,16,181
43,64,18,66,18,166
44,65,33,68,15,181
45,52,33,68,15,168
46,66,33,68,15,182
47,51,33,68,15,167
49,69,17,118,15,219
51,52,33,85,15,185
52,101,33,99,18,251
53,65,18,67,15,165
54,118,15,65,18,216
56,100,31,52,14,197
58,132,32,104,16,284
60,99,32,104,16,251
61,80,32,104,16,232
62,65,32,104,16,217
63,68,14,104,16,202
64,100,34,52,16,202
65,81,34,52,16,183
67,65,17,52,16,150
68,86,18,63,18,185
69,66,18,63,18,165
70,70,32,65,17,184
71,69,16,65,17,167
72,52,16,65,17,150
73,65,16,85,17,183
75,132,17,84,15,248
76,82,17,66,17,182
77,67,17,66,17,167
79,67,17,84,15,183
81,83,34,69,14,200
82,66,34,69,14,183
83,83,33,83,16,215
84,66,33,83,16,198
88,69,31,67,18,185
89,65,17,67,18,167
90,83,16,53,16,168
92,80,18,117,17,232
93,66,18,117,17,218
94,67,34,83,17,201
96,53,16,83,17,169
97,117,35,65,17,234
98,99,35,65,17,216
100,100,33,65,18,216
101,85,33,65,18,201
102,215,18,67,15,315
103,52,33,65,18,168
104,68,32,101,16,217
105,66,16,101,16,199
106,82,16,68,16,182
108,65,34,83,18,200
109,67,16,83,18,184
111,66,18,67,15,166
112,68,32,100,17,217
113,99,18,130,19,266
114,134,32,101,18,285
115,67,18,130,19,234
116,67,33,83,14,197
117,51,33,83,14,181
118,86,14,101,18,219
120,65,35,66,18,184
122,67,30,54,15,166
124,51,14,54,15,134
125,67,17,117,16,217
126,66,33,84,16,199
128,54,15,84,16,169
129,100,17,100,17,234
130,67,33,100,17,217
131,65,17,100,17,199
132,67,33,67,17,184
134,83,17,67,17,184
135,84,33,66,16,199
136,67,33,66,16,182
138,118,15,50,16,199
140,67,32,50,16,165
142,100,32,100,17,249
143,99,16,100,17,232
144,82,16,100,17,215
146,101,33,133,16,283
148,83,17,133,16,249
149,67,17,133,16,233
151,83,36,98,18,235
152,101,32,66,18,217
153,66,19,98,18,201
154,68,32,66,18,184
157,84,33,85,15,217
158,81,17,85,15,198
159,82,34,51,15,182
160,66,34,51,15,166
161,116,33,67,18,234
162,51,16,51,15,133
163,84,33,67,18,202
164,67,33,67,18,185
165,67,15,67,18,167
166,51,15,67,18,151
168,100,34,99,17,250
169,100,16,99,17,232
170,67,34,99,17,217
171,68,16,99,17,200
172,52,16,99,17,184
173,82,35,66,17,200
174,66,35,66,17,184
175,66,17,66,17,166
177,82,34,118,15,249
178,67,34,118,15,234
180,66,33,85,15,199
181,67,16,85,15,183
182,51,16,85,15,167
183,118,32,66,17,233
184,66,35,132,18,251
185,65,19,132,18,234
188,52,15,66,17,150
189,51,34,100,17,202
192,83,17,51,16,167
193,65,17,51,16,149
195,68,16,100,16,200
196,68,33,67,16,184
197,51,33,67,16,167
198,51,16,67,16,150
199,81,35,100,18,234
200,100,33,67,18,218
203,67,17,67,18,169
204,85,16,52,16,169
205,68,16,52,16,152
206,66,34,166,16,282
207,50,34,166,16,266
208,67,34,98,18,217
209,117,32,134,18,301
210,68,33,65,18,184
212,99,33,67,17,216
213,81,33,67,17,198
215,66,16,67,17,166
216,65,34,67,18,184
217,68,16,67,18,169
218,67,33,52,16,168
220,67,34,102,15,218
221,83,34,68,15,200
225,84,35,82,16,217
226,84,18,82,16,200
228,68,31,67,17,183
229,52,31,67,17,167
230,66,35,133,16,250
231,66,18,133,16,233
232,82,16,101,16,215
233,67,16,101,16,200
234,67,34,67,16,184
236,81,17,119,16,233
237,65,17,119,16,217
238,66,35,84,16,201
239,68,16,84,16,184
240,67,33,51,16,167
242,68,32,67,18,185
243,81,35,66,17,199
245,84,32,51,16,183
246,51,16,66,17,150
248,67,34,82,16,199
249,66,16,82,16,180
250,66,33,100,17,216
252,83,19,97,18,217
253,98,16,67,18,199
258,65,32,51,17,165
259,51,32,51,17,151
260,67,35,82,17,201
261,67,17,82,17,183
262,83,17,66,17,183
265,50,34,100,17,201
266,82,17,68,17,184
267,66,17,68,17,168
268,66,34,131,20,251
269,117,34,63,20,234
270,117,17,63,20,217
271,67,18,97,20,202
272,68,34,63,20,185
274,68,31,52,16,167
275,100,15,102,18,235
276,82,15,102,18,217
277,65,15,102,18,200
279,135,16,84,17,252
281,51,33,99,18,201
283,66,16,84,17,183
284,66,33,51,17,167
287,67,15,101,17,200
288,66,35,66,17,184
289,66,17,66,17,166
290,51,17,66,17,151
292,68,33,68,16,185
293,66,17,68,16,167
294,66,33,199,18,316
297,68,17,92,5,182
298,84,16,60,5,165
299,67,16,60,5,148
300,51,16,60,5,132
301,67,15,149,19,250
302,65,32,67,18,182
304,60,5,67,18,150
307,72,36,49,18,175
309,84,33,65,16,198
311,65,19,65,16,165
312,50,19,65,16,150
313,51,34,67,15,167
314,49,18,67,15,149
315,84,36,166,16,302
316,65,36,166,16,283
317,85,31,67,16,199
318,67,31,67,16,181
319,53,31,67,16,167
321,83,35,84,17,219
322,63,35,84,17,199
324,83,16,52,17,168
325,65,16,52,17,150
327,68,18,66,18,170
329,52,33,67,16,168
330,120,16,67,16,219
332,66,34,67,16,183
334,67,31,52,16,166
335,65,15,52,16,148
336,82,19,81,19,201
337,64,19,81,19,183
338,67,32,68,17,184
339,67,16,68,17,168
341,68,15,53,15,151
342,64,36,65,16,181
343,65,19,65,16,165
345,68,15,99,21,203
346,101,32,102,17,252
347,51,33,66,21,171
348,65,32,102,17,216
350,65,34,68,17,184
351,66,16,68,17,167
353,71,11,119,17,218
354,55,11,119,17,202
355,66,18,83,17,184
356,68,32,68,16,184
357,64,15,68,16,163
360,83,17,67,16,183
361,99,17,65,18,199
362,101,34,67,16,218
365,84,31,52,16,183
367,51,31,52,16,150
369,67,18,83,15,183
370,67,32,66,17,182
371,51,32,66,17,166
373,66,17,67,17,167
375,67,15,51,15,148
377,67,17,67,16,167
378,67,32,70,16,185
379,116,35,82,17,250
380,51,15,70,16,152
381,67,17,65,16,165
384,70,30,69,15,184
386,65,34,68,17,184
389,66,17,66,16,165
390,52,17,66,16,151
391,53,33,84,16,186
392,68,33,99,18,218
393,67,16,99,18,200
394,66,33,134,15,248
395,84,34,67,16,201
396,66,34,67,16,183
397,67,16,67,16,166
399,67,16,68,15,166
400,66,35,99,16,216
401,66,17,99,16,198
402,67,33,82,17,199
403,67,17,82,17,183
404,83,16,101,18,218
406,82,17,66,18,183
407,66,17,66,18,167
408,82,17,100,16,215
409,67,17,100,16,200
410,51,17,100,16,184
413,68,16,66,18,168
414,51,16,66,18,151
415,66,17,133,19,235
416,67,33,185,17,302
417,65,17,185,17,284
419,133,17,85,17,252
420,67,33,52,14,166
421,100,17,85,17,219
424,66,33,69,15,183
425,100,16,67,18,201
426,52,14,69,15,150
427,67,16,67,18,168
428,85,17,99,17,218
429,66,17,99,17,199
430,69,31,68,17,185
431,83,34,68,15,200
432,67,34,68,15,184
434,65,34,67,17,183
435,84,34,66,16,200
436,68,34,66,16,184
437,67,17,66,16,166
438,51,17,66,16,150
439,65,18,100,17,200
440,133,34,66,17,250
442,66,33,100,17,216
443,51,33,100,17,201
444,66,34,66,17,183
445,65,18,66,17,166
447,84,33,67,16,200
448,67,33,67,16,183
449,84,35,131,17,267
450,66,35,131,17,249
451,66,18,131,17,232
452,68,32,67,16,183
453,100,18,65,17,200
454,83,18,65,17,183
458,67,32,102,15,216
459,51,32,102,15,200
460,65,34,68,15,182
461,66,17,68,15,166
463,83,35,82,16,216
464,67,35,82,16,200
465,68,17,82,16,183
466,51,17,82,16,166
467,100,18,65,16,199
468,50,16,67,17,150
469,65,18,65,16,164
472,134,33,50,15,232
473,67,16,117,15,215
474,65,34,67,16,182
475,65,18,67,16,166
476,67,33,50,15,165
478,67,34,83,16,200
481,51,31,68,17,167
483,66,17,101,16,200
485,67,16,68,16,167
486,85,16,68,18,187
487,67,16,68,18,169
488,66,35,51,14,166
489,84,33,84,17,218
490,68,33,84,17,202
491,67,17,84,17,185
492,86,14,101,17,218
493,98,17,67,17,199
494,82,17,67,17,183
495,66,17,67,17,167
496,84,17,65,18,184
498,69,32,132,18,251
499,101,16,99,18,234
500,118,15,66,18,217
501,82,33,66,18,199
502,65,33,66,18,182
503,133,15,89,11,248
504,84,17,66,16,183
505,67,17,66,16,166
507,66,15,89,11,181
508,101,34,82,17,234
509,83,34,82,17,216
511,66,18,82,17,183
514,54,11,103,16,184
515,68,16,134,15,233
517,79,35,66,15,195
518,68,35,66,15,184
524,81,17,66,18,182
525,65,17,66,18,166
526,65,34,99,18,216
527,83,32,67,18,200
529,67,16,67,18,168
530,50,16,67,18,151
531,66,17,83,17,183
533,51,32,118,16,217
534,101,34,99,18,252
535,67,16,84,16,183
536,66,34,99,18,217
537,66,17,99,18,200
538,84,17,66,18,185
540,133,38,78,19,268
541,83,33,67,16,199
542,66,33,67,16,182
544,66,38,78,19,201
545,67,20,78,19,184
546,51,20,78,19,168
547,83,34,67,15,199
549,83,34,133,16,266
551,120,34,66,16,236
552,68,33,134,16,251
554,117,17,67,16,217
556,83,17,67,16,183
557,67,17,67,16,167
559,85,34,65,18,202
560,66,34,65,18,183
561,117,32,51,16,216
562,67,33,131,17,248
563,84,32,51,16,183
566,83,16,99,17,215
567,67,16,99,17,199
568,83,16,66,17,182
570,84,15,102,16,217
571,66,15,102,16,199
572,65,34,68,16,183
573,65,17,68,16,166
575,66,17,102,14,199
576,51,17,102,14,184
577,51,34,100,17,202
578,84,18,148,16,266
579,67,18,148,16,249
580,68,34,64,18,184
581,51,34,64,18,167
583,52,32,66,16,166
584,66,32,50,16,164
586,64,34,84,16,198
588,66,32,118,17,233
589,65,16,118,17,216
592,51,15,84,17,167
593,68,16,67,16,167
594,84,16,68,17,185
595,65,16,68,17,166
597,66,17,67,16,166
598,83,17,66,18,184
599,67,17,66,18,168
600,68,34,66,17,185
601,67,17,66,17,167
602,117,16,67,19,219
603,51,32,101,19,203
604,84,16,67,19,186
606,66,35,51,14,166
607,67,18,51,14,150
608,51,18,51,14,134
609,83,33,66,17,199
613,66,16,101,16,199
615,63,17,68,16,164
616,66,34,149,17,266
617,83,34,65,17,199
618,101,33,66,16,216
621,133,17,201,17,368
624,115,17,118,15,265
625,66,17,201,17,301
626,66,33,118,15,232
627,66,17,118,15,216
628,50,17,118,15,200
629,67,18,83,15,183
630,68,32,51,15,166
631,68,16,51,15,150
633,50,34,67,17,168
634,66,32,68,18,184
637,68,17,100,16,201
638,67,33,67,16,183
640,52,16,67,16,151
641,117,33,67,15,232
643,83,33,67,15,198
644,67,33,67,15,182
645,65,17,67,15,164
648,84,16,100,17,217
650,51,16,100,17,184
651,51,34,99,17,201
654,66,34,67,17,184
655,118,34,65,17,234
656,66,33,67,17,183
657,51,33,67,17,168
659,51,34,65,17,167
660,67,33,66,17,183
661,67,16,66,17,166
662,84,15,101,16,216
663,67,15,101,16,199
664,65,34,67,16,182
666,83,16,50,17,166
667,66,16,50,17,149
668,67,34,71,14,186
669,67,17,71,14,169
670,67,33,118,16,234
671,135,13,53,16,217
672,50,17,118,16,201
673,67,21,62,18,168
674,71,27,53,16,167
675,55,27,53,16,151
676,52,13,53,16,134
677,83,34,100,17,234
678,62,34,100,17,213
679,66,16,100,17,199
680,53,16,100,17,186
681,52,32,68,17,169
684,67,33,67,16,183
685,84,32,68,17,201
686,68,32,68,17,185
687,52,32,68,17,169
688,65,35,165,17,282
694,65,33,67,17,182
695,67,15,67,17,166
696,83,17,199,17,316
697,66,17,199,17,299
698,51,17,199,17,284
700,67,35,67,16,185
701,66,18,67,16,167
703,67,18,65,19,169
704,51,18,65,19,153
705,52,33,117,14,216
706,67,32,65,20,184
707,67,16,65,20,168
711,66,15,84,17,182
712,65,34,67,17,183
713,66,14,67,17,164
714,52,14,67,17,150
715,66,17,66,18,167
716,68,33,68,17,186
717,64,17,68,17,166
718,67,33,133,18,251
720,84,17,65,16,182
721,68,17,65,16,166
722,51,17,65,16,149
723,68,15,66,18,167
725,66,16,101,18,201
726,65,33,86,16,200
728,84,15,101,16,216
729,67,15,101,16,199
730,66,35,99,17,217
731,50,35,99,17,201
732,134,33,67,17,251
733,68,16,132,17,233
736,66,33,67,17,183
737,81,34,67,16,198
738,65,34,67,16,182
740,50,17,67,16,150
743,67,17,50,20,154
744,100,37,97,16,250
745,66,17,68,16,167
747,67,20,97,16,200
748,50,20,97,16,183
749,85,33,67,15,200
750,84,17,67,15,183
751,84,33,66,16,199
752,97,34,65,18,214
753,83,34,65,18,200
754,66,34,65,18,183
755,50,34,65,18,167
756,82,17,66,18,183
758,66,33,51,17,167
759,83,33,67,18,201
760,116,17,133,17,283
762,66,35,133,17,251
763,68,17,133,17,235
764,51,17,133,17,218
765,82,34,67,17,200
767,83,33,200,18,334
771,65,18,67,15,165
772,67,34,198,18,317
773,67,17,198,18,300
774,116,17,67,18,218
775,52,33,66,17,168
776,67,32,67,18,184
777,82,34,51,18,185
778,65,34,51,18,168
779,67,17,51,18,153
780,99,36,116,14,265
781,68,16,66,18,168
782,67,36,116,14,233
783,68,18,116,14,216
785,52,30,134,16,232
786,84,16,100,16,216
787,66,16,100,16,198
788,64,34,66,16,180
790,68,32,101,17,218
791,68,14,101,17,200
792,52,14,101,17,184
793,83,35,98,17,233
794,82,19,98,17,216
795,64,19,98,17,198
797,66,16,232,19,333
798,67,32,51,17,167
799,68,15,51,17,151
801,67,15,101,16,199
802,66,34,151,15,266
804,51,17,151,15,234
805,67,16,65,18,166
806,68,33,65,19,185
809,99,15,100,18,232
810,83,15,100,18,216
811,100,15,66,18,199
812,149,16,68,17,250
813,68,15,66,18,167
815,66,18,99,17,200
816,84,16,68,17,185
817,65,16,68,17,166
818,66,34,101,15,216
819,101,16,99,17,233
820,65,34,99,17,215
822,52,16,99,17,184
823,67,17,65,17,166
824,51,17,65,17,150
825,65,18,65,19,167
826,82,17,135,15,249
828,65,33,102,15,215
829,83,33,101,18,235
831,69,14,101,18,202
832,52,14,101,18,185
833,99,19,50,15,183
834,67,35,50,15,167
835,64,19,50,15,148
836,69,32,67,16,184
837,51,32,67,16,166
838,85,15,153,16,269
839,69,15,153,16,253
842,67,35,84,16,202
844,50,19,84,16,169
847,84,35,115,17,251
848,65,35,115,17,232
849,69,16,115,17,217
850,53,16,115,17,201
851,83,33,51,17,184
852,66,33,51,17,167
853,64,16,51,17,148
855,65,17,66,17,165
856,67,34,101,15,217
857,67,17,101,15,200
858,51,17,101,15,184
859,83,34,68,17,202
860,83,17,68,17,185
862,66,35,65,18,184
863,84,33,65,18,200
864,69,33,65,18,185
866,100,33,51,17,201
867,52,32,68,16,168
868,83,15,51,17,166
869,68,15,51,17,151
871,66,17,83,15,181
872,84,17,100,15,216
875,100,15,135,15,265
876,66,32,135,15,248
877,67,15,135,15,232
879,70,15,67,15,167
881,50,33,67,15,165
882,68,34,100,15,217
883,64,18,100,15,197
886,82,19,65,18,184
889,85,32,66,18,201
890,67,32,66,18,183
893,67,15,101,17,200
894,65,33,68,17,183
895,135,16,67,15,233
897,66,16,67,16,165
901,50,33,133,16,232
902,67,34,66,16,183
903,65,18,66,16,165
904,99,34,66,17,216
906,66,34,66,17,183
907,67,17,66,17,167
908,66,33,134,16,249
911,66,17,67,18,168
912,66,34,67,16,183
913,67,17,67,16,167
914,67,33,50,17,167
915,84,34,66,18,202
917,84,33,100,16,233
918,118,15,67,16,216
919,66,17,100,16,199
920,85,15,67,16,183
922,66,34,67,16,183
924,51,16,67,16,150
925,82,34,66,16,198
926,67,34,66,16,183
928,67,33,100,17,217
929,66,17,100,17,200
930,67,33,67,17,184
931,117,34,100,17,268
935,68,16,100,17,201
936,84,17,66,17,184
937,68,17,66,17,168
938,83,17,100,18,218
939,65,17,100,18,200
942,83,16,51,18,168
943,101,16,67,16,200
946,66,36,65,16,183
948,51,18,65,16,150
949,52,31,167,16,266
950,67,34,66,18,185
951,149,32,68,17,266
953,67,17,133,17,234
954,67,33,67,16,183
956,66,32,68,17,183
957,68,14,68,17,167
958,65,35,66,16,182
960,67,33,66,17,183
962,68,33,67,18,186
963,82,33,68,16,199
964,151,16,66,17,250
965,66,17,68,16,167
967,66,17,68,15,166
969,69,16,66,17,168
970,52,16,66,17,151
975,67,17,133,17,234
976,82,16,135,17,250
977,67,16,135,17,235
978,101,33,67,17,218
979,84,33,67,17,201
982,51,17,67,17,152
983,100,17,100,15,232
986,67,33,67,15,182
987,67,16,67,15,165
988,134,32,67,18,251
989,65,18,66,18,167
991,83,32,67,18,200
993,52,32,67,18,169
995,66,15,52,16,149
997,67,17,67,17,168
999,67,16,67,15,165
1000,52,16,67,15,150
1001,51,33,100,16,200
1002,67,34,132,17,250
1003,83,32,68,15,198
1004,67,32,68,15,182
1005,65,17,68,15,165
1006,66,34,66,17,183
1007,66,17,66,17,166
1008,66,34,99,18,217
1009,67,18,99,18,202
1011,83,34,67,15,199
1012,66,34,67,15,182
1013,67,17,67,15,166
1014,49,17,67,15,148
1017,68,16,99,17,200
1018,67,32,67,17,183
1019,66,17,67,17,167
1020,83,17,66,17,183
1021,65,17,66,17,165
1025,67,16,67,16,166
1026,66,33,134,17,250
1030,67,34,66,17,184
1031,66,18,66,17,167
1033,83,33,84,17,217
1034,67,33,84,17,201
1035,51,33,84,17,185
1036,83,16,51,17,167
1038,50,16,51,17,134
1039,69,16,100,16,201
1040,84,17,67,16,184
1042,51,17,67,16,151
1044,66,34,66,17,183
1046,67,34,66,16,183
1047,66,18,66,16,166
1048,100,34,65,18,217
1051,67,17,65,18,167
1052,66,33,100,16,215
1054,83,16,68,16,183
1055,66,16,68,16,166
1056,65,33,68,16,182
1057,67,15,68,16,166
1058,50,15,68,16,149
1059,84,33,99,17,233
1060,68,33,99,17,217
1061,66,17,99,17,199
1062,68,33,101,15,217
1063,82,34,67,15,198
1065,68,16,67,15,166
1066,51,16,67,15,149
1067,83,35,66,19,203
1069,65,18,66,19,168
1070,117,16,100,16,249
1071,100,16,100,16,232
1072,69,32,100,16,217
1073,68,16,100,16,200
1074,66,35,65,16,182
1075,70,16,65,16,167
1076,67,30,68,16,181
1077,51,30,68,16,165
1081,65,17,51,17,150
1082,51,17,51,17,136
1083,64,18,150,17,249
1084,67,34,65,16,182
1086,68,32,66,18,184
1087,52,32,66,18,168
1088,82,17,102,16,217
1089,82,33,135,16,266
1090,65,33,135,16,249
1095,52,34,66,16,168
1096,69,32,100,15,216
1097,67,16,100,15,198
1098,100,32,68,15,215
1100,98,34,69,14,215
1101,50,32,68,15,165
1102,66,34,69,14,183
1103,99,19,65,17,200
1105,65,19,65,17,166
1106,83,20,66,14,183
1109,68,16,134,19,237
1111,67,19,65,16,167
1112,66,32,66,19,183
1113,66,18,66,19,169
1114,50,18,66,19,153
1117,103,14,50,19,186
1118,85,14,50,19,168
1119,83,34,133,16,266
1120,66,34,133,16,249
1121,50,34,133,16,233
1122,83,19,66,16,184
1124,50,19,66,16,151
1125,101,18,65,18,202
1126,83,18,65,18,184
1129,52,32,102,15,201
1131,66,17,69,15,167
1132,65,36,64,18,183
1133,67,18,64,18,167
1134,69,33,64,17,183
1135,86,31,134,17,268
1136,69,31,134,17,251
1137,51,31,134,17,233
1138,64,33,101,17,215
1140,81,18,83,16,198
1141,84,31,52,16,183
1143,50,31,52,16,149
1144,66,35,101,16,218
1147,65,16,68,16,165
1148,52,16,68,16,152
1150,67,34,67,16,184
1151,84,35,63,19,201
1155,53,32,150,15,250
1156,67,31,67,19,184
1159,69,14,68,18,169
1160,50,14,68,18,150
1161,67,15,52,15,149
1162,52,15,52,15,134
1163,67,15,101,16,199
1166,52,15,100,18,185
1167,64,20,64,18,166
1168,69,32,135,15,251
1169,67,16,135,15,233
1170,68,32,51,18,169
1172,82,15,70,15,182
1173,99,18,65,18,200
1175,67,18,65,18,168
1176,51,18,65,18,152
1177,68,17,198,17,300
1178,70,31,119,17,237
1180,65,32,87,17,201
1182,63,36,135,15,249
1183,66,18,135,15,234
1186,71,33,67,15,186
1188,68,31,67,15,181
1189,134,16,133,17,300
1192,82,16,133,17,248
1193,96,17,101,17,231
1194,51,16,133,17,217
1196,63,35,66,17,181
1197,65,18,66,17,166
1198,67,31,52,20,170
1199,100,18,84,17,219
1200,66,35,84,17,202
1202,66,37,81,15,199
1204,52,20,81,15,168
1206,84,17,65,16,182
1207,84,32,65,19,200
1210,100,32,102,16,250
1212,81,16,102,16,215
1213,64,16,102,16,198
1214,84,18,65,16,183
1216,51,18,65,16,150
1218,85,17,83,17,202
1219,66,17,83,17,183
1220,65,33,67,16,181
1221,51,33,67,16,167
1222,51,17,67,16,151
1224,66,34,68,16,184
1225,67,17,68,16,168
1226,67,32,52,14,165
1227,98,20,64,17,199
1228,66,36,64,17,183
1229,65,20,64,17,166
1230,68,30,69,16,183
1233,69,15,68,18,170
1234,64,35,51,15,165
1236,69,33,99,16,217
1237,83,33,66,16,198
1238,86,15,66,16,183
1239,69,15,66,16,166
1241,67,16,184,17,284
1243,81,33,101,17,232
1245,65,17,101,17,200
1246,66,33,68,17,184
1247,67,16,68,17,168
1249,118,34,65,17,234
1250,67,34,99,17,217
1251,67,17,99,17,200
1254,51,17,65,17,150
1255,51,32,102,32,217
1256,66,33,69,32,200
1258,65,34,67,17,183
1260,102,32,100,16,250
1261,68,17,66,16,167
1263,84,34,66,16,200
1264,67,34,66,16,183
1266,66,33,99,18,216
1267,54,33,99,18,204
1269,83,34,68,13,198
1270,132,36,65,15,248
1273,52,32,101,15,200
1274,84,18,65,15,182
1275,68,18,65,15,166
1276,68,31,66,18,183
1277,82,34,65,17,198
1278,85,16,65,17,183
1279,83,32,101,17,233
1280,65,32,101,17,215
1282,66,33,68,17,184
1283,66,15,68,17,166
1284,65,34,51,17,167
1286,84,17,67,16,184
1289,68,17,99,16,200
1293,66,17,66,16,165
1294,66,33,132,19,250
1295,83,33,68,17,201
1296,66,33,68,17,184
1297,50,33,68,17,168
1298,66,36,131,17,250
1299,84,32,65,16,197
1301,85,31,68,17,201
1303,102,15,51,16,184
1305,68,15,51,16,150
1307,82,33,69,15,199
1308,68,33,69,15,185
1310,51,16,69,15,151
1313,66,19,97,32,214
1314,69,32,97,7,205
1315,66,17,97,7,187
1316,100,33,68,16,217
1317,51,32,101,16,200
1321,80,7,78,17,182
1322,65,7,78,17,167
1323,66,17,66,18,167
1324,101,33,51,16,201
1325,69,33,51,16,169
1327,66,17,51,16,150
1328,66,33,83,19,201
1329,68,15,83,19,185
1331,68,16,68,15,167
1332,51,16,68,15,150
1333,64,19,67,15,165
1334,68,34,65,16,183
1335,65,19,65,16,165
1336,68,33,98,18,217
1337,151,33,68,16,268
1338,67,32,66,18,183
1339,52,32,66,18,168
1340,98,33,68,16,215
1343,67,16,68,16,167
1344,66,35,65,17,183
1345,85,33,65,18,201
1346,68,33,65,18,184
1348,68,32,100,19,219
1349,82,33,67,19,201
1350,65,33,67,19,184
1351,67,16,67,19,169
1352,65,34,52,15,166
1353,67,16,52,15,150
1356,52,15,118,17,202
1357,68,15,68,16,167
1358,52,15,68,16,151
1359,81,36,66,15,198
1360,66,36,66,15,183
1361,83,33,199,17,332
1363,65,17,199,17,298
1364,52,17,199,17,285
1365,67,17,66,18,168
1366,66,34,132,17,249
1369,67,16,100,17,200
1370,66,33,167,16,282
1371,69,15,167,16,267
1372,82,16,51,17,166
1373,82,34,67,17,200
1375,64,18,67,17,166
1376,84,17,66,16,183
1379,52,33,68,15,168
1380,67,33,67,16,183
1381,67,16,67,16,166
1382,82,19,82,16,199
1384,83,17,100,17,217
1385,83,34,83,17,217
1386,67,34,83,17,201
1387,51,34,83,17,185
1388,66,32,217,17,332
1389,67,16,217,17,317
1390,100,34,65,17,216
1391,67,17,67,15,166
1392,66,34,65,17,182
1394,101,32,101,17,251
1395,84,32,101,17,234
1396,82,17,101,17,217
1397,65,17,101,17,200
1398,65,36,133,17,251
1400,68,32,68,16,184
1402,84,17,99,17,217
1404,65,35,99,17,216
1405,51,35,99,17,202
1406,68,33,66,17,184
1407,52,33,66,17,168
1409,117,33,66,18,234
1413,66,16,66,18,166
1414,52,16,66,18,152
1416,66,33,134,17,250
1417,66,16,134,17,233
1419,100,17,67,17,201
1420,66,34,67,17,184
1422,67,33,51,15,166
1423,49,33,51,15,148
1425,66,18,67,17,168
1426,67,32,67,17,183
1427,51,32,67,17,167
1430,67,32,51,16,166
1431,67,15,51,16,149
1434,69,30,66,17,182
1435,66,16,66,17,165
1436,51,16,66,17,150
1437,83,33,68,16,200
1438,63,33,68,16,180
1439,67,15,68,16,166
1440,66,33,68,17,184
1441,80,35,66,18,199
1442,66,35,66,18,185
1443,66,17,66,18,167
1446,51,17,66,17,151
1447,67,16,100,18,201
1448,84,15,67,18,184
1449,68,15,67,18,168
1451,82,34,99,17,232
1453,67,15,99,17,198
1456,52,15,101,16,184
1457,66,15,68,16,165
1458,66,33,51,17,167
1459,98,18,68,15,199
1460,51,15,51,17,134
1461,99,17,67,16,199
1462,68,33,67,16,184
1463,66,17,67,16,166
1465,51,35,65,18,169
1466,100,33,151,15,299
1467,67,17,102,13,199
1469,65,17,151,15,248
1471,68,15,66,20,169
1472,66,36,65,17,184
1476,66,35,67,15,183
1477,72,15,67,15,169
1479,69,15,100,18,202
1480,102,32,69,16,219
1481,66,16,65,18,165
1482,67,32,69,16,184
1483,82,33,52,16,183
1484,83,17,52,16,168
1486,117,16,67,16,216
1487,68,18,63,17,166
1488,85,16,67,16,184
1491,50,31,106,17,204
1492,63,36,70,17,186
1494,67,38,118,16,239
1495,88,32,69,17,206
1496,74,32,69,17,192
1498,70,34,52,16,172
1500,66,35,99,16,216
1501,65,18,99,16,198
1502,69,33,118,14,234
1504,52,16,118,14,200
1505,85,32,52,14,183
1508,66,33,101,16,216
1509,64,17,101,16,198
1510,84,14,68,16,182
1511,68,14,68,16,166
1512,52,14,68,16,150
1513,84,34,65,18,201
1514,67,34,65,18,184
1515,65,17,65,18,165
1516,51,17,65,18,151
1518,133,34,99,16,282
1519,52,30,51,17,150
1520,83,16,68,16,183
1521,67,16,68,16,167
1522,64,34,99,16,213
1525,66,18,65,16,165
1526,68,33,134,15,250
1527,51,33,134,15,233
1528,67,32,67,17,183
1529,99,17,69,15,200
1531,101,15,66,17,199
1532,65,34,66,17,182
1533,67,15,66,17,165
1535,51,35,99,17,202
1536,51,18,99,17,185
1538,83,16,52,15,166
1540,82,17,82,17,198
1541,101,15,50,17,183
1542,85,15,50,17,167
1543,68,15,50,17,150
1544,84,16,100,17,217
1545,66,16,100,17,199
1546,82,17,99,18,216
1547,65,17,99,18,199
1548,50,17,99,18,184
1549,50,33,66,18,167
1550,151,16,135,16,318
1552,66,33,137,14,250
1553,67,16,137,14,234
1554,66,34,135,16,251
1556,51,16,135,16,218
1557,84,33,68,16,201
1558,68,33,68,16,185
1559,66,17,68,16,167
1560,103,32,52,46,233
1561,117,39,59,18,233
1562,69,32,52,46,199
1564,68,39,59,18,184
1565,66,23,59,18,166
1567,70,46,86,17,219
1569,82,35,132,20,269
1570,77,17,132,20,246
1573,81,17,101,15,214
1574,68,17,101,15,201
1575,102,30,52,18,202
1576,52,34,150,15,251
1577,86,13,52,18,169
1578,68,13,52,18,151
1580,85,33,65,15,198
1581,67,33,65,15,180
1583,52,18,65,15,150
1586,68,15,75,22,180
1587,65,34,85,16,200
1588,84,41,60,16,201
1589,108,22,223,15,368
1590,65,25,60,16,166
1591,75,22,223,15,335
1592,104,16,100,18,238
1593,85,16,100,18,219
1594,69,16,100,18,203
1595,60,34,66,18,178
1596,61,18,66,18,163
1598,82,34,66,19,201
1599,85,15,66,19,185
1600,84,33,100,17,234
1602,98,16,119,16,249
1604,65,16,119,16,216
1607,52,15,133,18,218
1608,67,16,100,18,201
1609,67,35,65,18,185
1610,100,16,66,16,198
1611,117,16,135,16,284
1614,67,16,135,16,234
1616,132,17,101,15,265
1619,68,33,101,15,217
1621,67,34,134,16,251
1623,67,33,67,17,184
1624,67,17,67,17,168
1625,67,34,67,16,184
1626,50,34,67,16,167
1627,67,33,50,16,166
1629,67,34,99,17,217
1630,67,17,99,17,200
1632,52,32,67,17,168
1633,50,16,67,17,150
1634,65,17,67,16,165
1635,99,33,84,17,233
1636,83,33,84,17,217
1641,65,34,68,16,183
1642,82,35,99,16,232
1643,66,35,99,16,216
1644,151,33,66,19,269
1645,52,17,99,16,184
1646,51,33,66,16,166
1647,84,17,65,18,184
1648,66,17,65,18,166
1651,66,32,53,15,166
1652,116,34,134,16,300
1653,83,16,232,19,350
1654,66,16,232,19,333
1655,66,34,134,16,250
1657,83,19,66,17,185
1658,65,19,66,17,167
1659,68,34,66,16,184
1660,149,33,98,20,300
1661,68,32,67,16,183
1662,68,17,67,16,168
1664,50,34,64,19,167
1665,66,33,98,20,217
1667,83,15,67,20,185
1668,100,15,53,17,185
1670,115,37,99,15,266
1671,65,33,67,18,183
1672,82,37,99,15,233
1674,68,17,99,15,199
1675,53,17,99,15,184
1676,118,34,83,16,251
1677,67,35,66,16,184
1679,82,17,83,16,198
1680,67,17,83,16,183
1681,69,32,67,17,185
1682,51,32,67,17,167
1683,49,17,67,17,150
1684,65,17,67,17,166
1685,83,16,66,17,182
1686,68,16,66,17,167
1689,67,33,85,15,200
1691,83,16,52,15,166
1693,82,19,68,14,183
1694,65,19,68,14,166
1695,68,32,68,17,185
1696,83,36,65,17,201
1697,52,15,68,17,152
1698,101,18,67,14,200
1700,83,33,101,16,233
1701,68,33,101,16,218
1702,83,34,67,16,200
1703,65,34,67,16,182
1705,50,17,67,16,150
1707,66,35,65,18,184
1708,84,32,67,16,199
1709,67,32,67,16,182
1710,69,16,67,16,168
1711,83,17,67,16,183
1712,82,34,67,17,200
1713,65,34,67,17,183
1714,83,33,100,16,232
1715,67,33,100,16,216
1716,67,17,100,16,200
1718,65,18,66,16,165
1721,51,16,132,18,217
1722,84,35,64,18,201
1724,65,19,64,18,166
1727,67,32,59,27,185
1728,83,34,102,16,235
1729,64,34,102,16,216
1731,91,43,101,16,251
1732,74,43,101,16,234
1733,136,34,100,17,287
1734,68,16,101,16,201
1735,118,18,100,17,253
1736,77,34,100,17,228
1737,67,34,100,17,218
1738,66,18,100,17,201
1739,50,18,100,17,185
1740,66,17,101,17,201
1741,83,17,99,18,217
1742,84,34,101,16,235
1743,100,34,83,14,231
1744,84,34,83,14,215
1746,68,17,83,14,182
1748,69,14,100,16,199
1749,83,18,64,16,181
1751,67,30,69,15,181
1752,130,19,67,16,232
1753,100,35,67,16,218
1754,82,35,67,16,200
1756,64,19,67,16,166
1757,101,35,84,16,236
1758,82,35,84,16,217
1759,67,35,84,16,202
1760,86,33,67,17,203
1761,67,33,67,17,184
1764,86,32,65,17,200
1765,68,32,65,17,182
1766,68,16,65,17,166
1767,67,32,85,14,198
1768,84,33,52,14,183
1770,64,17,52,14,147
1771,82,16,100,17,215
1772,81,33,67,17,198
1774,69,14,67,17,167
1776,67,15,101,17,200
1777,66,34,117,18,235
1778,81,34,67,16,198
1779,67,34,67,16,184
1780,66,17,67,16,166
1781,51,17,67,16,151
1782,98,17,84,17,216
1783,67,34,84,17,202
1785,83,18,67,15,183
1788,51,33,100,15,199
1789,67,34,66,15,182
1790,68,17,66,15,166
1791,67,32,68,15,182
1794,67,16,67,15,165
1795,66,34,65,18,183
1796,85,33,65,19,202
1797,68,33,65,19,185
1798,50,33,65,19,167
1799,67,32,68,17,184
1800,52,32,68,17,169
1803,65,35,66,17,183
1804,69,16,66,17,168
1805,68,32,69,14,183
1807,52,15,69,14,150
1808,99,18,66,15,198
1810,66,18,66,15,165
1811,51,18,66,15,150
1812,65,17,67,18,167
1813,66,35,101,15,217
1814,84,32,69,15,200
1817,67,33,185,15,300
1819,65,36,66,15,182
1821,69,32,66,15,182
1822,51,32,66,15,164
1823,51,17,66,15,149
1825,66,32,66,18,182
1826,83,35,65,16,199
1827,66,35,65,16,182
1828,66,20,65,16,167
1829,83,15,69,17,184
1833,65,35,83,17,200
1834,84,31,69,17,201
1835,69,31,69,17,186
1837,118,17,131,17,283
1839,83,17,131,17,248
1840,100,14,67,18,199
1842,67,14,67,18,166
1845,67,31,68,16,182
1846,81,33,200,18,332
1847,100,35,66,18,219
1848,67,15,200,18,300
1849,64,35,66,18,183
1850,65,18,66,18,167
1851,99,35,99,18,251
1852,50,31,101,16,198
1853,66,35,99,18,218
1854,66,18,99,18,201
1857,53,16,65,18,152
1858,52,32,67,17,168
1860,81,34,68,15,198
1861,65,34,68,15,182
1862,67,16,68,15,166
1863,67,32,69,17,185
1864,51,32,69,17,169
1866,66,18,66,17,167
1867,83,18,67,17,185
1868,66,18,67,17,168
1869,69,33,115,17,234
1870,51,33,115,17,216
1873,84,16,65,19,184
1874,100,16,131,20,267
1876,67,16,131,20,234
1877,81,17,134,17,249
1878,64,17,134,17,232
1879,84,14,66,20,184
1880,67,14,66,20,167
1881,65,36,133,18,252
1882,69,17,133,18,237
1883,85,14,70,15,184
1885,66,35,68,18,187
1886,82,35,51,14,182
1887,82,18,51,14,165
1888,66,18,51,14,149
1891,68,32,67,15,182
1893,51,14,67,15,147
1894,50,33,70,15,168
1897,67,36,131,15,249
1898,65,21,131,15,232
1899,70,30,67,18,185
1900,100,17,167,17,301
1901,51,15,67,18,151
1902,69,17,167,17,270
1903,65,32,68,17,182
1904,67,15,68,17,167
1905,85,16,51,16,168
1906,98,19,133,17,267
1907,81,19,133,17,250
1911,51,16,66,15,148
1912,52,34,148,18,252
1913,67,32,100,16,215
1914,67,15,100,16,198
1915,51,15,100,16,182
1916,83,32,68,16,199
1919,83,17,50,16,166
1922,65,18,67,15,165
1923,50,18,67,15,150
1924,51,32,66,19,168
1925,50,16,66,19,151
1926,100,16,69,18,203
1927,67,31,69,18,185
1928,66,16,69,18,169
1929,66,36,51,13,166
1930,65,17,51,13,146
1932,67,18,82,18,185
1935,51,13,51,18,133
1936,83,35,133,15,266
1939,69,35,98,15,217
1940,51,35,98,15,199
1942,53,30,68,15,166
1943,65,34,102,16,217
1944,66,16,102,16,200
1946,85,31,53,15,184
1947,68,31,53,15,167
1948,81,37,97,18,233
1951,84,15,100,19,218
1954,65,17,67,19,168
1955,83,14,119,18,234
1956,67,14,119,18,218
1957,100,34,135,16,285
1958,84,34,135,16,269
1959,67,34,135,16,252
1960,67,15,135,16,233
1961,53,15,135,16,219
1963,68,35,66,16,185
1964,84,31,51,15,181
1966,84,35,82,17,218
1967,66,35,82,17,200
1968,84,31,133,18,266
1969,66,31,133,18,248
1973,132,32,67,16,247
1976,84,32,67,16,199
1978,65,17,67,16,165
1979,83,17,167,16,283
1980,83,32,135,16,266
1982,84,34,67,15,200
1983,83,18,67,15,183
1984,65,18,67,15,165
1985,66,33,68,16,183
1987,84,17,99,18,218
1989,82,19,65,18,184
1991,68,33,66,16,183
1992,67,17,66,16,166
1993,67,32,85,14,198
1994,84,34,51,14,183
1995,65,34,51,14,164
2000,50,31,70,16,167
2001,51,14,70,16,151
2002,85,34,99,15,233
2003,133,32,67,16,248
2005,70,32,132,18,252
2006,52,32,132,18,234
2007,98,35,65,18,216
2008,67,14,67,16,164
2013,67,33,201,16,317
2014,84,33,53,16,186
2015,83,15,53,16,167
2016,68,15,53,16,152
2018,66,20,66,15,167
2019,69,33,65,16,183
2020,68,16,65,16,165
2021,53,16,65,16,150
2022,53,33,99,18,203
2023,81,17,67,18,183
2025,99,33,66,17,215
2026,51,34,68,15,168
2027,66,33,66,17,182
2028,84,35,82,16,217
2029,67,35,82,16,200
2030,69,17,82,16,184
2031,68,31,116,17,232
2032,52,31,116,17,216
2033,66,35,132,16,249
2034,65,18,132,16,231
2035,66,32,66,18,182
2037,67,35,65,16,183
2039,67,31,85,16,199
2041,66,34,116,18,234
2042,83,33,101,18,235
2043,65,33,101,18,217
2044,67,17,101,18,203
2045,85,16,67,18,186
2046,67,16,67,18,168
2047,51,16,67,18,152
2048,83,35,65,17,200
2049,101,31,136,15,283
2050,65,18,65,17,165
2052,51,31,136,15,233
2054,100,18,167,15,300
2055,82,18,167,15,282
2056,64,18,167,15,264
2057,51,18,167,15,251
2058,86,33,65,18,202
2059,69,33,65,18,185
2060,85,33,100,16,234
2061,167,33,67,18,285
2062,52,33,100,16,201
2063,82,16,101,17,216
2065,65,35,66,17,183
2066,68,17,66,17,168
2068,66,18,67,18,169
2069,84,17,52,15,168
2070,66,17,52,15,150
2072,51,34,65,17,167
2074,51,33,83,16,183
2077,65,34,67,18,184
2079,83,16,68,14,181
2080,134,16,65,17,232
2081,84,17,67,18,186
2082,67,17,67,18,169
2083,85,16,65,17,183
2085,68,33,67,15,183
2086,84,32,100,17,233
2087,67,32,100,17,216
2088,67,14,100,17,198
2089,65,35,99,18,217
2091,67,32,167,16,282
2092,114,34,67,17,232
2093,67,33,67,17,184
2095,65,34,67,17,183
2098,68,15,67,16,166
2099,52,15,67,16,150
2100,67,17,67,16,167
2101,67,33,100,17,217
2102,66,16,100,17,199
2103,67,34,150,17,268
2104,100,18,65,18,201
2106,66,18,65,18,167
2108,52,32,67,17,168
2109,117,16,184,16,333
2110,83,34,184,16,317
2111,65,34,184,16,299
2112,67,16,184,16,283
2113,67,34,65,17,183
2114,50,34,65,17,166
2115,51,17,65,17,150
2116,115,33,52,16,216
2119,65,33,52,16,166
2120,81,34,66,17,198
2121,65,34,66,17,182
2122,66,17,66,17,166
2124,68,16,67,16,167
2125,52,16,67,16,151
2126,83,35,50,15,183
2127,83,18,50,15,166
2128,65,18,50,15,148
2129,83,16,68,17,184
2130,64,16,68,17,165
2131,51,16,68,17,152
2132,68,15,52,14,149
2133,50,15,52,14,131
2134,66,18,166,16,266
2136,99,17,53,14,183
2137,52,14,88,14,168
2138,67,17,53,14,151
2139,66,35,65,16,182
2140,66,18,65,16,165
2141,70,32,66,18,186
2142,70,14,66,18,168
2144,99,17,134,15,265
2145,81,17,134,15,247
2146,63,17,134,15,229
2147,66,34,100,15,215
2148,69,16,100,15,200
2150,67,17,67,15,166
2151,67,33,68,17,185
2153,66,34,133,17,250
2155,82,19,83,16,200
2157,68,33,66,17,184
2158,68,16,66,17,167
2159,51,16,66,17,150
2160,86,32,66,19,203
2162,82,34,98,18,232
2165,66,32,100,18,216
2166,82,34,66,18,200
2169,98,34,101,15,248
2171,66,34,101,15,216
2172,65,16,101,15,197
2173,100,32,85,16,233
2174,66,16,67,15,164
2175,52,16,67,15,150
2178,66,17,50,16,149
2179,67,33,69,15,184
2180,133,18,64,17,232
2181,68,33,66,17,184
2182,50,33,66,17,166
2183,117,15,70,15,217
2185,69,30,70,15,184
2186,52,30,70,15,167
2187,100,36,99,15,250
2188,82,36,99,15,232
2189,64,36,99,15,214
2190,66,19,99,15,199
2191,51,19,99,15,184
2192,53,30,69,15,167
2195,99,31,68,16,214
2196,65,19,66,15,165
2198,52,31,68,16,167
2199,64,35,232,17,348
2201,81,18,51,15,165
2203,68,32,101,17,218
2205,65,34,133,17,249
2206,50,34,133,17,234
2207,51,15,133,17,216
2211,67,34,65,18,184
2212,51,34,65,18,168
2213,66,32,66,19,183
2214,67,15,66,19,167
2215,66,33,52,15,166
2216,66,16,52,15,149
2217,65,33,103,15,216
2218,66,15,103,15,199
2219,66,34,69,15,184
2221,52,15,69,15,151
2222,67,16,100,18,201
2223,68,35,83,15,201
2224,65,19,83,15,182
2225,69,31,52,15,167
2228,67,17,69,14,167
2229,65,33,68,15,181
2230,83,36,80,17,216
2233,116,17,133,18,284
2234,65,18,65,17,165
2236,64,17,133,18,232
2237,80,17,69,14,180
2238,83,33,67,18,201
2240,50,33,67,18,168
2241,84,18,64,18,184
2243,69,31,67,17,184
2245,85,15,68,16,184
2246,67,15,68,16,166
2247,82,16,68,16,182
2248,68,16,68,16,168
2249,51,16,68,16,151
2250,66,17,133,17,233
2251,51,17,133,17,218
2252,66,18,82,17,183
2253,68,32,67,17,184
2255,50,16,67,17,150
2256,67,17,184,16,284
2257,82,17,68,16,183
2259,84,16,118,16,234
2261,66,35,83,16,200
2265,51,15,68,18,152
2266,67,17,52,15,151
2268,67,16,133,16,232
2270,69,15,66,17,167
2273,83,16,69,15,183
2274,115,35,65,16,231
2275,116,19,65,16,216
2276,67,17,67,18,169
2277,66,35,65,16,182
2278,117,33,66,18,234
2279,69,32,66,17,184
2280,52,32,66,17,167
2281,67,33,66,18,184
2282,69,15,66,18,168
2283,65,33,67,18,183
2284,50,33,67,18,168
2285,66,33,119,14,232
2286,65,16,119,14,214
2287,66,34,67,18,185
2289,85,15,52,14,166
2290,68,15,52,14,149
2291,52,15,52,14,133
2292,101,14,102,17,234
2293,67,32,102,17,218
2294,67,14,102,17,200
2296,83,33,100,18,234
2298,65,16,100,18,199
2299,51,16,100,18,185
2300,67,17,65,18,167
2302,116,35,66,17,234
2303,52,16,98,18,184
2305,65,35,66,17,183
2306,66,17,66,17,166
2307,67,31,52,16,166
2308,66,15,52,16,149
2309,66,35,67,17,185
2311,66,33,51,17,167
2314,67,17,83,17,184
2315,67,34,66,16,183
2316,67,17,66,16,166
2317,51,17,66,16,150
2318,117,32,52,17,218
2319,83,17,66,18,184
2320,83,32,52,17,184
2321,66,32,52,17,167
2322,118,35,65,16,234
2323,65,34,66,18,183
2324,83,35,65,16,199
2325,66,35,65,16,182
2326,50,35,65,16,166
2327,69,31,102,15,217
2330,66,16,68,15,165
2331,81,17,68,16,182
2333,67,35,66,17,185
2335,68,33,231,17,349
2336,52,33,231,17,333
2337,68,33,99,18,218
2338,67,17,99,18,201
2340,68,18,64,18,168
2341,50,18,64,18,150
2342,52,30,52,16,150
2343,84,15,66,19,184
2344,67,15,66,19,167
2345,64,34,65,17,180
2347,52,16,65,17,150
2348,81,33,69,16,199
2349,85,14,69,16,184
2350,117,33,84,16,250
2353,69,33,84,16,202
2356,52,32,101,15,200
2357,65,35,66,15,181
2358,84,33,67,17,201
2360,68,16,67,17,168
2362,68,16,68,15,167
2364,64,19,66,15,164
2365,67,34,65,17,183
2366,67,17,65,17,166
2367,68,32,67,17,184
2368,85,33,66,18,202
2369,66,33,66,18,183
2371,65,34,132,15,246
2372,101,15,68,17,201
2373,67,32,68,17,184
2374,69,15,68,17,169
2375,51,15,68,17,151
2377,147,20,66,15,248
2378,83,32,101,15,231
2379,115,20,66,15,216
2381,80,20,66,15,181
2382,65,20,66,15,166
2383,67,33,116,17,233
2384,83,33,67,16,199
2385,101,32,51,17,201
2388,52,32,51,17,152
2389,100,33,65,19,217
2390,85,33,65,19,202
2391,67,33,65,19,184
2393,51,17,65,19,152
2394,83,33,85,17,218
2395,65,33,85,17,200
2397,65,35,67,15,182
2398,69,16,67,15,167
2399,83,17,167,18,285
2400,83,35,132,18,268
2401,102,33,99,18,252
2402,66,17,132,18,233
2403,67,33,99,18,217
2404,52,33,99,18,202
2405,68,33,133,16,250
2407,66,34,165,17,282
2408,51,34,165,17,267
2409,82,17,67,16,182
2410,83,35,65,17,200
2412,68,17,65,17,167
2414,84,33,67,18,202
2415,83,17,67,18,185
2416,99,16,52,17,184
2417,82,16,52,17,167
2418,68,16,52,17,153
2419,50,16,52,17,135
2420,50,34,99,18,201
2422,68,17,64,18,167
2425,84,15,67,18,184
2426,66,15,67,18,166
2427,64,35,65,18,182
2428,68,17,65,18,168
2429,68,32,51,18,169
2430,115,36,64,19,234
2431,85,15,68,17,185
2432,67,15,68,17,167
2434,66,18,64,19,167
2435,51,18,64,19,152
2439,83,15,100,17,215
2440,68,15,100,17,200
2441,51,15,100,17,183
2442,97,18,66,19,200
2444,81,34,51,17,183
2445,66,34,51,17,168
2446,68,14,51,17,150
2450,65,17,100,15,197
2451,118,16,66,21,221
2452,68,16,67,15,166
2453,69,33,66,21,189
2454,67,16,66,21,170
2456,66,17,53,29,165
2457,67,32,134,17,250
2458,103,45,68,17,233
2460,70,45,68,17,200
2461,53,45,68,17,183
2462,101,17,66,16,200
2463,66,35,66,16,183
2465,67,33,66,18,184
2469,82,17,66,17,182
2470,66,17,66,17,166
2473,67,32,85,16,200
2474,133,20,80,18,251
2477,66,36,80,18,200
2478,66,20,80,18,184
2479,70,31,116,16,233
2480,68,16,116,16,216
2481,51,16,116,16,199
2482,51,34,98,20,203
2483,98,31,54,13,196
2484,65,18,65,20,168
2485,67,31,54,13,165
2486,100,16,67,18,201
2487,82,16,67,18,183
2488,67,16,67,18,168
2489,85,13,52,16,166
2491,54,13,52,16,135
2492,68,15,69,15,167
2493,117,19,67,16,219
2495,52,16,67,16,151
2496,65,19,67,16,167
2497,84,17,101,16,218
2502,52,33,67,12,164
2503,68,33,66,15,182
2505,82,18,64,17,181
2508,51,32,83,19,185
2510,65,17,85,17,184
2511,64,30,55,17,166
2512,69,13,55,17,154
2514,68,19,82,16,185
2515,51,19,82,16,168
2516,53,32,98,18,201
2518,51,33,133,15,232
2519,82,16,68,14,180
2520,83,32,68,15,198
2523,65,36,82,17,200
2524,84,32,84,15,215
2525,50,18,82,17,167
2526,51,32,84,15,182
2527,83,18,116,18,235
2531,84,15,68,15,182
2532,52,32,68,15,167
2534,67,16,67,17,167
2536,83,33,68,16,200
2537,68,33,68,16,185
2538,100,17,65,16,198
2540,85,34,64,17,200
2541,101,31,50,17,199
2542,52,34,64,17,167
2543,68,31,50,17,166
2544,82,33,67,18,200
2547,64,34,68,16,182
2549,50,17,68,16,151
2550,102,17,99,16,234
2552,85,32,100,18,235
2553,68,32,100,18,218
2554,50,32,100,18,200
2555,51,16,100,18,185
2556,83,33,151,16,283
2557,82,17,151,16,266
2559,67,33,66,17,183
2560,67,17,66,17,167
2561,84,15,67,18,184
2562,68,15,67,18,168
2563,51,15,67,18,151
2564,50,33,52,16,151
2566,65,17,100,16,198
2567,67,34,66,16,183
2572,82,33,67,18,200
2573,66,33,67,18,184
2574,65,17,67,18,167
2575,65,35,133,16,249
2577,68,32,52,14,166
2578,84,34,67,16,201
2579,85,16,67,16,184
2581,84,14,67,16,181
2583,83,18,182,16,299
2584,65,18,182,16,281
2586,65,16,69,13,163
2587,67,35,115,16,233
2588,66,19,115,16,216
2590,66,19,81,16,182
2591,69,32,101,16,218
2592,53,32,101,16,202
2593,66,32,69,16,183
2594,68,15,69,16,168
2595,64,33,100,18,215
2596,84,36,64,18,202
2597,65,36,64,18,183
2600,85,31,102,15,233
2602,83,34,68,15,200
2603,64,34,68,15,181
2605,65,34,100,17,216
2606,65,17,100,17,199
2607,68,34,66,17,185
2608,84,33,50,16,183
2609,68,33,50,16,167
2611,67,33,69,15,184
2612,67,16,69,15,167
2614,68,16,67,19,170
2615,50,16,67,19,152
2617,69,31,67,16,183
2618,102,14,68,15,199
2620,68,14,68,15,165
2621,64,34,66,16,180
2624,64,18,99,17,198
2625,68,32,67,17,184
2626,66,17,67,17,167
2627,66,34,50,16,166
2629,66,33,68,16,183
2630,67,17,68,16,168
2631,67,33,99,19,218
2633,117,16,99,16,248
2634,68,17,199,16,300
2635,68,32,99,16,215
2636,67,16,99,16,198
2637,51,16,99,16,182
2638,67,14,102,14,197
2639,83,16,100,16,215
2642,66,15,102,15,198
2644,64,19,67,15,165
2645,67,33,98,19,217
2646,64,19,98,19,200
2648,52,34,97,17,200
2649,67,32,102,14,215
2650,68,17,102,14,201
2652,82,33,136,15,266
2653,134,33,66,15,248
2654,68,14,136,15,233
2655,102,33,66,15,216
2656,65,20,64,16,165
2657,70,33,66,15,184
2658,65,19,66,15,165
2660,100,19,100,18,237
2661,64,35,100,18,217
2662,66,19,100,18,203
2663,66,31,69,18,184
2664,53,31,69,18,171
2666,67,17,53,15,152
2667,100,33,65,18,216
2669,69,33,65,18,185
2670,70,15,65,18,168
2673,67,31,52,16,166
2674,66,14,52,16,148
2675,65,33,101,18,217
2676,80,35,118,14,247
2677,83,16,118,14,231
2680,50,33,68,17,168
2681,68,33,133,16,250
2682,82,35,63,17,197
2683,66,35,63,17,181
2685,68,31,67,16,182
2686,115,35,67,17,234
2687,52,14,67,16,149
2688,80,35,67,17,199
2691,83,17,103,15,218
2692,81,34,84,16,215
2693,68,34,84,16,202
2694,85,34,50,16,185
2696,85,35,131,16,267
2697,68,35,131,16,250
2698,84,31,66,18,199
2699,69,31,66,18,184
2700,67,16,66,18,167
2701,50,16,66,18,150
2702,68,17,65,16,166
2703,82,15,100,19,216
2704,67,15,100,19,201
2705,66,34,66,19,185
2706,98,19,67,15,199
2709,50,19,67,15,151
2710,67,15,68,17,167
2712,69,17,66,16,168
2713,67,32,50,17,166
2714,51,32,50,17,150
2715,102,33,68,15,218
2717,66,33,68,15,182
2718,67,17,68,15,167
2719,50,17,68,15,150
2720,50,33,166,17,266
2722,67,18,66,17,168
2724,65,17,51,16,149
2725,50,17,51,16,134
2727,66,33,82,19,200
2728,68,16,82,19,185
2730,64,17,102,17,200
2735,69,33,63,18,183
2737,85,13,102,18,218
2738,69,13,102,18,202
2739,50,13,102,18,183
2740,65,15,69,18,167
2742,83,32,66,18,199
2743,51,19,98,18,186
2744,52,32,66,18,168
2745,69,33,99,17,218
2747,65,33,169,15,282
2748,65,17,169,15,266
2750,66,15,68,17,166
2752,83,35,83,16,217
2753,66,35,83,16,200
2754,83,34,65,18,200
2755,85,17,65,18,185
2757,103,31,98,19,251
2758,52,34,98,17,201
2759,68,31,98,19,216
2760,82,34,64,19,199
2761,65,34,64,19,182
2763,83,15,66,16,180
2764,68,15,66,16,165
2766,66,14,51,20,151
2767,64,35,102,16,217
2771,86,17,65,18,186
2774,86,31,118,16,251
2775,66,31,118,16,231
2776,51,31,118,16,216
2777,83,17,67,16,183
2778,66,17,67,16,166
2779,66,33,101,14,214
2780,65,18,101,14,198
2781,84,18,132,19,253
2782,66,18,132,19,235
2783,67,32,68,15,182
2784,102,17,65,19,203
2785,84,17,65,19,185
2786,68,17,65,19,169
2787,67,33,100,16,216
2788,99,17,68,16,200
2789,83,17,68,16,184
2793,67,33,166,18,284
2794,52,33,166,18,269
2795,68,32,100,17,217
2797,65,35,65,17,182
2798,68,18,65,17,168
2799,84,15,85,16,200
2800,68,15,85,16,184
2802,117,34,67,15,233
2803,65,34,66,18,183
2804,65,17,66,18,166
2805,85,16,67,15,183
2806,100,17,68,15,200
2809,84,17,65,18,184
2810,66,17,65,18,166
2811,67,33,67,15,182
2812,67,18,67,15,167
2814,100,17,65,16,198
2815,65,35,65,16,181
2816,100,17,101,17,235
2817,67,32,101,17,217
2818,67,17,101,17,202
2821,133,33,50,17,233
2822,50,34,67,16,167
2823,67,34,65,18,184
2825,68,33,50,17,168
2827,51,16,50,17,134
2828,67,16,52,17,152
2831,67,34,66,16,183
2832,51,34,66,16,167
2833,52,17,66,16,151
2834,67,18,97,17,199
2836,64,19,65,17,165
2837,82,17,67,16,182
2838,66,17,67,16,166
2839,65,32,68,16,181
2841,116,17,67,16,216
2842,66,18,100,16,200
2843,67,33,67,16,183
2844,100,17,50,15,182
2845,84,17,50,15,166
2846,67,17,50,15,149
2847,66,34,117,16,233
2848,84,31,69,17,201
2849,67,31,69,17,184
2850,67,15,69,17,168
2851,82,18,51,16,167
2852,65,18,51,16,150
2853,82,18,133,15,248
2855,51,18,133,15,217
2856,119,32,68,17,236
2857,51,16,100,15,182
2859,83,16,68,17,184
2860,116,34,66,17,233
2862,66,17,51,15,149
2863,66,34,66,17,183
2865,68,32,133,17,250
2866,51,32,133,17,233
2867,51,15,133,17,216
2869,66,32,67,17,182
2870,66,15,67,17,165
2871,51,15,67,17,150
2873,66,33,67,16,182
2874,67,15,67,16,165
2876,84,33,65,18,200
2877,67,33,65,18,183
2878,82,33,67,16,198
2879,83,17,67,16,183
2880,100,15,69,16,200
2882,99,17,68,15,199
2883,50,15,69,16,150
2886,66,18,101,15,200
2887,69,34,67,15,185
2888,51,34,67,15,167
2890,67,18,66,16,167
2892,68,17,98,18,201
2896,82,33,68,17,200
2900,68,15,67,17,167
2901,101,32,68,15,216
2903,68,32,68,15,183
2904,67,15,68,15,165
2906,50,34,200,17,301
2907,66,34,66,16,182
2909,68,32,68,15,183
2910,83,34,100,17,234
2911,66,34,100,17,217
2912,85,34,133,16,268
2913,66,34,133,16,249
2914,67,18,133,16,234
2915,68,33,66,17,184
2917,84,16,67,16,183
2918,84,33,50,17,184
2920,51,33,50,17,151
2922,66,17,99,16,198
2923,67,33,66,16,182
2924,66,17,66,16,165
2925,50,17,66,16,149
2927,84,15,133,17,249
2928,68,15,133,17,233
2929,66,34,99,17,216
2930,65,18,99,17,199
2931,65,33,66,17,181
2932,98,16,51,17,182
2933,83,16,51,17,167
2934,67,16,51,17,151
2935,99,34,51,15,199
2936,99,17,51,15,182
2938,67,17,51,15,150
2941,67,33,66,20,186
2942,68,15,66,20,169
2943,66,35,67,17,185
2944,85,31,53,16,185
2946,67,14,53,16,150
2947,152,15,51,15,233
2948,68,16,65,17,166
2949,67,33,134,16,250
2952,66,15,51,15,147
2955,83,15,101,18,217
2957,84,18,131,17,250
2958,67,18,131,17,233
2959,69,32,67,16,184
2960,67,16,67,16,166
2961,52,16,67,16,151
2962,83,34,67,19,203
2963,115,16,54,12,197
2964,115,35,85,14,249
2965,99,35,85,14,233
2966,83,35,85,14,217
2968,131,18,82,18,249
2969,67,31,135,16,249
2972,66,18,82,18,184
2974,66,14,134,17,231
2975,54,14,134,17,219
2976,68,17,201,15,301
2977,67,33,67,17,184
2978,81,33,167,16,297
2980,66,17,167,16,266
2981,66,34,133,16,249
2982,67,18,133,16,234
2983,67,34,67,15,183
2984,51,34,67,15,167
2985,68,31,134,17,250
2987,65,36,98,17,216
2989,67,32,66,17,182
2990,52,32,66,17,167
2991,68,34,49,18,169
2994,67,16,69,15,167
2995,66,35,66,16,183
2996,67,18,66,16,167
2997,84,17,66,16,183
2998,68,17,66,16,167
3000,67,17,100,17,201
3001,66,34,66,17,183
3003,82,16,51,17,166
3006,84,34,82,17,217
3007,66,34,82,17,199
3009,84,16,101,16,217
3010,65,16,101,16,198
3011,66,33,68,16,183
3012,66,16,68,16,166
3014,66,17,68,16,167
3015,85,16,66,17,184
3016,68,16,66,17,167
3019,68,32,66,19,185
3020,66,16,66,19,167
3022,50,34,65,19,168
3023,66,32,70,13,181
3024,50,32,70,13,165
3026,101,18,63,17,199
3027,65,37,63,17,182
3028,69,18,63,17,167
3029,70,31,99,17,217
3031,68,32,101,16,217
3032,65,16,101,16,198
3033,104,26,66,18,214
3035,73,26,66,18,183
3036,57,26,66,18,167
3037,67,34,50,16,167
3038,50,34,50,16,150
3040,101,16,85,15,217
3041,66,34,85,15,200
3043,50,16,85,15,166
3044,67,17,51,15,150
3045,68,35,66,14,183
3047,69,31,166,18,284
3048,52,31,166,18,267
3050,85,34,67,14,200
3051,66,34,67,14,181
3052,64,20,67,14,165
3053,69,32,65,18,184
3054,52,32,65,18,167
3056,117,36,66,16,235
3058,53,30,69,16,168
3061,66,33,98,17,214
3062,52,33,98,17,200
3063,102,33,67,16,218
3064,51,33,100,16,200
3065,66,33,67,16,182
3066,65,17,67,16,165
3068,82,35,100,15,232
3071,67,34,66,15,182
3072,67,18,66,15,166
3073,51,18,66,15,150
3074,52,32,99,19,202
3075,83,17,65,19,184
3076,84,33,66,20,203
3078,85,32,86,17,220
3079,67,32,86,17,202
3082,50,34,52,17,153
3083,66,33,86,16,201
3084,101,17,131,17,266
3085,86,17,131,17,251
3086,67,17,131,17,232
3088,63,17,52,16,148
3089,86,16,133,16,251
3090,100,16,65,17,198
3093,83,17,134,18,252
3094,98,16,119,17,250
3095,65,33,119,17,234
3097,65,35,134,16,250
3098,67,18,134,16,235
3099,68,32,168,16,284
3100,51,32,168,16,267
3101,101,35,64,17,217
3103,66,35,64,17,182
3104,68,17,64,17,166
3105,52,17,64,17,150
3106,84,31,102,16,233
3107,84,15,102,16,217
3108,66,15,102,16,199
3109,64,35,67,16,182
3110,100,18,65,19,202
3111,82,18,65,19,184
3112,66,18,65,19,168
3113,51,18,65,19,153
3114,52,33,167,16,268
3116,102,14,52,16,184
3117,65,33,52,16,166
3118,68,14,52,16,150
3119,51,14,52,16,133
3121,68,33,98,17,216
3122,66,16,98,17,197
3123,52,16,98,17,183
3125,67,33,84,15,199
3126,66,17,84,15,182
3127,67,31,102,17,217
3128,83,36,83,15,217
3129,64,36,83,15,198
3130,65,19,83,15,182
3132,82,34,66,17,199
3133,68,34,66,17,185
3134,85,32,51,16,184
3136,66,15,51,16,148
3138,99,16,67,17,199
3139,66,33,67,17,183
3140,66,16,67,17,166
3142,67,16,102,16,201
3146,67,15,52,15,149
3147,51,15,52,15,133
3149,84,15,70,15,184
3150,98,19,168,16,301
3151,52,15,70,15,152
3152,100,18,66,14,198
3153,101,32,65,18,216
3155,70,32,65,18,185
3157,84,17,67,16,184
3158,67,17,67,16,167
3159,66,31,101,17,215
3161,65,36,130,19,250
3164,69,17,66,17,169
3165,52,17,66,17,152
3167,65,34,84,16,199
3168,83,31,53,16,183
3169,97,35,68,16,216
3170,102,16,68,16,202
3172,83,34,67,17,201
3175,53,16,67,17,153
3176,84,33,67,16,200
3177,68,33,67,16,184
3178,130,20,99,17,266
3180,67,14,69,16,166
3182,117,32,99,18,266
3183,67,33,83,16,199
3184,66,17,83,16,182
3185,52,17,83,16,168
3187,82,17,65,18,182
3188,100,16,65,19,200
3189,116,15,102,17,250
3192,100,15,69,17,201
3193,50,15,102,17,184
3196,117,33,66,16,232
3199,69,33,66,16,184
3201,52,16,66,16,150
3202,66,17,65,16,164
3203,67,32,68,14,181
3204,66,16,68,14,164
3206,65,17,49,19,150
3207,65,35,98,19,217
3208,65,19,98,19,201
3211,101,32,83,16,232
3212,136,14,100,17,267
3214,84,33,100,17,234
3216,67,14,100,17,198
3217,51,14,100,17,182
3218,149,35,117,14,315
3219,69,30,103,16,218
3220,64,16,103,16,199
3221,66,34,136,16,252
3222,65,17,136,16,234
3224,67,18,117,14,216
3225,69,34,165,16,284
3226,102,16,51,14,183
3227,69,32,51,14,166
3228,68,16,51,14,149
3229,66,35,65,19,185
3231,67,30,137,14,248
3232,67,14,137,14,232
3233,100,33,133,18,284
3234,66,17,65,18,166
3235,65,33,133,18,249
3236,68,14,133,18,233
3238,50,32,68,17,167
3239,65,37,82,15,199
3241,69,31,51,15,166
3242,53,31,51,15,150
3243,85,16,68,16,185
3244,83,33,69,15,200
3245,64,33,69,15,181
3247,51,15,69,15,150
3249,68,34,201,19,322
3250,66,18,201,19,304
3252,82,34,68,15,199
3256,67,16,66,17,166
3258,84,31,101,16,232
3259,68,31,101,16,216
3262,67,20,64,16,167
3263,68,19,61,17,165
3265,56,45,83,17,201
3267,80,17,100,18,215
3269,100,33,133,17,283
3270,85,33,133,17,268
3271,67,33,133,17,250
3272,67,17,133,17,234
3273,83,17,117,16,233
3274,84,33,67,17,201
3275,84,15,67,17,183
3277,66,34,169,16,285
3278,50,34,169,16,269
3279,67,33,67,16,183
3280,66,16,67,16,165
3281,84,16,119,15,234
3282,67,16,119,15,217
3283,50,16,119,15,200
3284,83,33,52,15,183
3286,66,17,52,15,150
3287,67,36,131,16,250
3288,66,20,131,16,233
3289,69,31,66,17,183
3290,69,15,66,17,167
3291,52,15,66,17,150
3293,63,34,133,19,249
3294,66,15,133,19,233
3295,66,34,67,16,183
3296,84,33,66,19,202
3297,68,33,66,19,186
3298,65,17,66,19,167
3299,67,34,67,17,185
3300,50,34,67,17,168
3301,67,32,118,16,233
3304,67,16,99,16,198
3306,68,17,65,16,166
3307,52,17,65,16,150
3309,67,32,66,18,183
3310,82,34,67,17,200
3311,65,34,67,17,183
3312,65,18,67,17,167
3314,66,16,67,18,167
3315,66,35,99,16,216
3316,68,17,99,16,200
3317,67,32,134,16,249
3318,51,32,134,16,233
3319,85,16,67,16,184
3321,66,33,67,16,182
3322,66,16,67,16,165
3324,65,18,67,16,166
3326,99,18,66,17,200
3327,67,34,66,17,184
3328,85,33,68,17,203
3330,84,33,52,15,184
3331,84,16,52,15,167
3332,84,35,65,17,201
3333,66,35,65,17,183
3334,85,32,67,16,200
3335,68,32,67,16,183
3336,68,15,67,16,166
3342,66,17,66,17,166
3343,67,34,66,16,183
3344,150,33,67,16,266
3345,50,17,66,16,149
3346,83,34,67,16,200
3348,66,17,67,16,166
3349,66,33,67,16,182
3350,83,34,100,16,233
3352,67,17,100,16,200
3353,83,17,67,16,183
3354,67,17,67,16,167
3355,67,33,133,16,249
3356,99,18,99,16,232
3357,66,34,99,16,215
3358,84,32,67,16,199
3360,51,32,67,16,166
3362,67,18,99,16,200
3364,117,33,115,21,286
3366,66,18,200,17,301
3367,83,16,115,21,235
3368,83,33,82,21,219
3369,67,33,82,21,203
3370,67,17,82,21,187
3371,83,17,69,15,184
3372,66,17,69,15,167
3373,50,17,69,15,151
3374,51,32,117,18,218
3376,65,21,80,18,184
3377,69,31,99,17,216
3378,53,31,99,17,200
3379,68,32,100,19,219
3381,98,32,102,16,248
3383,67,32,102,16,217
3384,50,32,102,16,200
3385,84,16,69,16,185
3386,67,16,69,16,168
3387,65,35,100,15,215
3388,49,35,100,15,199
3393,100,32,118,18,268
3396,65,17,118,18,218
3397,50,17,118,18,203
3398,85,32,69,15,201
3399,67,32,69,15,183
3400,68,16,69,15,168
3401,51,16,69,15,151
3402,82,36,99,16,233
3403,83,18,99,16,216
3404,100,15,185,17,317
3406,67,15,185,17,284
3407,83,16,52,17,168
3408,65,16,52,17,150
3409,63,36,133,16,248
3410,66,18,133,16,233
3411,85,17,83,17,202
3413,52,17,83,17,169
3415,84,16,66,17,183
3417,67,33,233,16,349
3419,68,33,67,16,184
3420,65,17,67,16,165
3421,83,15,69,14,181
3422,82,35,68,16,201
3423,100,34,67,15,216
3424,84,34,67,15,200
3425,67,34,67,15,183
3427,69,34,231,16,350
3428,119,32,56,28,235
3430,117,33,65,19,234
3431,115,17,65,19,216
3432,53,32,56,28,169
3434,65,17,65,19,166
3435,65,23,61,17,166
3436,73,42,68,16,199
3438,51,31,68,16,166
3439,65,36,67,14,182
3441,67,32,68,17,184
3442,98,19,50,16,183
3443,68,35,50,16,169
3444,65,19,50,16,150
3445,67,33,99,18,217
3447,85,16,66,18,185
3448,69,16,66,18,169
3450,101,17,67,15,200
3451,82,17,67,15,181
3452,65,17,67,15,164
3453,66,33,132,21,252
3454,51,33,132,21,237
3455,135,33,52,15,235
3456,84,34,64,21,203
3458,116,31,120,15,282
3459,83,18,52,15,168
3460,83,31,120,15,249
3461,67,31,120,15,233
3462,83,36,84,15,218
3463,85,15,84,15,199
3464,70,15,84,15,184
3465,67,31,53,15,166
3466,136,15,67,17,235
3467,67,34,68,16,185
3468,65,15,68,16,164
3469,65,34,67,17,183
3470,69,15,67,17,168
3473,101,33,66,18,218
3474,65,17,68,16,166
3475,67,33,66,18,184
3477,66,35,99,16,216
3478,67,18,99,16,200
3479,68,31,68,16,183
3480,82,33,51,17,183
3484,66,17,83,17,183
3485,68,33,67,15,183
3489,83,17,66,18,184
3490,67,17,66,18,168
3491,99,34,168,15,316
3492,82,34,168,15,299
3493,66,34,168,15,283
3494,83,34,65,17,199
3495,66,34,65,17,182
3496,100,17,68,16,201
3498,65,17,68,16,166
3500,65,16,69,15,165
3502,85,34,132,16,267
3505,69,34,81,17,201
3506,86,30,68,16,200
3508,100,17,67,17,201
3509,64,35,67,17,183
3510,117,34,116,17,284
3511,65,33,51,16,165
3513,68,34,116,17,235
3515,67,33,68,15,183
3520,65,19,83,16,183
3524,68,16,68,15,167
3527,82,19,99,17,217
3529,102,32,65,18,217
3530,65,19,65,17,166
3532,53,32,65,18,168
3533,66,33,117,17,233
3534,51,33,117,17,218
3537,65,35,67,17,184
3538,67,17,67,17,168
3541,85,17,66,20,188
3542,84,34,52,13,183
3543,67,34,52,13,166
3545,99,33,66,18,216
3546,103,13,66,18,200
3547,86,13,66,18,183
3550,51,35,66,15,167
3551,117,17,99,16,249
3553,101,32,67,16,216
3554,84,32,67,16,199
3555,66,32,67,16,181
3556,65,17,67,16,165
3557,67,36,97,17,217
3558,65,20,97,17,199
3559,68,31,101,16,216
3560,53,31,101,16,201
3561,67,33,68,16,184
3563,81,16,51,17,165
3564,68,16,51,17,152
3565,66,35,99,16,216
3566,67,18,99,16,200
3567,68,33,66,16,183
3568,51,33,66,16,166
3569,116,18,67,16,217
3570,51,32,67,16,166
3571,65,34,67,16,182
3572,65,18,67,16,166
3573,66,33,68,16,183
3574,65,17,68,16,166
3575,50,17,68,16,151
3576,85,34,66,16,201
3577,83,18,66,16,183
3578,67,18,66,16,167
3579,134,33,69,14,250
3582,68,16,66,17,167
3583,66,33,69,14,182
3584,66,17,69,14,166
3586,82,36,80,18,216
3587,66,36,80,18,200
3588,86,31,49,18,184
3589,69,31,49,18,167
3590,52,31,49,18,150
3594,51,33,67,16,167
3595,49,18,67,16,150
3596,85,33,82,17,217
3597,67,33,82,17,199
3598,52,33,82,17,184
3599,67,34,65,16,182
3600,84,33,67,16,200
3601,67,33,67,16,183
3602,68,18,67,16,169
3603,67,32,68,15,182
3607,67,33,166,17,283
3608,52,33,166,17,268
3609,68,31,52,16,167
3610,52,31,52,16,151
3612,83,33,67,17,200
3613,83,16,67,17,183
3615,68,32,101,18,219
3619,102,31,67,17,217
3620,67,18,65,16,166
3621,85,16,67,17,185
3622,82,34,50,18,184
3624,133,18,64,19,234
3625,65,33,67,16,181
3627,50,17,67,16,150
3629,68,32,66,19,185
3630,52,32,66,19,169
3632,66,16,102,15,199
3633,83,15,68,15,181
3635,85,14,67,18,184
3636,83,35,66,17,201
3637,102,32,51,17,202
3638,98,17,51,17,183
3640,64,17,51,17,149
3641,50,17,51,17,135
3643,66,34,101,15,216
3644,68,17,101,15,201
3645,51,17,101,15,184
3647,68,33,65,17,183
3649,67,34,99,15,215
3650,85,31,68,15,199
3651,67,31,68,15,181
3652,83,33,50,18,184
3655,64,35,67,16,182
3657,68,33,66,17,184
3658,51,33,66,17,167
3660,65,19,65,18,167
3661,67,32,66,18,183
3663,66,33,68,16,183
3664,68,16,68,16,168
3665,65,33,68,16,182
3666,100,17,66,16,199
3667,66,35,66,16,183
3668,84,33,67,16,200
3669,68,33,67,16,184
3670,132,18,65,17,232
3671,117,18,65,17,217
3672,83,34,65,17,199
3676,67,16,101,16,200
3678,67,16,68,16,167
3679,65,34,67,17,183
3680,83,34,65,17,199
3681,67,34,65,17,183
3682,67,17,65,17,166
3683,51,17,65,17,150
3684,67,17,83,16,183
3686,67,15,67,19,168
3688,84,32,66,18,200
3689,67,32,66,18,183
3690,66,16,66,18,166
3691,67,35,83,17,202
3692,134,17,133,16,300
3693,67,31,52,17,167
3696,65,17,133,16,231
3701,99,34,134,17,284
3702,99,17,134,17,267
3703,65,34,134,17,250
3704,67,17,134,17,235
3705,84,18,83,17,202
3707,50,18,83,17,168
3708,51,32,68,17,168
3713,68,32,101,18,219
3714,67,15,101,18,201
3715,51,15,101,18,185
3716,67,17,99,16,199
3717,84,17,299,16,416
3718,84,32,66,16,198
3722,67,15,101,15,198
3723,65,33,68,15,181
3724,66,17,68,15,166
3726,81,35,233,16,365
3727,66,35,233,16,350
3729,68,33,67,17,185
3731,68,34,98,17,217
3733,100,33,100,16,249
3735,67,33,100,16,216
3737,66,32,68,16,182
3739,82,16,100,19,217
3740,116,32,52,16,216
3742,84,32,52,16,184
3743,68,32,52,16,168
3744,51,32,52,16,151
3745,85,15,67,17,184
3746,81,35,199,17,332
3749,52,16,199,17,284
3752,99,18,64,18,199
3756,134,16,100,17,267
3758,82,34,100,17,233
3759,64,34,100,17,215
3760,65,16,100,17,198
3761,51,16,100,17,184
3762,66,17,66,17,166
3763,84,18,65,17,184
3764,66,18,65,17,166
3765,100,33,68,15,216
3766,66,17,101,15,199
3767,66,33,68,15,182
3768,67,16,68,15,166
3769,82,18,99,17,216
3773,52,16,66,17,151
3774,51,32,51,17,151
3778,68,17,66,16,167
3780,51,33,67,15,166
3782,66,17,66,17,166
3783,66,34,65,19,184
3784,66,18,65,19,168
3786,66,17,52,16,151
3788,83,35,99,17,234
3789,65,35,99,17,216
3790,69,16,99,17,201
3792,84,34,65,18,201
3793,68,34,65,18,185
3794,83,32,51,17,183
3795,67,32,51,17,167
3796,65,17,51,17,150
3798,65,16,67,18,166
3799,65,35,149,15,264
3800,68,17,149,15,249
3801,68,32,52,15,167
3802,51,32,52,15,150
3803,85,15,84,15,199
3804,67,15,84,15,181
3805,84,15,65,18,182
3806,69,15,65,18,167
3807,52,15,65,18,150
3808,65,17,50,17,149
3809,67,32,102,17,218
3810,65,15,102,17,199
3812,67,17,98,19,201
3813,50,17,98,19,184
3814,84,33,65,18,200
3815,102,31,202,16,351
3816,68,16,65,18,167
3817,67,31,202,16,316
3821,65,34,100,17,216
3822,66,16,100,17,199
3823,68,33,101,16,218
3825,85,17,66,16,184
3827,68,32,50,17,167
3828,67,15,50,17,149
3830,83,33,101,17,234
3832,65,17,101,17,200
3833,50,17,101,17,185
3834,69,14,102,15,200
3836,101,17,66,16,200
3837,51,16,68,15,150
3838,82,34,66,15,197
3839,68,34,66,15,183
3841,116,18,67,15,216
3843,66,34,67,15,182
3844,65,18,67,15,165
3846,84,34,65,16,199
3847,67,34,65,16,182
3849,67,33,100,16,216
3853,65,35,65,18,183
3854,66,19,65,18,168
3855,100,32,56,29,217
3856,84,32,56,29,201
3857,68,32,56,29,185
3859,65,34,71,30,200
3860,68,16,71,30,185
3861,66,22,79,15,182
3865,101,34,66,17,218
3867,66,34,66,17,183
3868,50,34,66,17,167
3869,97,33,99,18,247
3870,99,17,99,18,233
3871,67,33,99,18,217
3873,66,34,65,18,183
3875,82,19,65,17,183
3876,116,34,133,17,300
3877,68,31,134,16,249
3879,65,34,133,17,249
3880,68,16,133,17,234
3881,65,33,67,16,181
3882,66,16,67,16,165
3884,67,15,67,17,166
3885,116,17,68,16,217
3887,67,33,68,16,184
3888,65,17,68,16,166
3889,67,33,67,16,183
3890,67,16,67,16,166
3891,83,18,70,30,201
3892,85,32,68,15,200
3894,67,16,68,15,166
3895,51,16,68,15,150
3897,70,30,64,19,183
3898,84,34,66,16,200
3899,68,34,66,16,184
3900,52,34,66,16,168
3901,64,30,52,17,163
3902,66,15,52,17,150
3903,64,36,66,15,181
3904,68,17,66,15,166
3905,66,33,132,19,250
3907,52,17,132,19,220
3911,66,33,52,16,167
3912,84,33,67,16,200
3913,66,33,67,16,182
3914,51,33,67,16,167
3915,85,16,100,16,217
3916,68,16,100,16,200
3918,51,32,199,17,299
3919,117,18,131,17,283
3921,67,33,131,17,248
3924,85,32,66,17,200
3925,82,16,66,17,181
3927,83,15,68,17,183
3928,150,32,71,13,266
3929,83,15,118,20,236
3930,67,15,118,20,220
3931,101,32,71,13,217
3932,65,18,83,20,186
3933,133,38,97,17,285
3934,67,15,71,13,166
3935,85,15,69,17,186
3936,83,38,97,17,235
3937,83,20,97,17,217
3939,102,32,51,15,200
3940,84,32,51,15,182
3941,69,32,51,15,167
3942,83,34,101,13,231
3943,147,19,65,18,249
3945,83,15,102,18,218
3946,66,15,102,18,201
3947,51,15,102,18,186
3949,69,32,95,20,216
3950,65,19,95,20,199
3951,102,28,54,17,201
3952,84,28,54,17,183
3953,65,28,54,17,164
3955,51,10,54,17,132
3956,134,19,66,16,235
3957,62,37,67,16,182
3959,54,17,67,16,154
3961,71,33,67,15,186
3962,117,34,98,19,268
3963,67,33,101,15,216
3964,68,17,101,15,201
3965,66,34,98,19,217
3966,65,18,98,19,200
3967,67,35,63,19,184
3969,69,32,66,15,182
3972,52,31,70,16,169
3974,84,35,81,17,217
3976,51,35,81,17,184
3977,70,30,51,17,168
3978,51,30,51,17,149
3979,100,33,84,20,237
3980,67,18,166,16,267
3981,65,33,84,20,202
3982,65,17,84,20,186
3984,85,34,65,16,200
3986,66,19,65,16,166
3987,68,36,96,16,216
3990,55,29,102,13,199
3991,65,37,65,13,180
3994,52,30,67,16,165
3995,67,35,64,18,184
3997,65,32,67,18,182
3999,83,16,53,12,164
4000,67,16,53,12,148
4001,64,35,99,15,213
4002,135,16,100,17,268
4003,67,30,69,15,181
4004,69,12,69,15,165
4005,84,16,100,17,217
4006,66,16,100,17,199
4008,81,33,66,18,198
4009,69,33,66,18,186
4010,83,33,67,18,201
4011,84,16,67,18,185
4013,66,33,69,15,183
4015,50,16,69,15,150
4020,100,16,99,18,233
4021,69,31,99,18,217
4022,98,17,100,16,231
4024,66,17,100,16,199
4026,68,15,66,16,165
4027,133,34,66,19,252
4029,66,34,134,18,252
4031,66,34,66,19,185
4032,66,18,66,19,169
4033,68,32,68,18,186
4035,85,15,52,15,167
4036,69,15,52,15,151
4038,68,15,167,18,268
4040,117,31,86,14,248
4041,118,15,86,14,233
4042,65,18,65,17,165
4043,68,31,86,14,199
4045,51,15,86,14,166
4046,67,16,52,14,149
4047,82,17,81,19,199
4048,149,34,166,18,367
4049,68,32,101,17,218
4050,50,32,101,17,200
4051,52,14,101,17,184
4052,65,18,67,17,167
4053,81,19,166,18,284
4054,63,19,166,18,266
4055,68,33,116,17,234
4056,52,33,116,17,218
4058,86,34,65,18,203
4060,86,31,69,16,202
4061,68,31,69,16,184
4062,51,31,69,16,167
4063,82,17,167,17,283
4064,83,35,97,19,234
4065,65,35,97,19,216
4066,67,17,97,19,200
4068,68,15,101,17,201
4071,67,30,52,17,166
4072,100,16,66,16,198
4076,68,17,82,17,184
4077,52,17,82,17,168
4079,66,33,133,18,250
4081,65,34,99,18,216
4083,50,17,99,18,184
4085,67,35,66,17,185
4086,68,17,66,17,168
4087,117,17,200,17,351
4089,84,17,200,17,318
4093,72,28,53,15,168
4095,65,34,67,15,181
4096,65,17,67,15,164
4097,81,15,67,17,180
4099,116,19,65,17,217
4100,84,34,65,17,200
4101,118,21,95,16,250
4103,67,38,95,16,216
4104,67,21,95,16,199
4105,72,27,101,17,217
4106,84,36,65,17,202
4107,82,19,65,17,183
4108,65,19,65,17,166
4109,63,32,66,17,178
4110,83,33,67,17,200
4111,68,33,67,17,185
4112,51,33,67,17,168
4113,65,33,51,17,166
4115,83,17,99,17,216
4116,67,17,99,17,200
4117,84,17,65,17,183
4118,67,17,65,17,166
4120,66,18,118,14,216
4122,99,16,53,14,182
4123,98,34,135,17,284
4124,67,16,53,14,150
4126,101,14,102,17,234
4127,67,33,102,17,219
4128,69,14,102,17,202
4129,53,14,102,17,186
4130,65,18,67,17,167
4131,83,19,65,17,184
4132,64,19,65,17,165
4133,102,32,69,16,219
4134,52,33,82,19,186
4135,67,32,69,16,184
4136,52,32,69,16,169
4137,82,17,66,17,182
4138,66,17,66,17,166
4141,50,19,65,15,149
4143,83,17,65,19,184
4145,80,19,67,17,183
4147,83,16,53,16,168
4148,82,36,66,18,202
4149,84,17,66,18,185
4150,103,16,51,15,185
4151,50,17,66,18,151
4154,66,17,65,17,165
4155,66,33,65,18,182
4157,98,33,85,16,232
4159,65,33,85,16,199
4160,64,16,85,16,181
4162,82,34,66,18,200
4163,67,34,66,18,185
4164,66,18,66,18,168
4165,85,16,67,19,187
4166,67,16,67,19,169
4167,51,16,67,19,153
4168,51,33,53,15,152
4169,66,34,118,16,234
4170,83,34,84,16,217
4171,67,34,84,16,201
4174,50,32,52,16,150
4175,66,34,66,18,184
4177,66,34,68,16,184
4179,52,16,68,16,152
4180,50,32,117,18,217
4181,66,36,81,18,201
4183,84,15,68,16,183
4184,67,15,68,16,166
4185,83,18,67,17,185
4187,81,18,99,16,214
4190,52,33,66,16,167
4191,67,32,70,13,182
4192,51,32,70,13,166
4194,83,36,132,15,266
4195,82,20,132,15,249
4196,65,20,132,15,232
4197,70,32,100,15,217
4199,68,34,66,15,183
4200,66,20,66,15,167
4203,66,34,64,18,182
4204,52,34,64,18,168
4205,98,32,68,17,215
4206,65,17,100,17,199
4208,120,31,52,14,217
4209,64,37,83,14,198
4210,67,19,83,14,183
4211,69,31,52,14,166
4213,68,34,116,19,237
4214,84,32,54,30,200
4215,83,14,54,30,181
4217,52,14,54,30,150
4218,81,22,113,18,234
4219,64,22,113,18,217
4221,54,49,64,18,185
4222,117,33,67,17,234
4223,52,19,64,18,153
4225,64,33,67,17,181
4226,83,37,69,30,219
4227,64,37,69,30,200
4228,50,37,69,30,186
4229,70,30,135,14,249
4230,82,39,76,20,217
4231,84,22,76,20,202
4232,66,22,76,20,184
4236,52,32,66,17,167
4237,62,34,66,15,177
4239,98,34,98,18,248
4240,51,32,66,16,165
4243,66,32,66,18,182
4244,52,32,66,18,168
4245,66,34,84,17,201
4246,65,18,84,17,184
4247,66,32,101,19,218
4249,66,33,68,19,186
4250,68,15,68,19,170
4251,65,36,99,17,217
4252,68,17,99,17,201
4253,86,15,67,17,185
4254,68,15,67,17,167
4255,68,32,136,15,251
4256,116,33,68,15,232
4257,51,13,136,15,215
4259,84,16,68,15,183
4260,65,16,68,15,164
4262,96,20,67,16,199
4265,68,31,52,23,174
4267,64,36,66,18,184
4268,87,39,77,19,222
4269,67,39,77,19,202
4270,52,39,77,19,187
4271,52,23,77,19,171
4272,85,32,67,16,200
4274,68,14,67,16,165
4276,153,34,66,17,270
4278,67,14,68,15,164
4280,65,18,66,16,165
4281,98,32,51,15,196
4283,68,32,51,15,166
4284,67,17,51,15,150
4286,66,18,66,18,168
4287,66,32,101,18,217
4288,135,16,100,16,267
4289,51,15,101,18,185
4290,68,16,134,16,234
4293,52,16,100,16,184
4295,85,15,66,18,184
4296,67,15,66,18,166
4297,66,34,66,16,182
4298,67,16,66,16,165
4300,65,16,69,15,165
4301,66,34,67,16,183
4303,82,19,64,18,183
4308,135,17,67,15,234
4309,64,34,168,16,282
4311,101,32,200,16,349
4312,68,17,67,15,167
4315,84,18,100,15,217
4316,117,33,66,16,232
4317,100,33,66,16,215
4318,66,18,67,15,166
4320,51,33,66,16,166
4321,66,34,65,16,181
4323,67,32,100,16,215
4324,52,32,100,16,200
4326,66,17,67,16,166
4327,65,35,64,18,182
4328,101,16,166,17,300
4329,68,32,166,17,283
4331,51,16,166,17,250
4332,51,32,86,16,185
4336,52,31,67,17,167
4337,67,35,132,17,251
4338,68,16,132,17,233
4339,83,15,100,17,215
4340,80,35,117,16,248
4342,116,32,52,16,216
4343,100,32,52,16,200
4345,68,32,52,16,168
4347,65,37,98,15,215
4348,50,37,98,15,200
4349,69,31,266,16,382
4350,84,33,67,16,200
4351,119,16,67,17,219
4354,83,33,67,17,200
4357,67,34,66,15,182
4358,65,18,66,15,164
4360,52,33,67,15,167
4361,67,33,66,16,182
4362,68,16,66,16,166
4363,81,19,99,16,215
4364,64,19,99,16,198
4365,82,17,134,17,250
4366,65,17,134,17,233
4367,82,19,165,17,283
4368,67,19,165,17,268
4370,52,32,67,17,168
4371,67,35,67,15,184
4374,52,32,133,19,236
4376,86,31,86,14,217
4379,66,33,118,16,233
4380,116,33,67,18,234
4381,82,16,84,16,198
4382,67,16,84,16,183
4383,86,14,67,18,185
4385,53,14,67,18,152
4386,66,17,100,17,200
4387,67,33,67,17,184
4389,67,34,66,16,183
4390,84,33,67,17,201
4391,67,33,67,17,184
4392,50,33,67,17,167
4394,98,18,67,17,200
4397,101,33,64,21,219
4398,101,16,64,21,202
4400,69,16,64,21,170
4401,67,33,84,16,200
4404,64,16,53,16,149
4405,85,15,101,15,216
4406,83,33,83,18,217
4407,67,33,83,18,201
4408,52,33,83,18,186
4411,65,36,81,16,198
4412,64,20,81,16,181
4413,68,33,64,19,184
4414,65,18,64,19,166
4415,133,36,64,18,251
4417,81,16,53,13,163
4419,64,36,64,18,182
4420,67,17,64,18,166
4421,67,30,52,15,164
4422,69,13,52,15,149
4424,67,14,84,15,180
4425,64,33,66,17,180
4427,85,16,67,17,185
4428,65,16,67,17,165
4429,67,32,68,17,184
4430,81,35,68,17,201
4431,83,18,68,17,186
4432,83,33,52,17,185
4434,100,18,98,18,234
4435,68,35,98,18,219
4437,68,34,64,18,184
4438,68,17,64,18,167
4439,52,17,64,18,151
4442,81,34,70,32,217
4443,64,34,70,32,200
4444,68,16,70,32,186
4445,65,33,69,14,181
4446,51,33,69,14,167
4448,66,20,64,17,167
4449,50,20,64,17,151
4450,66,18,65,17,166
4451,69,32,66,16,183
4452,84,33,67,16,200
4453,64,33,67,16,180
4454,83,33,102,16,234
4455,65,33,102,16,216
4457,66,34,68,16,184
4458,65,18,68,16,167
4460,82,36,64,17,199
4461,66,36,64,17,183
4465,52,17,65,18,152
4467,64,34,67,16,181
4468,82,33,101,13,229
4469,83,15,101,13,212
4470,67,15,101,13,196
4471,85,16,67,13,181
4472,118,33,84,17,252
4473,83,18,150,15,266
4474,65,18,150,15,248
4475,68,33,84,17,202
4477,67,33,134,17,251
4480,65,17,51,15,148
4481,66,35,66,17,184
4482,71,17,66,17,171
4483,68,31,68,17,184
4484,52,31,68,17,168
4485,86,15,65,18,184
4486,83,33,65,16,197
4487,66,33,65,16,180
4488,67,16,65,16,164
4489,85,15,68,16,184
4490,65,15,68,16,164
4491,98,35,98,19,250
4492,66,15,100,17,198
4493,100,34,64,19,217
4495,68,34,64,19,185
4497,51,18,64,19,152
4498,53,31,52,15,151
4499,65,33,68,16,182
4500,66,16,68,16,166
4501,83,15,67,16,181
4502,69,15,67,16,167
4503,52,15,67,16,150
4504,50,34,99,16,199
4505,84,17,119,16,236
4506,65,17,119,16,217
4507,67,35,84,16,202
4508,65,19,84,16,184
4509,68,31,69,16,184
4510,52,31,69,16,168
4512,66,18,100,16,200
4513,65,35,65,16,181
4517,116,17,167,17,317
4518,134,18,62,18,232
4520,65,17,167,17,266
4521,87,18,62,18,185
4522,87,29,67,16,199
4523,71,29,67,16,183
4524,55,29,67,16,167
4525,85,15,67,17,184
4526,80,34,99,17,230
4527,62,34,99,17,212
4528,67,16,99,17,199
4530,65,17,66,17,165
4533,50,17,67,17,151
4536,66,18,99,16,199
4538,67,15,67,16,165
4540,83,34,66,19,202
4542,82,34,66,17,199
4543,83,18,66,17,184
4545,85,15,135,15,250
4546,68,15,135,15,233
4547,85,15,51,16,167
4548,69,15,51,16,151
4549,83,18,66,15,182
4550,100,16,66,18,200
4551,117,18,99,19,253
4552,66,16,66,18,166
4553,51,16,66,18,151
4554,84,32,67,19,202
4555,66,32,67,19,184
4556,65,17,67,19,168
4557,66,34,66,17,183
4559,66,33,68,16,183
4560,67,17,68,16,168
4561,86,14,51,17,168
4562,99,18,65,16,198
4565,68,33,66,16,183
4566,82,32,101,15,230
4567,68,32,101,15,216
4568,51,32,101,15,199
4569,81,18,133,17,249
4571,82,18,66,17,183
4572,64,18,66,17,165
4573,50,18,66,17,151
4574,52,33,99,18,202
4575,67,33,101,19,220
4576,66,18,101,19,204
4577,66,33,87,29,215
4578,83,33,54,29,199
4581,66,35,65,17,183
4582,67,17,65,17,166
4583,68,19,63,18,168
4584,51,19,63,18,151
4585,100,35,66,17,218
4587,65,35,66,17,183
4588,81,32,68,16,197
4589,69,32,68,16,185
4590,52,32,68,16,168
4591,135,33,67,15,250
4593,66,34,100,15,215
4594,68,17,100,15,200
4595,68,33,67,15,183
4596,101,18,117,15,251
4597,83,18,117,15,233
4599,67,33,65,19,184
4601,67,31,102,16,216
4603,64,34,101,16,215
4605,65,34,67,16,182
4606,69,15,67,16,167
4607,118,17,67,16,218
4608,101,17,67,16,201
4609,68,33,67,16,184
4610,65,17,67,16,165
4611,67,34,100,16,217
4612,64,18,100,16,198
4613,67,33,67,16,183
4614,68,16,67,16,167
4615,51,16,67,16,150
4616,51,33,101,17,202
4621,66,35,98,18,217
4623,67,31,67,18,183
4624,99,17,51,17,184
4625,83,17,51,17,168
4628,81,35,66,17,199
4629,67,35,66,17,185
4630,68,17,66,17,168
4631,134,33,100,17,284
4632,83,34,67,16,200
4633,84,17,67,16,184
4634,100,16,100,17,233
4635,66,33,100,17,216
4636,66,16,100,17,199
4638,66,18,333,15,432
4641,83,17,66,17,183
4642,101,16,101,16,234
4644,67,16,101,16,200
4645,80,16,68,16,180
4646,67,16,68,16,167
4647,83,17,100,18,218
4648,66,17,100,18,201
4649,67,34,66,18,185
4650,100,17,51,16,184
4652,67,17,51,16,151
4653,84,16,67,15,182
4654,84,34,151,15,284
4656,68,16,151,15,250
4657,84,16,118,15,233
4658,67,16,118,15,216
4659,82,19,84,15,200
4660,64,19,84,15,182
4662,67,15,67,17,166
4663,84,16,66,17,183
4664,69,16,66,17,168
4666,99,16,68,16,199
4667,52,15,101,16,184
4668,82,36,64,18,200
4669,66,36,64,18,184
4670,65,19,64,18,166
4671,69,32,65,18,184
4673,68,32,51,16,167
4674,51,32,51,16,150
4675,64,33,67,17,181
4676,67,15,67,17,166
4677,65,34,65,19,183
4678,67,16,65,19,167
4679,51,16,65,19,151
4680,66,16,101,16,199
4682,66,15,136,16,233
4683,65,35,101,16,217
4684,215,34,51,17,317
4686,68,16,67,16,167
4687,69,34,64,19,186
4688,84,33,116,17,250
4689,101,31,68,17,217
4690,83,31,68,17,199
4691,67,31,68,17,183
4692,51,31,68,17,167
4694,67,15,51,17,150
4695,50,15,51,17,133
4696,83,34,66,16,199
4697,85,17,66,16,184
4698,66,17,66,16,165
4701,66,34,67,17,184
4702,83,33,51,16,183
4703,66,33,51,16,166
4704,83,34,99,17,233
4705,67,34,99,17,217
4708,51,33,99,18,201
4710,66,17,66,18,167
4711,66,33,51,17,167
4714,50,33,200,18,301
4716,85,35,65,18,203
4718,86,32,98,18,234
4719,70,32,98,18,218
4721,67,33,65,18,183
4723,65,32,51,17,165
4724,50,32,51,17,150
4725,51,14,51,17,133
4726,81,35,132,18,266
4727,65,35,132,18,250
4728,65,17,132,18,232
4729,51,17,132,18,218
4731,67,34,84,17,202
4732,99,17,68,16,200
4733,66,33,68,16,183
4735,84,16,67,18,185
4737,66,35,135,15,251
4741,51,16,67,17,151
4742,67,15,70,15,167
4743,65,34,67,16,182
4745,51,16,67,16,150
4750,82,34,99,17,232
4753,66,34,65,17,182
4754,67,17,65,17,166
4759,65,35,66,17,183
4760,100,17,67,17,201
4761,67,33,67,17,184
4762,83,33,199,18,333
4763,68,33,199,18,318
4766,101,16,100,16,233
4768,67,16,100,16,199
4770,99,19,98,17,233
4771,82,19,98,17,216
4772,84,32,66,17,199
4773,68,32,66,17,183
4774,52,32,66,17,167
4775,83,16,51,17,167
4776,83,34,67,16,200
4777,82,16,67,16,181
4778,82,34,68,15,199
4779,66,34,68,15,183
4780,67,17,68,15,167
4783,67,35,133,15,250
4784,66,19,133,15,233
4785,83,16,102,15,216
4787,82,18,68,15,183
4788,66,18,68,15,167
4789,65,33,68,16,182
4791,102,33,67,16,218
4792,51,35,65,18,169
4793,68,33,67,16,184
4794,64,18,67,16,165
4795,84,16,68,15,183
4796,67,16,68,15,166
4797,65,35,65,18,183
4799,83,17,67,15,182
4804,84,32,50,16,182
4805,67,32,50,16,165
4806,52,32,50,16,150
4808,66,17,67,16,166
4810,67,16,135,16,234
4811,50,16,135,16,217
4814,51,33,83,16,183
4815,84,16,51,16,167
4816,100,17,83,15,215
4818,100,16,100,18,234
4820,67,16,100,18,201
4821,51,16,100,18,185
4823,98,34,84,18,234
4825,83,17,84,18,202
4826,65,17,84,18,184
4827,84,15,69,16,184
4828,67,15,69,16,167
4829,52,15,69,16,152
4831,84,18,65,16,183
4833,69,31,85,17,202
4834,115,35,83,16,249
4835,50,15,85,17,167
4836,67,16,118,16,217
4837,65,35,83,16,199
4838,65,19,83,16,183
4840,67,17,84,14,182
4841,68,31,53,14,166
4842,52,31,53,14,150
4845,84,14,102,17,217
4847,53,14,102,17,186
4849,101,33,133,16,283
4850,83,33,133,16,265
4853,67,34,132,15,248
4855,132,34,67,16,249
4856,52,31,68,16,167
4857,81,18,101,16,216
4859,65,34,67,16,182
4861,68,33,67,17,185
4862,52,33,67,17,169
4864,65,19,66,16,166
4867,67,33,67,17,184
4868,52,33,67,17,169
4870,66,17,51,16,150
4871,82,18,84,17,201
4872,65,18,84,17,184
4873,84,16,150,15,265
4874,68,16,150,15,249
4877,66,35,64,18,183
4881,66,33,69,16,184
4882,99,15,52,16,182
4883,82,15,52,16,165
4884,67,15,52,16,150
4885,84,18,64,18,184
4887,69,32,68,16,185
4888,67,16,68,16,167
4889,52,16,68,16,152
4890,100,18,82,17,217
4892,84,31,68,16,199
4893,68,31,68,16,183
4894,66,15,68,16,165
4895,52,15,68,16,151
4896,66,18,66,17,167
4898,83,33,133,18,267
4899,68,33,133,18,252
4900,51,33,133,18,235
4902,117,33,51,15,216
4903,70,30,84,15,199
4904,54,30,84,15,183
4906,83,33,67,17,200
4907,63,33,67,17,180
4909,50,16,67,17,150
4911,51,15,67,16,149
4912,83,33,67,18,201
4913,84,16,67,18,185
4914,66,16,67,18,167
4915,102,32,133,16,283
4917,118,14,69,15,216
4918,65,18,133,16,232
4919,67,32,69,15,183
4920,69,14,69,15,167
4921,64,35,100,15,214
4922,68,17,100,15,200
4923,101,32,67,17,217
4924,64,19,150,17,250
4925,69,32,67,17,185
4927,66,34,65,19,184
4930,51,33,51,17,152
4931,67,32,117,18,234
4932,83,36,81,18,218
4933,65,36,81,18,200
4934,69,17,81,18,185
4935,51,17,81,18,167
4937,68,33,52,14,167
4939,65,34,67,18,184
4940,84,32,118,15,249
4942,69,14,118,15,216
4943,52,14,118,15,199
4945,85,14,66,19,184
4946,67,14,66,19,166
4949,65,33,68,16,182
4951,66,34,67,17,184
4952,68,15,67,17,167
4954,65,18,99,17,199
4955,84,17,99,17,217
4956,82,33,66,17,198
4957,100,33,167,17,317
4958,84,33,167,17,301
4960,67,16,167,17,267
4962,99,19,66,17,201
4964,66,19,66,17,168
4965,50,19,66,17,152
4966,52,33,65,17,167
4967,69,33,65,19,186
4968,52,33,65,19,169
4969,83,15,52,15,165
4970,115,34,66,17,232
4972,66,16,69,14,165
4973,65,34,66,17,182
4974,67,15,66,17,165
4976,85,31,67,17,200
4977,69,31,67,17,184
4978,64,17,67,17,165
4980,65,18,165,17,265
4981,66,32,84,18,200
4982,67,17,84,18,186
4985,116,18,98,18,250
4987,67,35,98,18,218
4988,85,31,67,18,201
4989,115,18,68,15,216
4992,84,32,68,16,200
4996,86,32,235,15,368
4997,68,32,235,15,350
4998,52,32,235,15,334
4999,51,17,235,15,318
5000,66,18,66,15,165
5001,66,32,134,15,247
5002,51,32,134,15,232
5004,67,17,135,15,234
5006,51,32,103,15,201
5007,66,33,101,17,217
5010,85,35,64,18,202
5011,185,15,69,14,283
5013,70,31,51,15,167
5014,52,31,51,15,149
5018,67,15,69,14,165
5019,51,15,69,14,149
5020,67,15,69,15,166
5021,66,36,98,17,217
5022,84,33,65,17,199
5024,51,33,65,17,166
5025,69,32,50,17,168
5026,52,32,50,17,151
5027,65,33,101,17,216
5029,65,34,84,15,198
5032,50,33,51,15,149
5034,67,17,82,16,182
5035,84,15,66,19,184
5036,68,15,66,19,168
5038,66,18,166,15,265
5039,82,16,68,16,182
5040,65,16,68,16,165
5041,85,16,66,17,184
5042,68,16,66,17,167
5043,66,33,67,15,181
5044,68,16,67,15,166
5045,118,17,133,18,286
5048,66,17,133,18,234
5049,50,17,133,18,218
5050,66,20,64,18,168
5053,67,32,100,18,217
5054,84,34,66,18,202
5055,64,34,66,18,182
5056,66,16,66,18,166
5060,66,16,68,16,166
5061,66,35,100,16,217
5062,66,17,100,16,199
5064,51,33,83,17,184
5065,53,15,83,17,168
5066,66,16,51,17,150
5067,100,33,99,16,248
5068,82,33,99,16,230
5070,51,33,99,16,199
5073,83,17,99,18,217
5076,65,17,67,18,167
5077,66,34,66,18,184
5078,83,33,51,17,184
5079,66,33,51,17,167
5082,69,15,68,16,168
5083,84,17,64,17,182
5084,68,17,64,17,166
5085,51,17,64,17,149
5086,50,33,98,18,199
5087,68,31,67,18,184
5088,50,31,67,18,166
5095,51,16,68,15,150
5096,65,17,68,17,167
5098,66,18,65,17,166
5099,68,33,117,15,233
5102,100,16,134,18,268
5103,65,33,134,18,250
5104,83,35,99,18,235
5105,65,35,99,18,217
5108,68,15,67,18,168
5109,67,31,54,15,167
5110,68,13,54,15,150
5112,65,17,133,18,233
5114,101,15,66,18,200
5115,54,15,67,16,152
5116,69,15,66,18,168
5119,83,17,51,17,168
5120,99,17,83,15,214
5121,66,35,83,15,199
5122,100,17,65,19,201
5123,118,16,99,18,251
5124,68,17,65,19,169
5125,51,17,65,19,152
5126,67,16,99,18,200
5127,66,32,67,18,183
5128,67,15,67,18,167
5129,65,36,65,15,181
5131,51,17,65,15,148
5132,82,34,134,17,267
5137,49,19,67,15,150
5138,66,17,133,18,234
5139,84,17,66,17,184
5140,86,33,66,18,203
5141,67,33,66,18,184
5144,83,33,84,17,217
5145,66,33,84,17,200
5146,102,15,68,14,199
5148,67,15,68,14,164
5149,51,15,68,14,148
5150,65,19,131,18,233
5151,101,31,67,18,217
5152,83,31,67,18,199
5153,68,31,67,18,184
5154,83,34,67,18,202
5157,65,33,135,16,249
5158,70,14,135,16,235
5159,53,14,135,16,218
5160,83,34,67,16,200
5161,67,34,67,16,184
5162,98,18,67,16,199
5163,52,16,67,16,151
5164,66,18,67,16,167
5165,68,33,65,18,184
5167,83,18,83,15,199
5168,67,18,83,15,183
5169,132,33,118,16,299
5172,67,16,67,19,169
5176,67,16,84,16,183
5177,67,33,252,15,367
5178,68,14,252,15,349
5179,82,20,64,18,184
5181,68,32,166,19,285
5182,65,16,166,19,266
5183,67,32,53,16,168
5184,52,32,53,16,153
5185,64,35,99,19,217
5187,67,34,65,19,185
5188,69,16,65,19,169
5190,83,33,201,17,334
5191,66,33,201,17,317
5192,64,17,201,17,299
5193,84,15,100,18,217
5196,67,18,66,18,169
5197,68,32,118,15,233
5198,68,13,118,15,214
5199,66,34,67,17,184
5201,66,32,52,15,165
5202,65,14,52,15,146
5203,84,17,51,15,167
5205,84,15,67,17,183
5206,66,15,67,17,165
5207,52,15,67,17,151
5208,68,15,84,16,183
5209,51,15,84,16,166
5210,99,17,84,15,215
5211,67,34,84,15,200
5212,82,33,66,19,200
5215,51,16,66,19,152
5218,82,34,67,15,198
5219,85,15,67,15,182
5220,67,15,67,15,164
5221,84,16,99,18,217
5222,67,16,99,18,200
5223,68,33,84,15,200
5224,65,17,84,15,181
5225,98,35,68,16,217
5227,82,17,68,16,183
5230,69,15,100,19,203
5232,136,14,67,16,233
5233,84,15,134,18,251
5237,84,17,64,18,183
5239,53,17,64,18,152
5240,97,17,83,17,214
5241,67,33,83,17,200
5242,81,34,66,17,198
5244,50,34,66,17,167
5245,67,34,66,17,184
5246,85,32,136,14,267
5247,100,34,102,14,250
5248,65,17,136,14,232
5249,66,34,102,14,216
5251,83,16,100,16,215
5252,68,16,100,16,200
5253,84,17,200,18,319
5254,84,35,82,17,218
5256,50,35,82,17,184
5257,69,31,68,16,184
5258,83,34,67,15,199
5259,66,34,67,15,182
5260,67,18,67,15,167
5261,82,17,66,18,183
5262,101,17,116,18,252
5263,68,33,116,18,235
5266,65,18,83,18,184
5267,66,34,67,16,183
5268,50,34,67,16,167
5269,51,16,67,16,150
5271,66,35,65,19,185
5272,83,34,65,18,200
5273,101,31,52,16,200
5274,52,34,65,18,169
5275,69,31,52,16,168
5279,65,34,134,16,249
5280,67,16,134,16,233
5281,52,16,134,16,218
5285,65,33,135,16,249
5286,102,17,99,16,234
5287,51,14,135,16,216
5288,84,31,68,16,199
5289,69,31,68,16,184
5291,52,15,68,16,151
5292,66,16,168,15,265
5293,81,18,66,17,182
5295,68,34,65,18,185
5297,83,17,68,15,183
5298,67,17,68,15,167
5299,117,17,98,17,249
5302,68,17,98,17,200
5303,83,16,67,17,183
5304,66,16,67,17,166
5305,116,17,66,17,216
5306,83,32,66,17,198
5307,66,32,66,17,181
5308,66,17,66,17,166
5314,66,18,66,16,166
5315,67,32,70,13,182
5316,66,16,70,13,165
5317,51,16,70,13,150
5318,67,17,100,17,201
5319,66,36,64,17,183
5321,70,30,120,17,237
5322,53,30,120,17,220
5323,66,34,67,19,186
5324,70,14,67,19,170
5325,64,35,99,15,213
5327,69,32,67,15,183
5329,67,36,140,26,269
5331,51,17,140,26,234
5332,53,31,109,26,219
5333,67,35,74,26,202
5334,63,20,74,26,183
5338,53,41,74,16,184
5339,74,26,64,19,183
5340,59,26,64,19,168
5342,52,30,153,15,250
5343,56,34,52,15,157
5345,64,35,84,15,198
5346,68,16,84,15,183
5347,53,16,84,15,168
5349,85,16,67,17,185
5350,66,16,67,17,166
5351,84,15,118,17,234
5353,52,15,118,17,202
5354,83,32,52,17,184
5355,67,32,52,17,168
5356,66,15,52,17,150
5357,66,33,84,18,201
5358,66,16,84,18,184
5359,65,36,66,15,182
5360,67,17,66,15,165
5361,52,17,66,15,150
5362,52,31,118,15,216
5363,67,35,83,15,200
5365,66,32,66,17,181
5367,84,17,65,19,185
5368,67,17,65,19,168
5369,66,32,202,15,315
5370,116,36,57,24,233
5371,51,15,202,15,283
5373,158,40,101,17,316
5374,100,16,65,17,198
5375,85,16,65,17,183
5376,52,32,65,17,166
5378,74,40,101,17,232
5380,98,19,65,17,199
5381,82,19,65,17,183
5383,67,32,135,16,250
5384,67,17,135,16,235
5385,68,33,67,19,187
5387,82,18,100,17,217
5388,67,18,100,17,202
5390,67,16,100,18,201
5391,102,33,82,16,233
5394,67,17,82,16,182
5395,85,15,100,16,216
5397,65,33,67,16,181
5399,82,16,68,17,183
5401,50,16,68,17,151
5403,118,15,202,17,352
5406,82,35,66,18,201
5407,84,17,66,18,185
5408,68,17,66,18,169
5409,84,17,66,17,184
5412,68,15,66,17,166
5413,66,34,67,17,184
5414,49,34,67,17,167
5415,66,32,69,15,182
5416,66,15,69,15,165
5417,66,35,66,18,185
5418,65,18,66,18,167
5421,69,32,51,17,169
5422,67,17,51,17,152
5423,66,33,67,17,183
5424,67,15,67,17,166
5427,51,17,64,17,149
5428,99,15,68,17,199
5429,67,32,68,17,184
5432,66,17,67,18,168
5433,66,34,51,15,166
5434,66,17,51,15,149
5435,51,17,51,15,134
5437,51,16,68,16,151
5438,68,15,100,18,201
5439,51,15,100,18,184
5440,67,17,98,17,199
5441,68,31,67,17,183
5443,51,15,67,17,150
5444,66,16,68,15,165
5446,67,15,69,16,167
5447,67,35,65,18,185
5448,66,18,65,18,167
5449,68,34,131,18,251
5450,65,19,131,18,233
5451,69,31,168,16,284
5452,83,35,65,18,201
5453,100,32,51,17,200
5454,50,35,65,18,168
5455,83,15,51,17,166
5456,115,35,66,16,232
5457,52,15,51,17,135
5458,67,15,68,16,166
5459,116,17,67,18,218
5460,66,17,66,16,165
5461,51,17,66,16,150
5462,66,17,67,18,168
5463,68,33,101,14,216
5464,99,18,67,14,198
5465,66,34,67,14,181
5466,84,34,82,18,218
5468,69,16,82,18,185
5469,52,16,82,18,168
5470,67,18,167,15,267
5471,67,32,67,17,183
5472,63,18,67,17,165
5475,67,32,68,15,182
5476,53,32,68,15,168
5477,100,35,65,16,216
5478,67,16,66,17,166
5479,65,35,65,16,181
5480,86,31,135,15,267
5482,51,31,135,15,232
5483,66,34,166,18,284
5484,66,17,166,18,267
5485,65,34,67,15,181
5487,68,33,67,15,183
5489,101,33,67,17,218
5490,51,34,100,17,202
5491,67,33,67,17,184
5492,99,17,118,17,251
5493,82,17,118,17,234
5494,65,17,118,17,217
5495,83,17,83,17,200
5497,67,31,69,16,183
5498,52,31,69,16,168
5500,100,17,65,18,200
5502,66,17,65,18,166
5503,69,33,234,17,353
5504,67,17,234,17,335
5505,84,15,101,16,216
5506,100,16,233,17,366
5507,83,16,233,17,349
5508,67,16,233,17,333
5511,101,33,68,17,219
5512,66,17,101,17,201
5513,67,33,68,17,185
5514,67,17,68,17,169
5518,67,18,65,17,167
5519,68,33,83,16,200
5520,83,32,101,17,233
5522,83,34,84,15,216
5523,82,17,84,15,198
5524,82,33,51,15,181
5526,66,16,51,15,148
5531,51,15,67,18,151
5533,66,33,68,15,182
5534,66,16,68,15,165
5535,67,35,65,18,185
5536,49,35,65,18,167
5537,85,16,66,16,183
5538,68,16,66,16,166
5539,68,32,67,18,185
5540,50,32,67,18,167
5541,65,34,51,15,165
5543,66,33,84,17,200
5544,84,33,68,15,200
5547,51,15,68,15,149
5548,101,17,66,17,201
5551,83,22,79,19,203
5553,70,29,69,14,182
5555,66,32,136,17,251
5556,51,32,136,17,236
5557,61,37,99,17,214
5558,65,19,99,17,200
5559,69,31,68,17,185
5560,52,31,68,17,168
5561,51,17,68,17,153
5562,84,34,67,15,200
5563,65,34,67,15,181
5564,85,33,66,17,201
5567,51,16,66,17,150
5568,84,32,50,16,182
5570,132,16,101,17,266
5572,66,15,84,17,182
5573,82,16,101,17,216
5575,50,16,101,17,184
5576,66,16,100,19,201
5579,85,16,150,17,268
5580,68,16,150,17,251
5581,68,32,52,14,166
5582,83,35,83,17,218
5583,66,35,83,17,201
5584,83,31,85,18,217
5592,66,18,65,16,165
5594,84,32,100,18,234
5595,84,15,100,18,217
5596,68,15,100,18,201
5598,66,17,67,18,168
5599,65,36,148,18,267
5600,66,18,148,18,250
5601,69,31,66,18,184
5602,53,31,66,18,168
5603,67,33,68,16,184
5604,67,15,68,16,166
5605,64,33,51,18,166
5609,68,34,66,16,184
5610,67,18,66,16,167
5611,69,34,82,15,200
5613,68,32,100,16,216
5614,52,32,100,16,200
5615,99,32,135,17,283
5616,67,17,67,16,167
5617,65,32,135,17,249
5618,68,15,135,17,235
5619,65,35,100,17,217
5620,84,33,67,17,201
5621,67,33,67,17,184
5622,66,17,67,17,167
5623,68,34,201,15,318
5625,67,33,66,16,182
5626,84,33,66,17,200
5627,67,33,66,17,183
5628,68,16,66,17,167
5629,50,16,66,17,149
5630,68,14,102,15,199
5631,82,17,69,15,183
5632,65,17,69,15,166
5633,66,35,67,15,183
5634,64,18,67,15,164
5635,68,34,66,14,182
5637,69,33,66,17,185
5638,85,33,50,16,184
5639,67,33,50,16,166
5640,85,33,65,16,199
5641,66,33,65,16,180
5642,84,33,65,18,200
5643,83,16,65,18,182
5644,84,32,68,16,200
5645,66,32,68,16,182
5646,52,32,68,16,168
5647,65,33,66,19,183
5648,99,17,65,19,200
5650,68,17,65,19,169
5651,68,31,69,18,186
5652,68,15,69,18,170
5653,66,34,53,14,167
5654,82,35,65,19,201
5655,100,32,100,19,251
5656,68,16,65,19,168
5659,53,14,100,19,186
5661,65,34,133,17,249
5663,82,18,69,15,184
5664,63,18,69,15,165
5666,67,14,67,17,165
5667,52,14,67,17,150
5668,51,36,65,19,171
5669,51,18,65,19,153
5671,84,17,66,18,185
5673,65,32,52,15,164
5674,69,13,52,15,149
5675,53,13,52,15,133
5677,84,15,68,17,184
5678,65,15,68,17,165
5679,103,32,66,17,218
5680,67,19,98,17,201
5682,67,16,66,17,166
5684,84,33,67,17,201
5686,65,17,67,17,166
5687,66,36,66,14,182
5689,50,19,66,14,149
5690,101,18,66,17,202
5691,67,35,66,17,185
5692,99,18,51,14,182
5693,66,32,51,14,163
5695,67,34,84,14,199
5697,66,31,53,14,164
5698,69,14,53,14,150
5700,82,33,52,14,181
5701,65,33,52,14,164
5702,67,14,52,14,147
5703,53,14,52,14,133
5706,66,14,68,18,166
5707,52,14,68,18,152
5708,117,33,67,16,233
5710,66,16,100,16,198
5711,68,33,67,16,184
5712,67,15,67,16,165
5715,68,32,67,16,183
5716,65,17,67,16,165
5717,67,33,116,19,235
5718,99,17,82,19,217
5721,67,33,132,19,251
5723,50,17,132,19,218
5724,67,18,64,17,166
5726,66,19,83,18,186
5727,68,31,52,18,169
5728,51,31,52,18,152
5730,83,37,82,17,219
5731,83,18,82,17,200
5733,52,18,82,17,169
5734,53,30,134,19,236
5736,83,34,84,17,218
5737,65,34,84,17,200
5739,52,17,84,17,170
5741,83,16,99,18,216
5742,82,36,63,18,199
5743,65,36,63,18,182
5744,69,17,63,18,167
5745,69,33,66,16,184
5747,69,30,102,16,217
5748,64,16,102,16,198
5749,63,36,66,16,181
5750,102,17,67,16,202
5751,82,17,67,16,182
5752,85,33,99,17,234
5753,69,33,99,17,218
5754,67,17,99,17,200
5755,82,18,65,17,182
5758,51,33,66,15,165
5759,67,32,168,14,281
5760,68,15,168,14,265
5761,65,34,67,16,182
5762,66,17,67,16,166
5763,66,33,166,17,282
5765,67,34,67,14,182
5766,65,19,67,14,165
5767,67,34,98,17,216
5769,68,33,65,17,183
5770,53,33,65,17,168
5771,67,34,65,17,183
5772,65,20,65,17,167
5773,82,16,67,16,181
5774,83,34,101,16,234
5775,65,34,101,16,216
5776,85,33,68,16,202
5777,82,16,68,16,182
5778,83,33,66,17,199
5779,118,17,165,17,317
5781,66,35,165,17,283
5782,67,17,165,17,266
5783,116,17,68,15,216
5784,52,31,102,15,200
5785,100,34,66,17,217
5786,99,17,66,17,199
5788,83,34,66,16,199
5789,68,34,66,16,184
5790,85,32,101,15,233
5791,117,17,67,15,216
5793,66,34,67,15,182
5794,66,17,67,15,165
5795,66,34,65,17,182
5796,67,18,65,17,167
5797,68,33,187,29,317
5798,51,33,187,29,300
5799,67,32,135,20,254
5803,83,17,67,20,187
5804,68,17,67,20,172
5805,51,17,67,20,155
5806,67,17,54,29,167
5807,66,34,66,17,183
5809,87,46,66,17,216
5813,83,17,66,17,183
5814,63,17,66,17,163
5815,67,32,51,16,166
5816,83,34,84,16,217
5817,117,16,100,17,250
5819,66,33,100,17,216
5820,67,16,100,17,200
5821,51,16,100,17,184
5825,51,16,235,14,316
5826,68,16,101,17,202
5827,65,34,67,17,183
5828,66,17,67,17,167
5832,84,33,166,18,301
5833,100,33,67,17,217
5834,68,16,166,18,268
5835,66,33,67,17,183
5836,52,33,67,17,169
5838,65,19,65,16,165
5840,66,18,66,18,168
5841,67,33,51,15,166
5842,51,33,51,15,150
5844,67,17,168,15,267
5847,102,31,68,15,216
5848,86,31,68,15,200
5849,69,31,68,15,183
5850,51,31,68,15,165
5852,67,17,101,17,202
5853,82,17,66,17,182
5854,85,32,133,17,267
5855,68,32,133,17,250
5856,84,34,67,15,200
5857,67,34,67,15,183
5859,66,33,66,17,182
5860,51,33,66,17,167
5862,67,17,66,16,166
5863,82,17,67,18,184
5864,65,17,67,18,167
5865,83,17,66,17,183
5866,66,17,66,17,166
5867,66,33,67,17,183
5868,51,33,67,17,168
5869,100,34,67,17,218
5870,83,34,67,17,201
5871,66,34,67,17,184
5872,67,17,67,17,168
5873,84,17,134,15,250
5874,66,17,134,15,232
5875,84,17,65,19,185
5876,67,17,65,19,168
5877,67,33,68,15,183
5880,66,16,68,18,168
5881,65,36,65,19,185
5882,67,17,65,19,168
5884,102,15,134,17,268
5885,68,33,134,17,252
5887,65,33,67,16,181
5888,69,14,67,16,166
5890,98,17,134,17,266
5892,64,17,134,17,232
5895,84,17,66,17,184
5896,51,34,66,17,168
5897,68,33,65,17,183
5898,68,17,65,17,167
5899,82,18,100,16,216
5900,65,18,100,16,199
5901,66,32,68,16,182
5902,67,15,68,16,166
5903,65,34,100,17,216
5904,67,17,100,17,201
5906,83,34,100,17,234
5908,85,32,85,15,217
5909,68,32,85,15,200
5910,101,17,51,15,184
5911,66,34,51,15,166
5915,68,32,101,17,218
5916,83,34,67,17,201
5917,51,15,101,17,184
5918,51,34,67,17,169
5919,82,16,52,15,165
5920,65,16,52,15,148
5921,84,17,65,17,183
5922,83,32,100,16,231
5923,84,15,100,16,215
5924,68,15,100,16,199
5925,52,15,100,16,183
5927,82,17,66,17,182
5928,82,33,68,17,200
5930,83,33,52,16,184
5931,67,33,52,16,168
5932,66,17,52,16,151
5934,66,18,216,17,317
5935,85,16,65,18,184
5937,52,16,65,18,151
5939,68,30,118,17,233
5941,101,32,101,15,249
5942,85,32,101,15,233
5943,82,16,101,15,214
5944,66,16,101,15,198
5945,52,16,101,15,184
5946,84,33,67,16,200
5947,66,33,67,16,182
5948,66,17,67,16,166
5949,67,34,66,18,185
5950,51,34,66,18,169
5951,67,33,65,18,183
5953,67,33,99,18,217
5954,51,33,99,18,201
5955,66,32,101,18,217
5956,51,32,101,18,202
5958,67,16,134,20,237
5960,81,34,87,30,232
5962,83,34,100,16,233
5963,67,34,100,16,217
5965,83,18,67,16,184
5966,83,20,130,16,249
5967,87,47,99,17,250
5970,68,17,99,17,201
5971,67,33,98,19,217
5972,63,17,98,19,197
5973,64,33,65,19,181
5974,50,33,65,19,167
5975,83,16,83,17,199
5977,66,32,68,16,182
5978,50,32,68,16,166
5979,65,35,68,14,182
5980,67,16,68,14,165
5981,51,16,68,14,149
5982,66,17,100,16,199
5983,51,17,100,16,184
5984,84,31,201,18,334
5988,100,18,67,17,202
5990,85,34,65,17,201
5991,102,33,66,18,219
5992,51,34,65,17,167
5995,67,32,100,16,215
5998,83,34,99,16,232
