序号,发送->接收,接收->转发,转发->接收,接收->处理,总计
1,163,34,97,19,313
2,58,34,97,19,208
3,84,31,66,19,200
5,52,31,66,19,168
6,116,15,84,18,233
7,66,18,51,16,151
9,67,15,84,18,184
11,69,16,67,16,168
12,51,16,67,16,150
13,83,34,66,16,199
14,68,34,66,16,184
15,65,18,66,16,165
16,83,18,299,16,416
17,86,32,133,16,267
18,68,32,133,16,249
19,84,35,66,17,202
22,67,33,65,16,181
23,51,33,65,16,165
24,68,33,132,17,250
25,102,15,67,17,201
26,66,32,67,17,182
27,66,15,67,17,165
30,65,34,99,18,216
33,68,16,66,18,168
34,101,32,119,17,269
35,66,17,151,17,251
37,66,16,119,17,218
39,84,33,68,14,199
40,67,33,68,14,182
43,68,16,100,16,200
44,84,17,100,15,216
45,68,17,100,15,200
46,118,16,66,17,217
47,50,31,101,17,199
49,83,34,131,18,266
51,68,18,131,18,235
52,51,18,131,18,218
53,50,32,299,17,398
54,66,32,185,16,299
56,64,34,100,17,215
58,83,16,67,17,183
60,67,34,65,19,185
61,68,16,65,19,168
62,117,15,101,17,250
63,50,33,133,17,233
64,84,15,101,17,217
65,66,15,101,17,199
67,68,16,133,16,233
68,51,16,133,16,216
69,50,33,68,15,166
70,68,33,67,16,184
71,82,35,67,16,200
72,66,35,67,16,184
73,66,18,67,16,167
75,134,16,68,14,232
76,67,35,100,14,216
77,66,19,100,14,199
79,52,32,68,14,166
81,51,33,66,17,167
82,65,35,83,17,200
83,65,19,83,17,184
84,68,31,52,17,168
88,66,34,65,17,182
89,52,34,65,17,168
90,52,17,65,17,151
92,67,32,67,17,183
93,66,16,67,17,166
94,65,34,100,17,216
96,66,33,67,17,183
97,100,17,133,17,267
98,84,17,133,17,251
100,117,15,101,17,250
101,65,18,67,15,165
102,67,32,101,17,217
103,67,15,101,17,200
104,50,15,101,17,183
105,68,17,66,17,168
106,67,33,50,17,167
108,68,33,66,18,185
109,67,16,66,18,167
111,51,34,66,18,169
112,50,17,66,18,151
113,116,33,67,17,233
114,118,15,67,17,217
115,67,16,68,15,166
116,66,33,67,17,183
117,67,15,67,17,166
118,52,15,67,17,151
120,68,32,51,16,167
122,67,34,67,16,184
124,66,33,50,17,166
125,68,16,50,17,151
126,84,17,100,17,218
128,67,33,67,17,184
129,50,33,67,17,167
130,83,16,52,15,166
131,66,16,52,15,149
132,65,35,66,16,182
134,67,32,100,17,216
135,51,32,100,17,200
136,52,15,100,17,184
138,66,32,134,17,249
140,66,34,66,17,183
142,83,16,217,17,333
143,67,16,217,17,317
144,51,16,217,17,301
146,83,17,68,17,185
148,50,17,68,17,152
149,117,33,49,17,216
151,51,34,66,16,167
152,68,33,49,17,167
153,117,33,66,17,233
154,51,16,49,17,133
157,82,32,68,17,199
158,49,17,66,17,149
159,49,32,68,17,166
160,84,15,51,18,168
161,68,15,51,18,152
162,66,34,218,17,335
163,86,35,99,17,237
164,68,35,99,17,219
165,84,32,84,15,215
166,69,32,84,15,200
168,84,16,51,15,166
169,67,16,51,15,149
170,65,34,84,17,200
171,67,17,84,17,185
172,67,32,69,16,184
173,67,15,69,16,167
174,118,17,82,17,234
175,101,17,82,17,217
177,67,17,82,17,183
178,69,31,68,16,184
180,135,33,84,18,270
181,81,35,50,16,182
182,99,33,84,18,234
183,66,17,50,16,149
184,68,33,84,18,203
185,67,17,84,18,186
188,66,36,98,15,215
189,119,31,101,15,266
192,69,31,101,15,216
193,53,31,101,15,200
195,83,33,49,18,183
196,65,33,49,18,165
197,65,18,49,18,150
198,67,34,83,17,201
199,99,18,67,17,201
200,67,33,67,17,184
203,52,33,132,17,234
204,100,32,66,17,215
205,85,32,66,17,200
206,67,32,66,17,182
207,69,15,66,17,167
208,84,16,66,17,183
209,67,16,66,17,166
210,66,32,68,17,183
212,100,34,67,32,233
213,99,17,67,32,215
215,65,17,67,32,181
216,51,17,67,32,167
217,86,32,67,15,200
218,69,32,67,15,183
220,67,32,200,18,317
221,100,17,67,17,201
225,68,17,52,15,152
226,84,18,83,15,200
228,67,32,66,18,183
229,52,32,66,18,168
230,52,15,66,18,151
231,101,15,69,14,199
232,83,15,69,14,181
233,81,34,167,18,300
234,66,34,167,18,285
236,82,19,97,18,216
237,65,19,97,18,199
238,118,16,67,18,219
239,65,17,66,18,166
240,84,16,67,18,185
242,65,32,53,15,165
243,83,35,99,17,234
245,66,17,99,17,199
246,67,33,66,17,183
248,53,15,66,17,151
249,68,15,68,17,168
250,99,35,65,19,218
252,83,18,65,19,185
253,100,14,53,14,181
258,65,33,67,19,184
259,67,14,67,19,167
260,85,17,132,17,251
261,66,17,132,17,232
262,68,32,68,16,184
265,68,16,65,17,166
266,51,16,65,17,149
267,64,18,216,17,315
268,68,32,100,19,219
269,65,16,100,19,200
270,65,34,66,19,184
271,67,17,66,19,169
272,66,33,52,16,167
274,84,16,200,17,317
275,67,16,200,17,300
276,50,16,200,17,283
277,69,16,49,17,151
279,68,15,67,16,166
281,65,17,68,15,165
283,65,17,66,17,165
284,50,17,66,17,150
287,83,35,100,16,234
288,83,18,100,16,217
289,67,18,100,16,201
290,66,32,101,16,215
292,67,34,100,16,217
293,100,18,66,16,200
294,66,34,66,16,182
297,66,17,65,18,166
298,67,33,67,17,184
299,67,17,67,17,168
300,82,16,100,23,221
301,66,16,100,23,205
302,65,35,65,23,188
304,67,34,135,14,250
307,68,14,152,18,252
309,100,34,133,31,298
311,66,34,133,31,264
312,104,36,79,31,250
313,63,18,129,17,227
314,69,36,79,31,215
315,118,33,115,15,281
316,75,30,63,17,185
317,84,33,115,15,247
318,99,47,83,19,248
319,167,18,100,16,301
321,67,31,83,19,200
322,63,17,83,19,182
324,100,30,168,16,314
325,66,18,100,16,200
327,53,30,168,16,267
329,81,37,165,16,299
330,214,17,67,17,315
332,52,18,165,16,251
334,53,19,96,18,186
335,53,34,96,16,199
336,69,29,133,18,249
337,53,29,133,18,233
338,63,33,67,17,180
339,80,34,66,18,198
341,65,16,66,18,165
342,67,33,68,15,183
343,84,33,67,16,200
345,66,16,67,16,165
346,66,35,65,17,183
347,85,32,67,17,201
348,68,32,67,17,184
350,83,17,68,15,183
351,65,17,68,15,165
353,84,34,65,16,199
354,84,17,65,16,182
355,133,17,150,16,316
356,116,17,150,16,299
357,66,19,82,17,184
360,65,34,116,16,231
361,66,18,116,16,216
362,65,34,82,16,197
365,52,33,65,17,167
367,82,33,137,16,268
369,83,34,85,18,220
370,65,34,85,18,202
371,66,17,85,18,186
373,67,16,99,18,200
375,67,19,63,18,167
377,68,18,101,13,200
378,70,47,54,13,184
379,53,47,54,13,167
380,63,18,54,13,148
381,83,36,98,17,234
384,102,44,75,19,240
386,66,44,75,19,204
389,72,13,70,14,169
390,85,19,165,17,286
391,121,33,81,17,252
392,60,34,65,18,177
393,83,33,81,17,214
394,70,33,81,17,201
395,86,32,234,15,367
396,67,32,234,15,348
397,66,18,234,15,333
399,51,32,51,19,153
400,81,17,66,18,182
401,84,36,97,17,234
402,66,36,97,17,216
403,65,19,97,17,198
404,51,19,97,17,184
406,84,15,69,15,183
407,101,15,66,17,199
408,63,34,66,17,180
409,66,15,66,17,164
410,67,35,67,16,185
413,98,19,67,15,199
414,66,36,67,15,184
415,66,19,67,15,167
416,67,31,69,14,181
417,52,31,69,14,166
419,66,20,67,16,169
420,67,33,65,16,181
421,66,18,65,16,165
424,67,31,68,15,181
425,52,31,68,15,166
426,65,35,64,18,182
427,86,33,65,19,203
428,66,33,65,19,183
429,83,31,53,14,181
430,99,34,69,14,216
431,67,16,53,14,150
432,64,34,69,14,181
434,65,33,66,20,184
435,69,14,66,20,169
436,83,20,64,17,184
437,65,20,64,17,166
438,83,16,51,17,167
439,64,16,51,17,148
440,66,34,67,16,183
442,64,34,69,17,184
443,67,17,69,17,170
444,84,17,53,16,170
445,81,36,164,18,299
447,86,33,98,16,233
448,69,33,98,16,216
449,70,16,98,16,200
450,135,32,68,16,251
451,53,31,100,18,202
452,79,20,65,18,182
453,82,32,68,16,198
454,66,32,68,16,182
458,65,35,50,18,168
459,51,35,50,18,154
460,68,34,81,16,199
461,52,34,81,16,183
463,51,34,163,17,265
464,100,31,67,18,216
465,84,31,67,18,200
466,66,31,67,18,182
467,81,35,65,17,198
468,63,35,65,17,180
469,66,18,65,17,166
472,52,15,67,17,151
473,50,33,51,19,153
474,65,34,68,16,183
475,65,17,68,16,166
476,67,36,64,16,183
478,51,19,64,16,150
481,67,16,67,17,167
483,51,36,98,17,202
485,115,35,69,12,231
486,99,35,69,12,215
487,83,35,69,12,199
488,63,35,69,12,179
489,67,18,69,12,166
490,67,33,66,19,185
491,67,16,66,19,168
492,52,16,66,19,153
493,51,36,63,18,168
494,69,30,84,20,203
495,52,30,84,20,186
496,66,33,51,20,170
498,81,15,69,15,180
499,69,15,69,15,168
500,135,31,134,16,316
501,65,20,62,19,166
502,51,20,62,19,152
503,53,31,50,18,152
504,69,31,134,16,250
505,51,31,134,16,232
507,66,18,97,16,197
508,68,33,64,16,181
509,53,33,64,16,166
511,83,32,117,16,248
514,80,18,83,16,197
515,66,18,83,16,183
517,66,18,65,17,166
518,68,33,66,16,183
524,66,35,66,16,183
525,50,35,66,16,167
526,50,19,66,16,151
527,83,35,67,17,202
529,69,16,67,17,169
530,82,16,52,16,166
531,67,16,52,16,151
533,65,18,65,19,167
534,67,33,68,14,182
535,68,16,68,14,166
536,68,32,101,16,217
537,51,32,101,16,200
538,84,17,81,16,198
540,68,30,51,16,165
541,51,30,51,16,148
542,66,35,99,17,217
544,65,32,84,18,199
545,51,32,84,18,185
546,84,17,50,18,169
547,67,17,50,18,152
549,66,17,202,15,300
551,67,18,66,16,167
552,68,32,204,14,318
554,101,33,137,14,285
556,66,33,137,14,250
557,83,34,103,14,234
559,67,18,103,14,202
560,82,19,69,14,184
561,66,19,69,14,168
562,83,16,52,15,166
563,121,29,66,18,234
566,69,29,66,18,182
567,54,29,66,18,167
568,121,12,101,17,251
570,83,12,101,17,213
571,69,12,101,17,199
572,118,16,66,18,218
573,66,18,65,17,166
575,64,16,66,18,164
576,68,33,51,16,168
577,68,15,51,16,150
578,98,34,66,17,215
579,66,16,100,17,199
580,66,34,66,17,183
581,66,16,66,17,165
583,68,15,99,18,200
584,67,33,100,17,217
586,117,15,51,17,200
588,50,16,67,17,150
589,67,15,51,17,150
592,84,17,66,17,184
593,66,17,66,17,166
594,51,17,66,17,151
595,66,17,66,17,166
597,68,15,101,17,201
598,66,33,85,17,201
599,67,16,85,17,185
600,66,34,85,16,201
601,65,17,85,16,183
602,67,34,51,16,168
603,67,17,51,16,151
604,51,17,51,16,135
606,51,17,64,19,151
607,51,33,67,15,166
608,98,36,83,15,232
609,66,15,134,19,234
613,85,31,52,16,184
615,51,31,52,16,150
616,98,35,99,18,250
617,68,15,186,15,284
618,83,16,99,18,216
621,66,18,98,19,201
624,66,33,52,15,166
625,83,33,100,16,232
626,98,34,66,16,214
627,69,15,100,16,200
628,66,34,66,16,182
629,51,34,66,16,167
630,52,15,66,16,149
631,65,18,66,17,166
633,97,18,66,18,199
634,51,15,68,16,150
637,66,17,50,15,148
638,167,33,67,16,283
640,84,15,100,18,217
641,67,15,100,18,200
643,66,17,66,18,167
644,67,33,67,16,183
645,82,33,69,16,200
648,66,34,117,17,234
650,67,35,82,17,201
651,285,31,67,18,401
654,100,34,101,15,250
655,51,33,69,16,169
656,65,34,101,15,215
657,83,35,66,15,199
659,66,19,66,15,166
660,85,17,64,19,185
661,52,33,64,19,168
662,51,17,64,19,151
663,52,33,98,18,201
664,66,31,67,18,182
666,64,35,66,17,182
667,101,16,51,16,184
668,66,32,51,16,165
669,67,16,51,16,150
670,67,34,66,17,184
671,66,16,66,17,165
672,66,33,50,16,165
673,67,16,50,16,149
674,51,16,50,16,133
675,99,16,101,16,232
676,83,16,101,16,216
677,165,18,66,19,268
678,50,16,101,16,183
679,149,35,65,16,265
680,67,34,68,15,184
681,152,31,66,18,267
684,102,31,66,18,217
685,51,35,65,16,167
686,68,31,66,18,183
687,103,15,100,17,235
688,66,34,100,17,217
694,66,34,68,17,185
695,69,15,68,17,169
696,53,15,68,17,153
697,50,33,52,16,151
698,51,16,52,16,135
700,68,33,83,16,200
701,68,16,83,16,183
703,52,32,51,16,151
704,81,19,98,17,215
705,64,19,98,17,198
706,165,34,85,16,300
707,66,16,66,17,165
711,165,18,66,16,265
712,83,17,85,16,201
713,313,31,135,16,495
714,51,17,85,16,169
715,98,18,66,16,198
716,101,34,65,17,217
717,66,18,66,16,166
718,85,16,65,17,183
720,301,34,100,15,450
721,52,32,68,15,167
722,168,31,135,16,350
723,98,18,99,17,232
725,65,18,99,17,199
726,68,34,65,17,184
728,100,34,68,16,218
729,52,31,135,16,234
730,99,34,99,18,250
731,50,34,68,16,168
732,65,34,99,18,216
733,85,34,100,15,234
736,68,33,82,17,200
737,67,17,82,17,183
738,67,32,50,17,166
740,165,33,100,16,314
743,51,32,234,16,333
744,50,17,234,16,317
745,65,17,66,18,166
747,83,33,67,16,199
748,66,33,67,16,182
749,101,16,101,16,234
750,66,34,101,16,217
751,102,15,68,16,201
752,51,16,101,16,184
753,67,15,68,16,166
754,101,34,67,16,218
755,65,18,66,18,167
756,101,32,67,16,216
758,100,35,100,15,250
759,52,32,67,16,167
760,101,32,68,15,216
762,67,32,68,15,182
763,733,16,68,16,833
764,67,33,100,18,218
765,515,35,65,19,634
767,84,31,52,15,182
771,68,16,133,17,234
772,65,33,68,16,182
773,68,15,68,16,167
774,52,15,68,16,151
775,65,18,66,17,166
776,101,32,87,14,234
777,83,32,87,14,216
778,68,32,87,14,201
779,52,32,87,14,185
780,66,34,53,14,167
781,65,17,53,14,149
782,98,35,67,16,216
783,50,32,68,16,166
785,70,14,67,16,167
786,53,14,67,16,150
787,50,33,233,17,333
788,68,34,67,15,184
790,99,35,65,19,218
791,67,16,100,19,202
792,101,34,131,19,285
793,85,34,131,19,269
794,67,34,131,19,251
795,51,34,131,19,235
797,52,31,119,16,218
798,65,35,65,19,184
799,85,32,52,16,185
801,51,32,52,16,151
802,67,33,68,16,184
804,65,35,65,18,183
805,68,16,65,18,167
806,52,16,65,18,151
809,99,16,168,15,298
810,65,34,168,15,282
811,83,33,68,17,201
812,50,16,168,15,249
813,66,17,68,17,168
815,66,17,51,17,151
816,67,34,98,19,218
817,51,34,98,19,202
818,68,34,64,19,185
819,68,17,64,19,168
820,51,17,64,19,151
822,98,35,166,16,315
823,65,16,136,15,232
824,64,35,166,16,281
825,68,16,166,16,266
826,167,33,65,17,282
828,102,34,65,16,217
829,83,34,65,16,198
831,98,18,65,17,198
832,100,32,50,16,198
833,166,16,169,16,367
834,67,32,50,16,165
835,52,32,50,16,150
836,166,34,100,16,316
837,66,17,117,18,218
838,82,16,169,16,283
839,67,16,169,16,268
842,102,33,67,16,218
844,69,33,67,16,185
847,52,33,66,16,167
848,66,34,66,15,181
849,67,18,66,15,166
850,99,34,65,18,216
851,98,18,65,18,199
852,66,34,65,18,183
853,66,18,65,18,167
855,698,18,100,16,832
856,67,32,69,16,184
857,51,32,69,16,168
858,150,15,68,17,250
859,68,16,151,17,252
860,66,35,83,16,200
862,51,18,83,16,168
863,51,31,68,17,167
864,51,15,68,17,151
866,65,34,82,18,199
867,83,34,66,16,199
868,52,16,82,18,168
869,68,17,66,16,167
871,50,32,66,18,166
872,66,34,65,19,184
875,65,16,52,15,148
876,66,33,84,17,200
877,502,16,66,16,600
879,68,15,101,16,200
881,99,17,69,14,199
882,69,32,69,14,184
883,100,16,67,17,200
886,82,19,64,16,181
889,167,16,66,16,265
890,67,32,52,16,167
893,66,18,100,16,200
894,66,34,66,16,182
895,67,16,66,16,165
897,52,33,66,18,169
901,101,16,66,16,199
902,66,34,66,16,182
903,67,16,66,16,165
904,67,34,83,15,199
906,68,32,101,15,216
907,50,32,101,15,198
908,66,33,68,15,182
911,100,18,66,15,199
912,101,34,66,15,216
913,67,18,66,15,166
914,102,32,66,18,218
915,84,32,66,18,200
917,84,34,63,18,199
918,66,34,63,18,181
919,51,34,63,18,166
920,66,32,68,15,181
922,66,31,70,18,185
924,151,16,66,18,251
925,100,18,65,17,200
926,68,33,65,17,183
928,170,34,65,18,287
929,52,34,66,18,170
930,51,16,66,18,151
931,100,18,117,16,251
935,68,16,65,18,167
936,53,16,65,18,152
937,69,15,100,17,201
938,66,33,67,17,183
939,64,17,67,17,165
942,51,16,67,15,149
943,51,33,100,18,202
946,299,34,68,16,417
948,66,34,68,15,183
949,67,16,68,15,166
950,66,35,131,17,249
951,86,33,66,16,201
953,51,33,66,16,166
954,100,34,66,18,218
956,99,32,52,13,196
957,148,31,102,18,299
958,98,34,68,16,216
960,66,34,68,16,184
962,150,17,67,16,250
963,50,31,102,18,201
964,52,13,102,18,185
965,67,18,100,16,201
967,66,17,67,16,166
969,51,32,99,19,201
970,100,33,67,14,214
975,65,16,102,16,199
976,517,15,135,17,684
977,67,17,184,14,282
978,67,31,102,15,215
979,101,17,67,15,200
982,66,33,85,14,198
983,52,33,85,14,184
986,67,33,83,15,198
987,51,33,83,15,182
988,67,32,51,15,165
989,68,14,51,15,148
991,101,15,52,16,184
993,65,15,52,16,148
995,99,16,67,18,200
997,83,35,65,17,200
999,101,17,68,15,201
1000,68,32,68,15,183
1001,66,17,68,15,166
1002,67,33,135,17,252
1003,68,15,135,17,235
1004,65,35,66,17,183
1005,168,17,65,18,268
1006,68,32,68,17,185
1007,50,32,68,17,167
1008,101,34,65,18,218
1009,67,17,51,14,149
1011,168,17,83,17,285
1012,68,31,52,17,168
1013,68,14,52,17,151
1014,99,35,83,17,234
1017,97,17,52,17,183
1018,52,17,83,17,169
1019,65,17,52,17,151
1020,102,33,100,15,250
1021,84,33,100,15,232
1025,51,32,68,15,166
1026,65,32,68,17,182
1030,68,32,132,19,251
1031,82,33,65,18,198
1033,51,33,65,18,167
1034,98,32,135,16,281
1035,100,15,135,16,266
1036,299,34,67,16,416
1038,166,34,132,19,351
1039,66,16,101,16,199
1040,85,17,100,15,217
1042,53,17,100,15,185
1044,167,34,67,16,284
1046,65,35,65,16,181
1047,50,35,65,16,166
1048,100,34,67,16,217
1051,69,15,67,16,167
1052,65,32,102,16,215
1054,101,33,66,17,217
1055,66,16,134,17,233
1056,67,33,66,17,183
1057,67,17,66,17,167
1058,51,17,66,17,151
1059,99,16,52,17,184
1060,67,32,52,17,168
1061,67,16,52,17,152
1062,66,35,100,15,216
1063,167,16,65,17,265
1065,85,33,65,17,200
1066,52,17,66,15,150
1067,102,16,65,17,200
1069,165,16,153,16,350
1070,98,33,52,17,200
1071,300,16,66,17,399
1072,65,33,52,17,167
1073,65,16,52,17,150
1074,65,33,153,16,267
1075,102,17,133,17,269
1076,66,36,133,17,252
1077,68,17,133,17,235
1081,66,17,67,17,167
1082,66,32,166,17,281
1083,103,16,66,17,202
1084,84,16,66,17,183
1086,67,33,67,14,181
1087,52,33,67,14,166
1088,166,35,67,17,285
1089,99,17,66,16,198
1090,166,33,68,14,281
1095,65,18,67,17,167
1096,66,33,68,14,181
1097,770,15,66,18,869
1098,102,34,165,16,317
1100,67,34,165,16,282
1101,85,31,51,17,184
1102,51,17,165,16,249
1103,52,31,51,17,151
1105,282,34,66,16,398
1106,64,35,66,16,181
1109,301,16,67,17,401
1111,51,32,85,15,183
1112,301,32,67,16,416
1113,51,34,51,15,151
1114,66,34,66,16,182
1117,168,16,67,17,268
1118,51,15,66,18,150
1119,51,34,66,16,167
1120,299,34,166,16,515
1121,65,16,135,16,232
1122,66,34,67,17,184
1124,101,32,67,16,216
1125,50,35,66,16,167
1126,69,32,67,16,184
1129,51,34,66,17,168
1131,66,17,67,16,166
1132,100,34,166,16,316
1133,66,17,66,19,168
1134,532,34,67,17,650
1135,67,17,166,16,266
1136,67,32,68,15,182
1137,102,15,66,18,201
1138,66,34,66,18,184
1140,66,34,99,17,216
1141,50,34,99,17,200
1143,64,17,67,17,165
1144,167,34,65,18,284
1147,67,17,51,17,152
1148,67,34,66,16,183
1150,67,34,65,18,184
1151,68,17,65,18,168
1155,100,16,133,17,266
1156,65,34,133,17,249
1159,51,34,66,16,167
1160,52,16,66,16,150
1161,66,16,67,17,166
1162,100,33,51,17,201
1163,149,34,65,18,266
1166,67,34,134,14,249
1167,85,34,65,18,202
1168,67,34,65,18,184
1169,51,34,65,18,168
1170,51,17,65,18,151
1172,65,34,67,17,183
1173,65,17,67,17,166
1175,66,17,65,17,165
1176,52,17,65,17,151
1177,52,32,66,17,167
1178,67,33,68,16,184
1180,65,33,102,16,216
1182,66,35,67,16,184
1183,151,32,168,16,367
1186,51,16,51,16,134
1188,67,32,168,16,283
1189,51,32,168,16,267
1192,65,33,102,16,216
1193,65,17,102,16,200
1194,100,34,99,17,250
1196,101,34,98,16,249
1197,51,34,99,17,201
1198,68,34,98,16,216
1199,51,34,98,16,199
1200,68,33,65,16,182
1202,67,32,134,15,248
1204,65,33,52,15,165
1206,65,35,99,17,216
1207,165,18,68,15,266
1210,52,15,67,17,151
1212,66,33,68,15,182
1213,64,18,68,15,165
1214,67,33,102,14,216
1216,66,35,67,14,182
1218,83,16,67,18,184
1219,51,31,67,18,167
1220,50,16,67,18,151
1221,66,18,98,18,200
1222,67,31,67,18,183
1224,67,35,65,18,185
1225,67,17,65,18,167
1226,149,18,231,16,414
1227,52,32,51,18,153
1228,67,33,119,16,235
1229,67,15,119,16,217
1230,65,36,231,16,348
1233,51,30,134,17,232
1234,99,36,65,17,217
1236,63,36,65,17,181
1237,67,16,65,17,165
1238,286,15,67,17,385
1239,68,14,101,16,199
1241,98,17,67,15,197
1243,164,20,65,16,265
1245,100,18,167,15,300
1246,67,34,167,15,283
1247,301,16,66,18,401
1249,65,20,65,16,166
1250,69,31,67,17,184
1251,101,17,67,15,200
1254,81,17,184,16,298
1255,65,17,184,16,282
1256,50,17,184,16,267
1258,165,34,69,16,284
1260,66,34,66,18,184
1261,83,32,52,16,183
1263,51,32,52,16,151
1264,66,34,69,16,185
1266,84,16,117,17,234
1267,68,16,117,17,218
1269,67,18,131,17,233
1270,69,34,65,16,184
1273,52,32,65,17,166
1274,82,17,65,18,182
1275,83,32,134,18,267
1276,148,17,84,14,263
1277,50,32,134,18,234
1278,65,33,101,18,217
1279,66,16,101,18,201
1280,65,35,84,14,198
1282,51,17,84,14,166
1283,51,33,51,14,149
1284,68,33,83,17,201
1286,66,32,51,17,166
1289,68,16,83,16,183
1293,64,18,66,18,166
1294,66,33,67,16,182
1295,83,33,50,17,183
1296,99,34,102,15,250
1297,51,33,50,17,151
1298,84,16,102,15,217
1299,99,17,100,16,232
1301,102,15,118,16,251
1303,68,15,118,16,217
1305,51,35,65,18,169
1307,65,16,100,18,199
1308,66,34,100,17,217
1310,65,34,66,17,182
1313,169,17,165,19,370
1314,168,33,66,17,284
1315,150,33,66,17,266
1316,101,33,165,19,318
1317,101,17,165,19,302
1321,51,33,66,17,167
1322,50,16,66,17,149
1323,165,17,100,19,301
1324,99,34,66,15,214
1325,66,16,66,19,167
1327,150,35,66,15,266
1328,67,32,100,19,218
1329,65,17,100,19,201
1331,68,15,101,15,199
1332,167,33,65,18,283
1333,51,35,66,15,167
1334,100,35,131,18,284
1335,65,16,100,18,199
1336,66,35,131,18,250
1337,86,33,65,18,202
1338,81,18,65,18,182
1339,51,33,65,18,167
1340,100,33,68,16,217
1343,68,15,68,16,167
1344,65,33,100,19,217
1345,101,17,65,19,202
1346,66,35,65,19,185
1348,68,31,102,15,216
1349,50,31,102,15,198
1350,51,15,102,15,183
1351,101,15,68,16,200
1352,65,34,68,16,183
1353,68,15,68,16,167
1356,167,34,67,16,284
1357,64,19,65,17,165
1358,68,33,99,16,216
1359,65,17,99,16,197
1360,166,34,66,18,284
1361,101,17,67,16,201
1363,66,17,67,16,166
1364,66,33,135,17,251
1365,517,36,66,16,635
1366,67,34,66,18,185
1369,152,32,101,15,300
1370,50,18,67,17,152
1371,69,15,52,15,151
1372,101,32,101,15,249
1373,516,34,66,17,633
1375,50,32,101,15,198
1376,52,15,101,15,183
1379,84,32,100,15,231
1380,51,18,163,20,252
1381,52,32,100,15,199
1382,167,31,136,16,350
1384,65,33,65,20,183
1385,52,33,65,20,170
1386,66,34,134,14,248
1387,51,34,134,14,233
1388,67,31,136,16,250
1389,51,31,136,16,234
1390,99,36,66,16,217
1391,1382,34,67,17,1500
1392,65,36,66,16,183
1394,52,18,66,16,152
1395,97,19,82,17,215
1396,69,33,82,17,201
1397,166,17,201,15,399
1398,66,31,100,17,214
1400,64,34,66,17,181
1402,65,34,201,15,315
1404,51,17,201,15,284
1405,99,17,102,15,233
1406,66,34,102,15,217
1407,66,17,102,15,200
1409,85,32,100,16,233
1413,83,33,99,19,234
1414,67,33,99,19,218
1416,68,32,67,19,186
1417,52,32,67,19,170
1419,84,33,82,17,216
1420,66,33,82,17,198
1422,86,13,101,17,217
1423,302,15,66,17,400
1425,66,18,116,16,216
1426,67,32,84,16,199
1427,80,34,50,16,180
1430,66,34,99,19,218
1431,68,17,99,19,203
1434,50,16,334,17,417
1435,67,15,53,16,151
1436,65,34,66,17,182
1437,102,16,66,17,201
1438,86,16,66,17,185
1439,68,16,66,17,167
1440,53,16,66,17,152
1441,66,15,117,18,216
1442,66,35,100,16,217
1443,64,18,100,16,198
1446,52,17,66,16,151
1447,52,31,51,18,152
1448,82,18,66,17,183
1449,83,34,66,16,199
1451,50,34,66,16,166
1453,101,17,151,16,285
1456,66,32,135,15,248
1457,51,32,135,15,233
1458,66,35,84,16,201
1459,66,18,84,16,184
1460,67,34,99,16,216
1461,51,34,99,16,200
1462,168,32,52,16,268
1463,67,18,66,16,167
1465,68,16,99,18,201
1466,99,32,52,16,199
1467,84,32,52,16,184
1469,65,16,52,16,149
1471,84,34,101,16,235
1472,150,17,66,17,250
1476,67,34,66,17,184
1477,532,16,67,16,631
1479,51,34,83,16,184
1480,100,33,67,15,215
1481,285,32,66,16,399
1482,99,34,66,16,215
1483,66,16,67,15,164
1484,65,34,66,16,181
1486,51,16,66,16,149
1487,98,18,51,18,185
1488,299,36,133,17,485
1491,86,33,98,16,233
1492,69,33,98,16,216
1494,51,18,98,16,183
1495,119,32,83,16,250
1496,99,32,83,16,230
1498,66,32,83,16,197
1500,66,32,51,16,165
1501,65,16,51,16,148
1502,64,36,133,17,250
1504,68,31,67,16,182
1505,100,19,66,17,202
1508,83,15,101,17,216
1509,68,15,101,17,201
1510,102,34,132,17,285
1511,50,35,105,10,200
1512,66,34,132,17,249
1513,84,32,100,17,233
1514,52,17,132,17,218
1515,170,15,167,15,367
1516,66,39,61,17,183
1518,71,30,97,17,215
1519,103,15,167,15,300
1520,69,31,167,15,282
1521,68,15,167,15,265
1522,93,34,68,17,212
1525,64,17,68,17,166
1526,101,33,132,17,283
1527,66,18,66,15,165
1528,69,33,132,17,251
1529,68,17,132,17,234
1531,68,16,66,16,166
1532,165,35,165,18,383
1533,50,32,67,17,166
1535,64,18,68,15,165
1536,99,35,165,18,317
1538,67,35,165,18,285
1540,68,31,102,16,217
1541,99,18,68,16,201
1542,50,16,102,16,184
1543,65,18,68,16,167
1544,65,35,65,18,183
1545,50,35,65,18,168
1546,69,33,65,18,185
1547,169,16,69,15,269
1548,68,32,136,15,251
1549,68,16,136,15,235
1550,65,33,103,15,216
1552,65,34,69,15,183
1553,67,16,69,15,167
1554,101,35,132,15,283
1556,68,35,132,15,250
1557,167,18,65,16,266
1558,51,18,132,15,216
1559,53,30,169,15,267
1560,65,34,200,17,316
1561,100,18,65,16,199
1562,64,36,65,16,181
1564,102,33,133,16,284
1565,152,31,68,16,267
1567,167,15,66,18,266
1569,66,18,65,17,166
1570,98,34,66,18,216
1573,100,17,167,16,300
1574,65,34,167,16,282
1575,67,17,167,16,267
1576,51,17,167,16,251
1577,99,15,70,16,200
1578,99,35,67,16,217
1580,65,35,67,16,183
1581,102,17,64,19,202
1583,68,17,64,19,168
1586,152,13,52,16,233
1587,65,16,100,18,199
1588,64,33,85,16,198
1589,67,14,85,16,182
1590,51,14,85,16,166
1591,166,17,51,18,252
1592,53,13,52,16,134
1593,167,16,98,19,300
1594,67,34,132,17,250
1595,65,16,132,17,230
1596,52,16,132,17,217
1598,86,16,98,19,219
1599,84,34,83,16,217
1600,52,16,98,19,185
1602,152,16,132,17,317
1604,64,34,135,15,248
1607,67,16,132,17,232
1608,169,32,50,16,267
1609,52,31,69,15,167
1610,167,35,66,19,287
1611,66,16,66,17,165
1614,69,32,50,16,167
1616,101,31,103,16,251
1619,101,17,68,16,202
1621,67,17,68,16,168
1623,70,16,65,18,169
1624,103,32,66,16,217
1625,101,16,66,16,199
1626,100,31,151,18,300
1627,65,16,66,16,163
1629,51,31,151,18,251
1630,50,13,151,18,232
1632,82,18,82,18,200
1633,64,18,82,18,182
1634,169,32,67,19,287
1635,68,14,99,17,198
1636,100,34,134,16,284
1641,51,32,67,19,169
1642,66,35,67,16,184
1643,300,18,99,18,435
1644,99,35,65,19,218
1645,67,15,51,15,148
1646,67,35,65,19,186
1647,69,16,65,19,169
1648,83,15,201,16,315
1651,65,16,67,16,164
1652,65,33,68,16,182
1653,68,14,68,16,166
1654,53,14,68,16,151
1655,66,17,50,16,149
1657,299,17,66,15,397
1658,68,32,67,18,185
1659,67,16,67,18,168
1660,50,16,67,18,151
1661,50,34,51,16,151
1662,66,33,66,18,183
1664,67,34,65,19,185
1665,67,16,65,19,167
1667,51,32,52,17,152
1668,66,33,53,15,167
1670,65,36,66,15,182
1671,68,17,66,15,166
1672,86,15,66,18,185
1674,53,15,66,18,152
1675,98,17,68,16,199
1676,98,33,101,17,249
1677,165,18,66,15,264
1679,68,15,101,17,201
1680,100,34,66,15,215
1681,67,18,100,15,200
1682,84,18,66,15,183
1683,66,18,66,15,165
1684,101,34,65,17,217
1685,52,32,68,15,167
1686,66,34,65,17,182
1689,66,19,66,16,167
1691,99,18,66,16,199
1693,67,18,66,16,167
1694,66,33,67,19,185
1695,67,17,67,19,170
1696,51,17,67,19,154
1697,100,18,100,17,235
1698,66,34,100,17,217
1700,67,32,100,17,216
1701,71,13,100,17,201
1702,53,13,100,17,183
1703,68,17,65,17,167
1705,63,18,100,16,197
1707,166,16,68,16,266
1708,98,35,100,16,249
1709,50,33,51,16,150
1710,65,35,100,16,216
1711,99,16,68,16,199
1712,168,32,66,17,283
1713,67,16,68,16,167
1714,51,16,68,16,151
1715,65,15,52,16,148
1716,166,32,67,18,283
1718,84,16,66,17,183
1721,97,16,67,18,198
1722,66,32,67,18,183
1724,66,35,66,18,185
1727,51,32,134,20,237
1728,51,16,134,20,221
1729,168,16,167,17,368
1731,68,17,85,15,185
1732,101,33,167,17,318
1733,100,16,167,17,300
1734,67,33,167,17,284
1735,66,16,167,17,266
1736,85,15,132,17,249
1737,86,34,131,18,269
1738,284,16,99,19,418
1739,1101,15,52,15,1183
1740,69,31,218,15,333
1741,65,15,218,15,313
1742,149,16,118,15,298
1743,168,17,98,17,300
1744,166,32,99,19,316
1746,51,16,68,16,151
1748,51,16,118,15,200
1749,67,17,98,17,199
1751,51,32,99,19,201
1752,51,16,99,19,185
1753,100,15,101,17,233
1754,83,15,101,17,216
1756,66,33,68,17,184
1757,167,16,66,18,267
1758,66,34,67,18,185
1759,67,15,67,18,167
1760,52,15,67,18,152
1761,50,34,65,18,167
1764,51,16,66,18,151
1765,69,14,52,16,151
1766,51,14,52,16,133
1767,66,16,67,16,165
1768,66,34,65,19,184
1770,101,32,86,15,234
1771,67,16,118,15,216
1772,67,32,86,15,200
1774,65,36,65,18,184
1776,101,32,51,17,201
1777,52,33,67,16,168
1778,69,32,51,17,169
1779,67,15,51,17,150
1780,166,32,66,20,284
1781,84,33,65,19,201
1782,83,17,65,19,184
1783,50,33,65,19,167
1785,99,16,66,20,201
1788,284,15,52,15,366
1789,68,16,51,15,150
1790,83,15,70,15,183
1791,102,15,66,18,201
1794,51,15,66,18,150
1795,300,17,85,16,418
1796,285,17,85,16,403
1797,65,16,101,18,200
1798,50,16,101,18,185
1799,103,15,52,15,185
1800,65,33,52,15,165
1803,101,15,67,16,199
1804,150,17,85,16,268
1805,149,33,52,16,250
1807,99,17,85,16,217
1808,533,34,98,19,684
1810,50,17,85,16,168
1811,51,33,52,16,152
1812,165,36,64,19,284
1813,66,18,133,17,234
1814,85,16,81,18,200
1817,52,31,100,19,202
1819,65,18,64,19,166
1821,66,18,51,16,151
1822,167,34,67,15,283
1823,67,15,67,19,168
1825,102,15,51,16,184
1826,51,16,66,17,150
1827,67,15,51,16,149
1828,67,34,67,15,183
1829,164,18,68,16,266
1833,64,18,50,17,149
1834,67,33,68,16,184
1835,83,34,98,19,234
1837,51,34,98,19,202
1839,52,34,83,17,186
1840,99,33,69,17,218
1842,65,33,69,17,184
1845,67,17,114,19,217
1846,52,17,114,19,202
1847,50,33,130,19,232
1848,69,33,97,19,218
1849,67,16,97,19,199
1850,99,34,133,17,283
1851,51,33,64,19,167
1852,100,30,53,16,199
1853,64,19,133,17,233
1854,67,30,53,16,166
1857,102,16,51,16,185
1858,65,34,51,16,166
1860,53,16,51,16,136
1861,67,17,83,17,184
1862,68,33,67,16,184
1863,67,16,67,16,166
1864,100,34,66,16,216
1866,66,34,66,16,182
1867,299,17,66,16,398
1868,67,33,65,17,182
1869,101,16,65,19,201
1870,67,33,65,19,184
1873,149,34,169,16,368
1874,65,33,68,17,183
1876,65,34,101,16,216
1877,68,15,101,16,200
1878,52,15,101,16,184
1879,167,17,69,16,269
1880,68,34,66,16,184
1881,66,17,66,16,165
1882,101,33,69,16,219
1883,100,17,69,16,202
1885,66,17,69,16,168
1886,66,32,106,9,213
1887,101,17,69,9,196
1888,65,37,69,9,180
1891,53,31,67,18,169
1893,86,29,150,17,282
1894,69,29,150,17,265
1897,99,17,118,17,251
1898,113,17,66,17,213
1899,104,17,66,17,204
1900,66,35,66,17,184
1901,66,17,66,17,166
1902,51,17,66,17,151
1903,52,32,100,17,201
1904,167,34,65,19,285
1905,66,17,66,17,166
1906,66,34,66,16,182
1907,300,18,66,16,400
1911,99,16,135,17,267
1912,98,33,102,17,250
1913,66,16,135,17,234
1914,66,33,102,17,218
1915,66,16,102,17,201
1916,65,34,68,17,184
1919,68,16,132,17,233
1922,68,33,65,17,183
1923,67,16,65,17,165
1924,67,33,66,16,182
1925,51,33,66,16,166
1926,66,32,68,17,183
1927,65,16,68,17,166
1928,65,34,51,16,166
1929,65,17,51,16,149
1930,66,34,68,15,183
1932,68,33,67,18,186
1935,51,35,98,19,203
1936,68,32,66,19,185
1939,69,15,52,16,152
1940,283,16,67,16,382
1942,66,35,67,15,183
1943,150,31,52,16,249
1944,52,16,67,15,150
1946,66,36,65,18,185
1947,64,19,65,18,166
1948,67,31,52,16,166
1951,50,34,66,18,168
1954,52,16,67,16,151
1955,100,17,101,16,234
1956,101,32,134,14,281
1957,66,17,101,16,200
1958,67,32,134,14,247
1959,51,32,134,14,231
1960,51,16,134,14,215
1961,65,18,66,16,165
1963,101,15,66,18,200
1964,100,34,67,16,217
1966,66,34,67,16,183
1967,66,18,67,16,167
1968,65,32,118,16,231
1969,63,18,118,16,215
1973,53,33,66,19,171
1976,67,32,101,16,216
1978,66,35,66,16,183
1979,165,17,66,18,266
1980,67,33,100,16,216
1982,101,33,66,18,218
1983,49,33,67,16,165
1984,99,34,116,16,265
1985,83,34,116,16,249
1987,285,32,51,17,385
1989,152,31,68,16,267
1991,165,19,65,17,266
1992,65,36,99,16,216
1993,85,31,68,16,200
1994,52,17,99,16,184
1995,51,31,68,16,166
2000,68,32,51,17,168
2001,52,32,51,17,152
2002,65,34,84,17,200
2003,67,17,84,17,185
2005,67,17,67,17,168
2006,101,34,66,15,216
2007,67,17,67,15,166
2008,84,17,66,15,182
2013,98,18,67,16,199
2014,66,33,67,16,182
2015,64,18,67,16,165
2016,100,33,68,16,217
2018,67,33,68,16,184
2019,101,18,98,18,235
2020,67,34,98,18,217
2021,67,18,98,18,201
2022,165,34,152,16,367
2023,51,34,64,18,167
2025,68,14,52,16,150
2026,64,34,102,17,217
2027,100,16,152,16,284
2028,64,34,152,16,266
2029,66,16,152,16,250
2030,52,16,152,16,236
2031,66,16,52,17,151
2032,102,34,82,16,234
2033,300,17,99,17,433
2034,68,34,82,16,200
2035,101,15,51,16,183
2037,66,15,51,16,148
2039,149,33,65,20,267
2041,166,17,99,17,299
2042,101,33,65,20,219
2043,65,17,83,15,180
2044,66,33,65,20,184
2045,50,33,65,20,168
2046,50,17,65,20,152
2047,67,17,99,17,200
2048,67,31,68,17,183
2049,102,14,51,16,183
2050,65,34,51,16,166
2052,84,15,118,17,234
2054,53,15,118,17,203
2055,65,16,85,17,183
2056,51,16,85,17,169
2057,99,18,65,17,199
2058,66,36,65,17,184
2059,67,18,65,17,167
2060,69,33,66,16,184
2061,86,32,135,14,267
2062,52,17,66,16,151
2063,51,32,135,14,232
2065,66,17,84,17,184
2066,100,32,132,19,283
2068,100,35,65,16,216
2069,51,32,132,19,234
2070,101,32,65,19,217
2072,67,32,65,19,183
2074,100,32,69,16,217
2077,51,32,69,16,168
2079,84,34,99,17,234
2080,67,34,99,17,217
2081,51,34,99,17,201
2082,69,32,167,17,285
2083,82,33,51,20,186
2085,51,33,51,20,155
2086,82,17,100,17,216
2087,167,16,299,18,500
2088,50,17,100,17,184
2089,51,37,80,17,185
2091,285,32,167,15,499
2092,66,34,299,18,417
2093,67,16,299,18,400
2095,67,17,100,17,201
2098,101,33,51,15,200
2099,65,19,67,17,168
2100,151,15,167,15,348
2101,532,19,66,16,633
2102,168,32,101,15,316
2103,69,17,232,18,336
2104,67,32,167,15,281
2106,51,15,167,15,248
2108,98,33,68,15,214
2109,99,15,68,15,197
2110,99,33,185,16,333
2111,99,15,185,16,315
2112,65,33,185,16,299
2113,68,15,185,16,284
2114,1899,35,100,17,2051
2115,68,15,117,17,217
2116,101,33,68,16,218
2119,66,15,68,16,165
2120,117,17,81,19,234
2121,51,33,51,16,151
2122,84,17,81,19,201
2124,168,31,51,18,268
2125,52,32,68,15,167
2126,285,15,51,17,368
2127,65,18,100,16,199
2128,66,34,66,16,182
2129,300,17,83,17,417
2130,150,18,99,17,284
2131,52,31,51,18,152
2132,100,34,99,17,250
2133,85,34,99,17,235
2134,66,34,99,17,216
2136,51,18,99,17,185
2137,64,17,132,16,229
2138,67,32,51,17,167
2139,68,15,51,17,151
2140,50,15,51,17,133
2141,100,17,83,17,217
2142,66,34,83,17,200
2144,51,17,83,17,168
2145,52,32,135,17,236
2146,66,33,69,16,184
2147,65,17,69,16,167
2148,65,35,67,17,184
2150,68,34,134,15,251
2151,52,34,134,15,235
2153,167,18,103,13,301
2155,51,31,173,13,268
2157,66,15,68,16,165
2158,64,37,103,13,217
2159,99,16,72,13,200
2160,52,18,103,13,186
2162,52,16,72,13,153
2165,68,20,77,16,181
2166,165,34,120,14,333
2169,66,14,67,18,165
2171,64,16,154,14,248
2172,63,34,120,14,231
2173,65,16,120,14,215
2174,304,31,50,18,403
2175,68,18,84,14,184
2178,66,36,100,16,218
2179,102,14,68,16,200
2180,66,32,68,16,182
2181,550,31,70,14,665
2182,103,33,66,16,218
2183,104,16,66,16,202
2185,98,19,65,16,198
2186,285,15,51,18,369
2187,981,34,67,15,1097
2188,68,31,50,18,167
2189,51,31,50,18,150
2190,66,34,67,15,182
2191,66,18,67,15,166
2192,163,34,51,18,266
2195,52,33,50,15,150
2196,67,31,70,15,183
2198,64,34,51,18,167
2199,67,15,51,18,151
2201,68,18,81,16,183
2203,84,33,66,17,200
2205,51,33,66,17,167
2206,97,35,83,18,233
2207,66,16,52,14,148
2211,68,14,70,14,166
2212,103,33,97,18,251
2213,66,20,97,17,200
2214,68,33,97,18,216
2215,66,18,97,18,199
2216,70,31,99,17,217
2217,103,14,66,17,200
2218,97,33,68,16,214
2219,68,14,66,17,165
2221,67,16,68,16,167
2222,301,33,52,14,400
2223,97,18,100,17,232
2224,66,35,100,17,218
2225,100,18,66,17,201
2228,69,33,67,15,184
2229,52,33,67,15,167
2230,67,33,100,17,217
2233,99,18,67,18,202
2234,50,17,66,17,150
2236,67,33,52,14,166
2237,66,17,52,14,149
2238,66,34,116,17,233
2240,67,32,84,17,200
2241,83,34,67,15,199
2243,49,34,67,15,165
2245,64,18,103,11,196
2246,68,33,70,11,182
2247,153,32,53,15,253
2248,101,36,60,25,222
2249,85,36,60,25,206
2250,67,36,60,25,188
2251,51,36,60,25,172
2252,70,32,53,15,170
2253,55,32,53,15,155
2255,52,28,109,16,205
2256,85,15,150,18,268
2257,108,15,170,14,307
2259,59,15,170,14,258
2261,84,30,69,16,199
2265,49,35,84,15,183
2266,115,20,130,16,281
2268,69,36,130,16,251
2270,735,31,69,16,851
2273,66,17,67,16,166
2274,98,32,66,18,214
2275,84,32,66,18,200
2276,52,17,67,15,151
2277,100,19,99,17,235
2278,67,35,99,17,218
2279,99,16,68,17,200
2280,67,31,68,17,183
2281,283,32,101,17,433
2282,66,34,51,15,166
2283,68,16,51,15,150
2284,65,34,67,16,182
2285,101,15,101,15,232
2286,68,32,101,15,216
2287,98,19,66,15,198
2289,64,19,66,15,164
2290,67,34,64,16,181
2291,66,18,64,16,164
2292,51,18,64,16,149
2293,53,32,66,18,169
2294,66,32,101,17,216
2296,64,34,67,17,182
2298,66,33,101,16,216
2299,69,15,101,16,201
2300,168,33,66,17,284
2302,67,34,115,17,233
2303,166,18,130,18,332
2305,67,17,99,17,200
2306,100,35,130,18,283
2307,66,17,66,17,166
2308,167,34,67,16,284
2309,67,18,130,18,233
2311,66,17,69,16,168
2314,100,30,135,16,281
2315,68,18,67,16,169
2316,69,30,135,16,250
2317,100,19,81,17,217
2318,50,14,135,16,215
2319,66,19,81,17,183
2320,67,31,67,16,181
2321,51,31,67,16,165
2322,101,34,66,17,218
2323,50,33,134,16,233
2324,64,34,66,17,181
2325,65,17,66,17,165
2326,167,33,99,18,317
2327,50,33,67,16,166
2330,100,33,99,18,250
2331,167,16,135,17,335
2333,50,33,99,18,200
2335,100,16,135,17,268
2336,167,34,116,17,334
2337,67,16,135,17,235
2338,66,33,52,17,168
2340,66,35,67,17,185
2341,67,17,67,17,168
2342,68,34,116,17,235
2343,51,34,116,17,218
2344,102,33,50,17,202
2345,84,33,50,17,184
2347,67,16,50,17,150
2348,66,32,68,19,185
2349,52,32,68,19,171
2350,65,35,52,14,166
2353,66,17,65,19,167
2356,52,14,66,16,148
2357,66,16,50,17,149
2358,167,32,69,14,282
2360,66,33,67,18,184
2362,50,17,67,18,152
2364,100,34,101,16,251
2365,68,16,69,14,167
2366,67,34,101,16,218
2367,83,35,82,16,216
2368,50,16,101,16,183
2369,151,32,67,16,266
2371,51,32,50,16,149
2372,67,34,65,17,183
2373,83,32,67,16,198
2374,66,32,67,16,181
2375,52,32,67,16,167
2377,50,33,68,16,167
2378,149,17,65,19,250
2379,66,17,67,17,167
2381,50,34,66,17,167
2382,68,33,65,19,185
2383,84,33,51,16,184
2384,151,16,100,16,283
2385,51,33,51,16,151
2388,65,35,100,16,216
2389,67,16,100,16,199
2390,51,16,100,16,183
2391,63,21,66,16,166
2393,65,18,101,15,199
2394,100,33,117,17,267
2395,54,33,68,15,170
2397,51,33,117,17,218
2398,66,35,99,15,215
2399,99,17,67,15,198
2400,68,32,67,15,182
2401,67,17,67,15,166
2402,100,34,166,16,316
2403,185,33,66,16,300
2404,99,33,67,16,215
2405,67,17,166,16,266
2407,299,17,68,17,401
2408,67,34,68,14,183
2409,84,33,66,16,199
2410,166,35,99,15,315
2412,168,32,67,15,282
2414,68,31,99,17,215
2415,84,35,99,15,233
2416,101,32,67,15,215
2417,50,35,99,15,199
2418,98,32,68,17,215
2419,52,32,67,15,166
2420,67,32,68,17,184
2422,99,33,67,16,215
2425,301,17,84,16,418
2426,100,35,100,15,250
2427,168,16,68,15,267
2428,65,35,100,15,215
2429,85,32,166,17,300
2430,67,32,166,17,282
2431,150,34,199,18,401
2432,51,16,166,17,250
2434,66,34,66,15,181
2435,66,18,66,15,165
2439,67,17,84,16,184
2440,98,35,66,16,215
2441,66,17,201,20,304
2442,64,35,66,16,181
2444,67,33,85,15,200
2445,52,33,85,15,185
2446,52,16,85,15,168
2450,67,33,53,15,168
2451,51,33,53,15,152
2452,52,15,53,15,135
2453,51,33,68,16,168
2454,86,15,66,17,184
2456,101,33,132,17,283
2457,100,17,132,17,266
2458,284,15,68,19,386
2460,99,33,66,17,215
2461,166,17,66,17,266
2462,66,33,66,17,182
2463,66,17,66,17,166
2465,49,33,67,17,166
2469,173,13,82,18,286
2470,67,32,68,19,186
2473,168,16,101,14,299
2474,66,34,82,18,200
2477,102,16,101,14,233
2478,101,33,68,14,216
2479,297,16,50,17,380
2480,67,33,68,14,182
2481,63,18,68,14,163
2482,68,33,66,17,184
2483,165,17,67,17,266
2484,66,35,65,17,183
2485,67,19,65,17,168
2486,68,31,68,17,184
2487,52,31,68,17,168
2488,167,33,166,17,383
2489,84,34,66,17,201
2491,102,16,50,17,185
2492,68,33,50,17,168
2493,68,16,50,17,151
2495,67,16,166,17,266
2496,83,17,132,17,249
2497,66,17,132,17,232
2502,68,29,87,16,200
2503,97,17,52,16,182
2505,99,18,65,18,200
2508,52,18,65,18,153
2510,52,16,84,16,168
2511,101,16,68,15,200
2512,65,34,68,15,182
2514,66,34,67,16,183
2515,67,16,67,16,166
2516,52,16,67,16,151
2518,68,33,65,18,184
2519,482,35,66,15,598
2520,67,32,100,17,216
2523,167,17,101,15,300
2524,166,34,217,17,434
2525,67,17,182,16,282
2526,68,32,99,18,217
2527,99,17,101,15,232
2531,65,19,217,17,318
2532,68,31,51,16,166
2534,101,31,101,18,251
2536,82,16,101,18,217
2537,100,17,66,18,201
2538,51,16,101,18,186
2540,81,17,101,16,215
2541,66,17,101,16,200
2542,67,34,67,16,184
2543,101,17,66,15,199
2544,66,35,66,15,182
2547,51,32,66,16,165
2549,98,17,68,17,200
2550,298,35,66,17,416
2552,66,35,99,17,217
2553,66,19,99,17,201
2554,67,33,132,18,250
2555,68,17,132,18,235
2556,102,32,84,17,235
2557,102,16,84,17,219
2559,67,16,84,17,184
2560,98,34,67,18,217
2561,66,15,135,17,233
2562,64,34,67,18,183
2563,66,16,67,18,167
2564,66,35,66,17,184
2566,52,17,66,17,152
2567,65,18,51,15,149
2572,51,15,52,16,134
2573,67,15,66,17,165
2574,84,16,100,16,216
2575,102,13,100,17,232
2577,68,13,100,17,198
2578,66,35,100,16,217
2579,65,18,100,16,199
2581,64,17,67,16,164
2583,51,32,67,18,168
2584,65,35,67,16,183
2586,99,35,98,18,250
2587,67,16,116,17,216
2588,67,35,98,18,218
2590,67,32,66,18,183
2591,101,17,65,18,201
2592,302,31,67,17,417
2593,67,17,65,18,167
2594,67,31,52,16,166
2595,65,17,52,16,150
2596,66,34,68,14,182
2597,66,16,68,14,164
2600,102,32,166,15,315
2602,68,32,166,15,281
2603,98,19,98,17,232
2605,65,19,98,17,199
2606,67,31,67,17,182
2607,53,31,67,17,168
2608,51,15,67,17,150
2609,302,16,66,17,401
2611,66,16,68,16,166
2612,67,33,67,17,184
2614,299,35,98,19,451
2615,64,20,67,16,167
2617,51,32,51,16,150
2618,102,32,52,16,202
2620,67,32,52,16,167
2621,51,32,52,16,151
2624,66,34,67,15,182
2625,68,16,67,15,166
2626,52,16,67,15,150
2627,99,18,98,19,234
2629,65,18,98,19,200
2630,67,31,67,19,184
2631,150,34,67,17,268
2633,66,17,52,15,150
2634,65,33,101,17,216
2635,66,17,101,17,201
2636,168,34,99,16,317
2637,101,17,100,15,233
2638,52,15,67,17,151
2639,68,17,100,15,200
2642,67,34,99,16,216
2644,67,33,165,18,283
2645,66,18,165,18,267
2646,67,33,65,18,183
2648,99,32,67,18,216
2649,51,33,167,16,267
2650,66,32,67,18,183
2652,150,16,167,16,349
2653,102,15,100,18,235
2654,300,34,65,17,416
2655,68,15,100,18,201
2656,167,35,66,16,284
2657,67,16,167,16,266
2658,168,32,133,17,350
2660,51,17,99,17,184
2661,100,17,66,16,199
2662,66,35,66,16,183
2663,100,16,133,17,266
2664,83,16,133,17,249
2666,51,16,133,17,217
2667,66,17,66,17,166
2669,50,34,65,17,166
2670,68,32,84,16,200
2673,67,16,51,16,150
2674,65,34,101,16,216
2675,66,17,101,16,200
2676,67,33,68,16,184
2677,167,17,66,18,268
2680,51,15,168,16,250
2681,100,17,66,18,201
2682,101,33,67,16,217
2683,167,16,98,19,300
2685,150,32,202,16,400
2686,99,34,98,19,250
2687,65,18,50,16,149
2688,66,34,98,19,217
2691,52,32,202,16,302
2692,50,16,202,16,284
2693,66,17,99,17,199
2694,67,31,68,17,183
2696,66,35,66,17,184
2697,99,17,84,17,217
2698,167,33,66,16,282
2699,100,16,51,17,184
2700,68,33,51,17,169
2701,82,35,66,17,200
2702,66,35,66,17,184
2703,85,33,66,16,200
2704,68,33,66,16,183
2705,51,33,66,16,166
2706,51,17,66,16,150
2709,67,16,99,19,201
2710,66,32,86,16,200
2712,65,35,51,16,167
2713,299,16,150,18,483
2714,67,32,52,16,167
2715,51,32,52,16,151
2717,68,16,66,18,168
2718,84,16,150,17,267
2719,101,16,117,17,251
2720,101,32,67,18,218
2722,66,32,67,18,183
2724,83,16,102,14,215
2725,66,16,102,14,198
2727,65,16,150,18,249
2728,67,35,98,17,217
2730,51,17,98,17,183
2735,168,16,118,15,317
2737,67,18,66,17,168
2738,101,32,118,15,266
2739,66,18,65,18,167
2740,69,32,118,15,234
2742,50,16,118,15,199
2743,50,33,67,18,168
2744,299,34,65,19,417
2745,99,17,84,16,216
2747,167,16,67,17,267
2748,151,16,67,17,251
2750,51,15,134,17,217
2752,66,34,67,17,184
2753,66,16,67,17,166
2754,51,16,67,17,151
2755,66,18,100,15,199
2757,51,32,68,15,166
2758,67,34,65,19,185
2759,100,18,100,15,233
2760,66,34,100,15,215
2761,66,18,100,15,199
2763,66,16,100,18,200
2764,65,34,66,18,183
2766,65,35,98,17,215
2767,66,19,98,17,200
2771,68,16,101,16,201
2774,100,35,82,18,235
2775,66,16,51,16,149
2776,66,35,82,18,201
2777,84,32,68,16,200
2778,168,32,67,15,282
2779,83,34,66,18,201
2780,101,34,132,17,284
2781,100,18,132,17,267
2782,100,32,67,15,214
2783,66,18,132,17,233
2784,68,32,67,15,182
2785,51,32,67,15,165
2786,84,17,133,16,250
2787,167,17,50,17,251
2788,99,33,68,16,216
2789,51,32,67,16,166
2793,66,17,50,17,150
2794,101,33,65,18,217
2795,52,34,67,15,168
2797,51,33,65,18,167
2798,50,17,65,18,150
2799,51,34,66,17,168
2800,67,31,52,16,166
2802,65,35,67,16,183
2803,68,17,67,16,168
2804,66,33,66,18,183
2805,68,16,66,18,168
2806,52,16,66,18,152
2809,66,16,51,17,150
2810,50,16,51,17,134
2811,99,17,66,17,199
2812,166,33,66,17,282
2814,51,17,66,17,151
2815,165,16,51,17,249
2816,67,33,99,17,216
2817,66,17,99,17,199
2818,99,32,51,17,199
2821,66,16,51,17,150
2822,65,34,68,15,182
2823,66,16,68,15,165
2825,67,17,100,16,200
2827,99,18,66,17,200
2828,167,34,100,17,318
2831,100,17,50,18,185
2832,66,33,50,18,167
2833,101,17,100,17,235
2834,66,34,100,17,217
2836,50,17,100,17,184
2837,51,34,134,16,235
2838,101,33,100,16,250
2839,65,19,70,14,168
2841,67,17,100,16,200
2842,103,31,64,19,217
2843,69,20,95,19,203
2844,70,31,64,19,184
2845,101,16,51,16,184
2846,51,17,64,19,151
2847,67,16,51,16,150
2848,63,32,68,16,179
2849,165,19,115,18,317
2850,83,16,266,17,382
2851,83,33,66,18,200
2852,51,16,266,17,350
2853,51,33,66,18,168
2855,65,19,115,18,217
2856,68,31,84,18,201
2857,102,16,133,17,268
2859,68,16,133,17,234
2860,49,16,133,17,215
2862,167,33,135,15,350
2863,84,32,101,15,232
2865,52,32,101,15,200
2866,66,33,68,15,182
2867,68,15,68,15,166
2869,98,19,165,17,299
2870,169,32,100,18,319
2871,64,19,165,17,265
2873,66,18,67,15,166
2874,50,18,67,15,150
2876,68,32,100,18,218
2877,85,32,68,18,203
2878,99,33,53,14,199
2879,101,15,53,14,183
2880,150,14,69,15,248
2882,300,33,66,17,416
2883,50,35,116,15,216
2886,53,14,69,15,151
2887,67,16,51,15,149
2888,65,36,80,19,200
2890,84,15,69,17,185
2892,116,19,66,16,217
2896,86,16,66,17,185
2900,99,34,65,16,214
2901,65,17,83,16,181
2903,51,34,65,16,166
2904,50,17,65,16,148
2906,99,33,51,17,200
2907,98,17,51,17,183
2909,66,17,51,17,151
2910,65,35,66,18,184
2911,84,33,117,16,250
2912,68,33,117,16,234
2913,103,15,84,16,218
2914,51,17,117,16,201
2915,69,15,84,16,184
2917,284,32,51,18,385
2918,51,14,102,16,183
2920,84,16,166,18,284
2922,52,16,166,18,252
2923,66,18,67,16,167
2924,66,32,100,18,216
2925,66,16,100,18,200
2927,67,18,116,18,219
2928,67,33,67,16,183
2929,67,17,67,16,167
2930,151,18,67,15,251
2931,101,17,67,15,200
2932,65,35,67,15,182
2933,100,18,67,15,200
2934,67,34,67,15,183
2935,85,33,67,15,200
2936,102,34,132,17,285
2938,67,34,132,17,250
2941,301,18,67,15,401
2942,67,32,67,17,183
2943,52,32,67,17,168
2944,98,34,116,18,266
2946,99,34,64,18,215
2947,67,17,116,18,218
2948,67,34,64,18,183
2949,52,34,64,18,168
2952,98,36,67,15,216
2955,67,18,67,15,167
2957,83,34,65,16,198
2958,69,34,65,16,184
2959,51,34,65,16,166
2960,67,31,117,17,232
2961,99,17,66,17,199
2962,99,33,100,18,250
2963,66,17,66,17,166
2964,65,33,100,18,216
2965,50,33,100,18,201
2966,67,33,200,18,318
2968,83,17,51,16,167
2969,67,17,51,16,151
2972,67,34,117,16,234
2974,51,16,117,16,200
2975,50,34,83,16,183
2976,99,34,67,17,217
2977,65,16,52,16,149
2978,65,34,67,17,183
2980,65,34,101,17,217
2981,68,16,101,17,202
2982,52,16,101,17,186
2983,101,16,68,15,200
2984,67,33,68,15,183
2985,501,16,132,19,668
2987,65,18,98,19,200
2989,99,17,52,15,183
2990,68,32,52,15,167
2991,66,17,52,15,150
2994,65,34,67,16,182
2995,69,15,67,16,167
2996,52,15,67,16,150
2997,66,18,66,17,167
2998,101,34,100,17,252
3000,166,35,166,17,384
3001,84,32,169,15,300
3003,51,32,169,15,267
3006,65,35,166,17,283
3007,67,16,166,17,266
3009,102,16,132,19,269
3010,102,34,65,17,218
3011,67,16,132,19,234
3012,67,34,65,17,183
3014,51,18,65,17,151
3015,65,17,85,16,183
3016,49,17,85,16,167
3019,67,16,67,18,168
3020,50,16,67,18,151
3022,100,33,85,15,233
3023,518,32,151,17,718
3024,67,33,85,15,200
3026,65,34,101,15,215
3027,66,17,101,15,199
3028,67,34,99,18,218
3029,66,17,99,18,200
3031,51,32,100,17,200
3032,51,15,100,17,183
3033,166,18,65,17,266
3035,65,17,68,15,165
3036,100,35,65,17,217
3037,66,15,100,17,198
3038,65,35,65,17,182
3040,68,32,100,16,216
3041,65,17,100,16,198
3043,69,14,67,16,166
3044,99,33,67,17,216
3045,67,17,100,17,201
3047,81,35,65,17,198
3048,51,16,67,17,151
3050,68,32,151,17,268
3051,51,32,151,17,251
3052,67,33,51,15,166
3053,51,33,51,15,150
3054,99,32,52,17,200
3056,67,32,52,17,168
3058,51,15,52,17,135
3061,67,17,67,16,167
3062,52,17,67,16,152
3063,51,32,68,14,165
3064,165,36,97,19,317
3065,65,19,100,15,199
3066,67,33,67,15,182
3068,283,17,67,18,385
3071,66,18,97,19,200
3072,67,30,67,19,183
3073,102,17,82,17,218
3074,51,15,67,19,152
3075,84,31,51,17,183
3076,66,31,51,17,165
3078,67,35,100,18,220
3079,67,16,100,18,201
3082,51,17,67,18,153
3083,65,18,66,17,166
3084,67,33,68,15,183
3085,66,18,68,15,167
3086,100,35,65,18,218
3088,166,33,98,19,316
3089,68,18,65,18,169
3090,50,18,65,18,151
3093,67,16,131,19,233
3094,298,33,51,16,398
3095,68,15,98,19,200
3097,65,18,100,17,200
3098,167,33,50,16,266
3099,166,16,50,16,248
3100,98,36,66,17,217
3101,101,17,66,17,201
3103,68,17,66,17,168
3104,116,15,66,18,215
3105,67,16,50,16,149
3106,53,16,50,16,135
3107,68,15,66,18,167
3108,83,16,51,16,166
3109,66,16,51,16,149
3110,50,16,51,16,133
3111,64,17,53,16,150
3112,66,34,66,16,182
3113,165,18,84,17,284
3114,51,16,66,16,149
3116,53,16,65,17,151
3117,67,15,51,18,151
3118,66,34,84,17,201
3119,98,18,97,19,232
3121,66,18,97,19,200
3122,51,18,97,19,185
3123,102,17,66,18,203
3125,300,18,66,16,400
3126,66,31,53,15,165
3127,51,31,53,15,150
3128,64,35,65,20,184
3129,67,16,65,20,168
3130,66,33,52,15,166
3132,100,35,100,16,251
3133,66,15,68,17,166
3134,65,35,100,16,216
3136,52,15,100,16,183
3138,68,35,66,16,185
3139,65,18,66,16,165
3140,50,18,66,16,150
3142,67,34,65,18,184
3146,99,33,69,15,216
3147,52,31,52,17,152
3149,67,15,69,15,166
3150,64,36,99,18,217
3151,67,17,99,18,201
3152,52,17,99,18,186
3153,51,33,66,18,168
3155,299,18,83,16,416
3157,66,17,68,16,167
3158,166,33,68,15,282
3159,100,19,133,15,267
3161,66,19,133,15,233
3164,66,33,68,15,182
3165,51,33,68,15,167
3167,166,17,67,15,265
3168,65,36,83,16,200
3169,66,18,83,16,183
3170,68,31,52,16,167
3172,102,33,65,17,217
3175,68,16,65,17,166
3176,52,16,65,17,150
3177,50,34,66,15,165
3178,67,31,69,17,184
3180,100,34,132,18,284
3182,66,34,132,18,250
3183,102,15,67,18,202
3184,86,15,67,18,186
3185,69,15,67,18,169
3187,51,35,65,18,169
3188,99,33,68,16,216
3189,66,16,101,16,199
3192,65,34,50,17,166
3193,67,16,50,17,150
3196,51,17,216,16,300
3199,66,16,52,16,150
3201,101,16,69,14,200
3202,84,16,69,14,183
3203,68,16,69,14,167
3204,52,16,69,14,151
3206,103,30,66,17,216
3207,65,20,81,15,181
3208,83,16,66,17,182
3211,67,16,67,18,168
3212,164,33,67,15,279
3214,66,34,67,17,184
3216,168,33,51,16,268
3217,67,16,133,18,234
3218,52,16,133,18,219
3219,101,17,66,18,202
3220,50,17,67,15,149
3221,99,17,51,16,183
3222,67,33,51,16,167
3224,67,33,133,18,251
3225,65,18,133,18,234
3226,66,34,66,17,183
3227,84,32,67,18,201
3228,51,16,66,17,150
3229,52,32,67,18,169
3231,66,16,51,16,149
3232,167,33,51,17,268
3233,68,16,84,17,185
3234,85,16,101,17,219
3235,67,16,101,17,201
3236,51,16,101,17,185
3238,152,17,64,17,250
3239,83,34,67,15,199
3241,166,16,67,17,266
3242,67,34,64,17,182
3243,68,17,64,17,166
3244,51,17,64,17,149
3245,52,33,66,15,166
3247,65,16,67,17,165
3249,66,18,84,15,183
3250,66,32,100,17,215
3252,167,35,67,15,284
3256,100,35,67,15,217
3258,83,18,67,15,183
3259,65,18,67,15,165
3262,68,34,65,16,183
3263,66,19,65,16,166
3265,67,16,119,14,216
3267,68,16,99,18,201
3269,66,18,65,18,167
3270,50,18,65,18,151
3271,101,14,69,15,199
3272,67,32,69,15,183
3273,69,14,69,15,167
3274,65,34,99,18,216
3275,67,16,99,18,200
3277,165,16,167,16,364
3278,69,33,83,16,201
3279,283,33,67,17,400
3280,68,31,52,16,167
3281,99,16,167,16,298
3282,64,34,167,16,281
3283,67,16,167,16,266
3284,65,34,68,16,183
3286,168,33,67,17,285
3287,150,33,67,17,267
3288,102,32,67,17,218
3289,66,18,65,16,165
3290,167,33,100,15,315
3291,67,16,67,17,167
3293,50,33,67,17,167
3294,65,34,66,17,182
3295,65,18,66,17,166
3296,67,33,100,15,215
3297,67,16,100,15,198
3298,51,16,100,15,182
3299,51,33,134,16,234
3300,165,35,100,17,317
3301,99,17,67,16,199
3304,99,35,100,17,251
3306,65,35,100,17,217
3307,784,33,68,15,900
3309,52,34,83,17,186
3310,69,32,51,17,169
3311,50,32,51,17,150
3312,66,34,101,14,215
3314,83,17,67,14,181
3315,282,34,100,17,433
3316,100,35,66,15,216
3317,51,32,101,15,199
3318,66,35,66,15,182
3319,66,18,66,15,165
3321,51,31,50,18,150
3322,66,35,83,16,200
3324,66,33,50,16,165
3326,50,18,50,16,134
3327,50,32,67,18,167
3328,65,34,100,17,216
3330,50,16,100,17,183
3331,102,17,65,17,201
3332,67,35,65,17,184
3333,84,32,234,17,367
3334,100,33,68,16,217
3335,53,32,234,17,336
3336,67,33,68,16,184
3342,68,33,65,18,184
3343,84,33,67,17,201
3344,65,33,67,17,182
3345,50,33,67,17,167
3346,50,16,67,17,150
3348,65,35,132,18,250
3349,66,17,132,18,233
3350,67,33,68,15,183
3352,52,16,68,15,151
3353,50,33,66,18,167
3354,166,33,83,19,301
3355,99,16,85,17,217
3356,51,17,65,16,149
3357,67,16,85,17,185
3358,66,34,51,17,168
3360,65,33,83,19,200
3362,50,17,83,19,169
3364,100,35,64,18,217
3366,166,33,67,18,284
3367,65,19,64,18,166
3368,83,16,65,19,183
3369,52,32,65,19,168
3370,51,16,65,19,151
3371,51,32,52,14,149
3372,64,33,67,18,182
3373,100,14,101,18,233
3374,65,33,101,18,217
3376,100,34,85,16,235
3377,67,15,67,18,167
3378,67,34,85,16,202
3379,66,16,85,16,183
3381,166,17,68,16,267
3383,101,16,132,19,268
3384,85,16,132,19,252
3385,68,16,132,19,235
3386,101,33,85,14,233
3387,66,17,68,16,167
3388,84,16,85,14,199
3393,67,15,67,17,166
3396,700,32,99,17,848
3397,66,16,117,16,215
3398,84,17,83,16,200
3399,65,17,83,16,181
3400,51,17,83,16,167
3401,68,14,51,16,149
3402,168,32,101,18,319
3403,68,16,67,17,168
3404,51,16,67,17,151
3406,51,16,67,18,152
3407,165,18,51,14,248
3408,167,33,100,16,316
3409,68,15,101,18,202
3410,52,15,101,18,186
3411,69,16,85,14,184
3413,65,18,51,14,148
3415,66,17,100,16,199
3417,51,32,133,18,234
3419,68,14,67,18,167
3420,65,35,83,16,199
3421,64,18,83,16,181
3422,68,32,184,17,301
3423,99,15,151,17,282
3424,67,33,151,17,268
3425,68,15,151,17,251
3427,67,16,52,16,151
3428,51,16,52,16,135
3430,86,16,66,16,184
3431,50,34,66,16,166
3432,52,16,66,16,150
3434,68,32,99,17,216
3435,150,31,51,17,249
3436,66,34,65,17,182
3438,100,31,51,17,199
3439,51,34,64,18,167
3441,52,31,51,17,151
3442,165,34,67,16,282
3443,66,16,67,19,168
3444,64,35,66,16,181
3445,67,17,66,16,166
3447,102,15,67,16,200
3448,67,34,67,16,184
3450,51,15,67,16,149
3451,66,19,64,19,168
3452,101,32,68,16,217
3453,65,17,67,16,165
3454,99,35,68,16,218
3455,167,19,199,16,401
3456,64,35,68,16,183
3458,67,33,151,17,268
3459,51,33,151,17,252
3460,68,35,199,16,318
3461,84,32,84,17,217
3462,68,32,84,17,201
3463,52,32,84,17,185
3464,67,34,67,16,184
3465,85,32,67,17,201
3466,165,34,99,16,314
3467,50,32,67,17,166
3468,101,32,66,18,217
3469,68,17,66,16,167
3470,67,32,66,18,183
3473,66,17,99,16,198
3474,66,32,101,18,217
3475,66,16,101,18,201
3477,99,17,68,15,199
3478,66,33,68,15,182
3479,151,32,66,18,267
3480,101,34,98,18,251
3484,68,32,66,18,184
3485,52,32,66,18,168
3489,67,16,66,19,168
3490,66,36,65,17,184
3491,66,18,65,17,166
3492,150,16,68,16,250
3493,101,16,101,16,234
3494,101,33,68,16,218
3495,67,16,101,16,200
3496,82,16,68,16,182
3498,52,16,68,16,152
3500,67,34,65,16,182
3502,52,16,65,16,149
3505,65,16,68,16,165
3506,666,33,84,16,799
3508,100,32,66,17,215
3509,84,32,66,17,199
3510,68,32,66,17,183
3511,100,18,68,15,201
3513,116,36,66,15,233
3515,82,36,66,15,199
3520,168,33,100,17,318
3524,300,32,68,16,416
3527,84,33,67,17,201
3529,101,15,51,16,183
3530,99,34,67,16,216
3532,100,33,66,19,218
3533,66,17,67,16,166
3534,84,16,66,19,185
3537,50,34,67,17,168
3538,300,33,101,17,451
3541,99,16,84,16,215
3542,67,33,84,16,200
3543,68,16,84,16,184
3545,65,18,132,17,232
3546,67,33,66,17,183
3547,83,33,83,17,216
3550,50,16,83,17,166
3551,51,33,67,18,169
3553,99,17,67,17,200
3554,50,16,101,17,184
3555,67,17,67,17,168
3556,50,17,67,17,151
3557,100,17,85,14,216
3558,52,15,101,18,186
3559,67,17,85,14,183
3560,67,34,51,14,166
3561,166,15,51,17,249
3563,167,18,97,17,299
3564,67,32,84,17,200
3565,68,14,84,17,183
3566,149,17,65,17,248
3567,67,15,51,17,150
3568,50,15,51,17,133
3569,299,14,68,15,396
3570,69,32,65,17,183
3571,66,17,65,17,165
3572,51,17,65,17,150
3573,100,15,53,15,183
3574,97,34,69,16,216
3575,99,17,69,16,201
3576,65,34,69,16,184
3577,167,14,68,15,264
3578,67,34,65,18,184
3579,68,15,65,18,166
3582,99,35,66,18,218
3583,66,14,68,15,163
3584,100,33,67,16,216
3586,65,33,67,16,181
3587,66,16,67,16,165
3588,52,16,67,16,151
3589,101,16,183,17,317
3590,66,34,183,17,300
3594,67,34,116,17,234
3595,67,16,116,17,216
3596,67,33,83,17,200
3597,100,17,168,15,300
3598,67,33,168,15,283
3599,65,17,168,15,265
3600,66,33,67,17,183
3601,100,17,101,15,233
3602,66,34,101,15,216
3603,84,33,101,15,233
3607,100,18,65,17,200
3608,50,16,132,18,216
3609,166,15,69,17,267
3610,68,33,217,14,332
3612,68,32,50,17,167
3613,66,17,50,17,150
3615,100,17,118,14,249
3619,101,15,52,14,182
3620,69,32,52,14,167
3621,68,15,52,14,149
3622,66,35,66,18,185
3624,67,31,152,15,265
3625,99,17,66,18,200
3627,102,19,62,18,201
3629,166,15,52,15,248
3630,53,19,62,18,152
3632,66,33,68,17,184
3633,66,15,68,17,166
3635,67,15,52,15,149
3636,101,32,67,18,218
3637,100,15,67,18,200
3638,68,32,67,18,185
3640,301,35,64,17,417
3641,67,16,68,16,167
3643,66,16,51,17,150
3644,102,33,67,16,218
3645,67,17,100,16,200
3647,51,33,67,16,167
3649,66,17,101,15,199
3650,149,18,64,17,248
3651,84,32,99,17,232
3652,99,35,64,17,215
3655,85,31,102,15,233
3657,799,18,165,18,1000
3658,168,31,52,16,267
3660,64,35,65,19,183
3661,84,34,132,18,268
3663,86,31,52,16,185
3664,69,31,52,16,168
3665,301,17,67,16,401
3666,65,35,100,17,217
3667,84,33,84,16,217
3668,66,33,84,16,199
3669,51,33,84,16,184
3670,52,16,84,16,168
3671,783,32,67,17,899
3672,66,34,67,16,183
3676,51,16,67,16,150
3678,100,32,101,16,249
3679,66,17,67,16,166
3680,166,34,66,18,284
3681,101,17,66,16,200
3682,166,32,102,16,316
3683,84,32,100,18,234
3684,67,32,100,18,217
3686,67,34,66,18,185
3688,150,16,68,16,250
3689,116,34,68,16,234
3690,50,16,102,16,184
3691,82,34,68,16,200
3692,66,34,68,16,184
3693,100,18,66,16,200
3696,550,18,82,19,669
3701,284,32,67,17,400
3702,66,32,68,16,182
3703,66,16,68,16,166
3704,50,16,68,16,150
3705,152,31,51,16,250
3707,66,18,65,18,167
3708,168,32,67,17,284
3713,67,17,82,17,183
3714,82,16,67,17,182
3715,150,33,150,19,352
3716,51,16,67,17,151
3717,167,16,116,19,318
3718,99,33,150,19,301
3722,66,34,116,19,235
3723,68,16,116,19,219
3724,101,31,51,19,202
3726,68,31,51,19,169
3727,66,15,51,19,151
3729,100,19,64,18,201
3731,85,32,101,15,233
3733,101,15,134,16,266
3735,68,15,134,16,233
3737,100,17,200,18,335
3739,67,17,200,18,302
3740,52,17,200,18,287
3742,167,35,52,13,267
3743,98,17,102,18,235
3744,65,33,102,18,218
3745,66,17,102,18,203
3746,98,35,52,13,198
3749,67,18,52,13,150
3752,51,18,132,18,219
3756,65,33,52,16,166
3758,67,34,68,16,185
3759,66,17,68,16,167
3760,50,17,68,16,151
3761,51,34,66,16,167
3762,52,16,66,16,150
3763,51,34,64,17,166
3764,68,32,100,16,216
3765,98,16,269,16,399
3766,98,35,84,16,233
3767,66,16,269,16,367
3768,64,35,84,16,199
3769,65,18,84,16,183
3773,67,19,64,18,168
3774,300,33,66,16,415
3778,100,32,66,16,214
3780,100,34,233,15,382
3782,68,34,233,15,350
3783,68,16,233,15,332
3784,66,32,67,17,182
3786,165,34,168,15,382
3788,99,32,68,16,215
3789,100,15,68,16,199
3790,67,32,68,16,183
3792,65,34,168,15,282
3793,284,33,100,17,434
3794,66,34,99,17,216
3795,83,34,65,17,199
3796,68,34,65,17,184
3798,68,33,67,15,183
3799,85,32,101,17,235
3800,99,35,66,17,217
3801,51,32,101,17,201
3802,65,35,66,17,183
3803,100,18,100,16,234
3804,67,33,100,16,216
3805,66,18,100,16,200
3806,101,35,65,17,218
3807,51,33,100,17,201
3808,66,35,65,17,183
3809,68,18,65,17,168
3810,100,33,68,16,217
3812,100,33,67,17,217
3813,83,33,67,17,200
3814,65,33,67,17,182
3815,51,33,67,17,168
3816,66,35,65,18,184
3817,67,18,65,18,168
3821,101,16,66,16,199
3822,65,34,66,16,181
3823,100,16,66,18,200
3825,67,16,66,18,167
3827,65,17,66,17,165
3828,482,18,66,16,582
3830,99,34,67,16,216
3832,100,35,65,16,216
3833,50,34,67,16,167
3834,86,16,65,16,183
3836,53,16,65,16,150
3837,52,32,67,17,168
3838,67,33,67,15,182
3839,97,18,165,17,297
3841,484,32,99,17,632
3843,484,32,67,17,600
3844,51,16,67,17,151
3846,66,34,65,17,182
3847,66,17,65,17,165
3849,102,15,168,16,301
3853,284,32,99,17,432
3854,67,34,99,16,216
3855,67,17,99,16,199
3856,152,16,68,14,250
3857,302,16,67,17,402
3859,65,17,67,18,167
3860,83,16,68,14,181
3861,152,32,99,17,300
3865,84,32,99,17,232
3867,66,18,99,17,200
3868,67,32,67,17,183
3869,66,15,67,17,165
3870,83,16,67,17,183
3871,69,16,67,17,169
3873,99,18,66,15,198
3875,65,18,66,15,164
3876,84,15,134,17,250
3877,151,32,67,17,267
3879,150,34,68,16,268
3880,166,33,66,18,283
3881,64,19,66,17,166
3882,68,32,67,17,184
3884,66,34,68,16,184
3885,51,34,68,16,169
3887,100,18,82,16,216
3888,67,35,82,16,200
3889,65,18,82,16,181
3890,68,31,51,16,166
3891,100,18,64,16,198
3892,51,15,51,16,133
3894,67,31,67,17,182
3895,51,31,67,17,166
3897,65,17,51,18,151
3898,80,18,66,18,182
3899,100,18,99,18,235
3900,49,18,66,18,151
3901,68,18,99,18,203
3902,168,35,114,18,335
3903,53,31,86,17,187
3904,99,35,67,16,217
3905,67,15,53,17,152
3907,65,18,67,16,166
3911,101,17,101,16,235
3912,67,33,101,16,217
3913,65,17,101,16,199
3914,65,32,85,18,200
3915,64,17,85,18,184
3916,100,34,65,18,217
3918,67,34,65,18,184
3919,52,34,65,18,169
3921,52,34,64,19,169
3924,65,33,101,17,216
3925,67,15,101,17,200
3927,69,14,68,17,168
3928,52,14,68,17,151
3929,65,17,117,18,217
3930,67,34,67,16,184
3931,82,32,102,15,231
3932,68,32,102,15,217
3933,501,16,66,17,600
3934,66,35,200,16,317
3935,67,18,200,16,301
3936,67,34,99,16,216
3937,50,34,99,16,199
3939,52,33,66,16,167
3940,99,34,133,19,285
3941,51,32,67,17,167
3942,166,32,53,14,265
3943,84,33,66,16,199
3945,101,17,85,14,217
3946,101,32,53,14,200
3947,68,17,85,14,184
3949,167,16,51,16,250
3950,66,34,100,17,217
3951,65,18,100,17,200
3952,85,14,67,17,183
3953,50,33,67,17,167
3955,68,16,51,16,151
3956,166,33,66,20,285
3957,81,33,66,17,197
3959,67,16,66,17,166
3961,101,15,66,20,202
3962,66,33,66,20,185
3963,99,18,117,15,249
3964,51,15,66,20,152
3965,67,18,117,15,217
3966,68,31,68,18,185
3967,101,15,101,16,233
3969,69,15,101,16,201
3972,52,16,68,16,152
3974,51,15,66,18,150
3976,150,18,98,21,287
3977,66,15,188,13,282
3978,168,32,134,17,351
3979,66,18,84,14,182
3980,67,33,98,21,219
3981,84,33,149,17,283
3982,51,18,98,21,188
3984,66,32,134,17,249
3986,65,33,134,17,249
3987,103,13,67,17,200
3990,101,33,50,17,201
3991,51,34,232,18,335
3994,50,17,50,17,134
3995,66,16,133,17,232
3997,67,17,99,17,200
3999,517,33,67,16,633
4000,67,34,99,18,218
4001,84,32,67,18,201
4002,67,32,67,18,184
4003,718,32,66,16,832
4004,66,33,67,18,184
4005,68,16,67,18,169
4006,65,34,116,18,233
4008,168,33,84,16,301
4009,68,15,101,16,200
4010,52,15,101,16,184
4011,98,19,100,17,234
4013,64,19,100,17,200
4015,65,18,84,16,183
4020,67,33,67,16,183
4021,51,33,67,16,167
4022,51,16,67,16,150
4024,66,34,100,16,216
4026,67,33,67,16,183
4027,84,32,100,19,235
4029,51,32,100,19,202
4031,84,32,52,16,184
4032,67,32,52,16,167
4033,166,17,66,16,265
4035,68,14,102,16,200
4036,65,35,99,16,215
4038,167,34,83,16,300
4040,68,34,98,16,216
4041,64,19,98,16,197
4042,67,32,66,16,181
4043,83,34,83,16,216
4045,168,16,52,16,252
4046,149,16,52,16,233
4047,98,19,66,18,201
4048,66,35,66,18,185
4049,66,19,66,18,169
4050,99,34,66,17,216
4051,65,16,52,16,149
4052,67,34,66,17,184
4053,168,22,129,16,335
4054,66,34,71,12,183
4055,68,16,71,12,167
4056,100,39,129,16,284
4058,66,39,129,16,250
4060,71,28,101,16,216
4061,55,28,101,16,200
4062,51,16,101,16,184
4063,67,17,67,16,167
4064,179,17,98,18,312
4065,66,16,51,15,148
4066,66,35,132,19,252
4068,83,15,70,15,183
4071,68,17,98,18,201
4072,67,34,64,18,183
4076,65,33,85,17,200
4077,69,14,85,17,185
4079,67,16,68,15,166
4081,64,18,67,16,165
4083,67,17,65,17,166
4085,168,16,133,17,334
4086,166,32,69,16,283
4087,66,16,168,16,266
4089,285,31,52,16,384
4093,67,15,69,16,167
4095,100,17,67,15,199
4096,101,32,66,18,217
4097,67,17,67,15,166
4099,100,18,66,17,201
4100,65,35,66,17,183
4101,66,18,66,17,167
4103,51,31,52,16,150
4104,66,35,66,18,185
4105,49,35,66,18,168
4106,150,15,66,19,250
4107,518,34,65,18,635
4108,52,16,51,15,134
4109,101,15,66,19,201
4110,66,33,66,19,184
4111,518,31,68,14,631
4112,151,14,68,17,250
4113,64,19,50,14,147
4115,65,16,68,16,165
4116,66,33,68,17,184
4117,101,17,66,18,202
4118,149,16,68,15,248
4120,68,33,51,15,167
4122,85,16,68,15,184
4123,67,16,68,15,166
4124,50,16,68,15,149
4126,51,15,135,15,216
4127,67,17,66,16,166
4128,68,33,101,15,217
4129,100,16,102,14,232
4130,50,18,101,15,184
4131,67,16,102,14,199
4132,66,34,68,14,182
4133,100,19,65,18,202
4134,67,34,65,18,184
4135,65,19,65,18,167
4136,68,34,163,18,283
4137,52,34,163,18,267
4138,68,31,68,14,181
4141,151,31,102,17,301
4143,68,17,99,17,201
4145,64,19,66,17,166
4147,167,16,68,15,266
4148,64,35,67,17,183
4149,85,35,65,16,201
4150,66,35,65,16,182
4151,51,35,65,16,167
4154,100,35,66,16,217
4155,99,19,66,16,200
4157,99,17,68,14,198
4159,99,18,67,16,200
4160,67,34,67,16,184
4162,66,34,64,18,182
4163,85,33,83,15,216
4164,101,31,52,15,199
4165,52,33,83,15,183
4166,67,31,52,15,165
4167,51,31,52,15,149
4168,64,34,66,17,181
4169,68,16,66,17,167
4170,65,33,101,18,217
4171,67,15,101,18,201
4174,66,34,52,14,166
4175,65,17,52,14,148
4177,67,16,81,19,183
4179,51,32,68,18,169
4180,52,14,68,18,152
4181,65,19,98,18,200
4183,63,19,66,18,166
4184,68,34,66,15,183
4185,99,18,66,18,201
4187,67,18,66,18,169
4190,66,32,53,16,167
4191,52,32,53,16,153
4192,66,34,66,19,185
4194,85,16,66,15,182
4195,51,35,66,15,167
4196,100,35,101,14,250
4197,101,16,101,14,232
4199,148,35,63,18,264
4200,66,33,131,18,248
4203,82,35,63,18,198
4204,84,17,63,18,182
4205,51,35,63,18,167
4206,51,17,63,18,149
4208,66,32,134,17,249
4209,66,14,134,17,231
4210,166,31,66,20,283
4211,85,33,99,18,235
4213,83,34,97,20,234
4214,103,31,66,20,220
4215,85,31,66,20,202
4217,52,31,66,20,169
4218,151,16,65,20,252
4219,303,15,65,18,401
4221,68,14,69,16,167
4222,52,14,69,16,151
4223,69,16,65,20,170
4225,67,16,68,16,167
4226,101,36,83,17,237
4227,65,16,102,17,200
4228,85,16,83,17,201
4229,68,16,83,17,184
4230,52,16,83,17,168
4231,103,15,65,18,201
4232,102,34,66,15,217
4236,52,17,66,15,150
4237,98,17,82,18,215
4239,66,17,82,18,183
4240,66,32,118,15,231
4243,66,17,84,15,182
4244,100,33,99,18,250
4245,167,16,52,15,250
4246,101,32,268,17,418
4247,167,16,100,18,301
4249,68,15,268,17,368
4250,65,33,52,15,165
4251,67,16,52,15,150
4252,65,34,100,18,217
4253,66,16,100,18,200
4254,51,16,100,18,185
4255,50,33,67,18,168
4256,52,15,67,18,152
4257,65,18,100,16,199
4259,65,17,151,16,249
4260,100,34,64,20,218
4262,100,34,50,16,200
4265,65,18,50,16,149
4267,101,16,99,18,234
4268,64,36,99,18,217
4269,168,15,51,17,251
4270,100,33,68,15,216
4271,49,34,65,18,166
4272,103,32,51,17,203
4274,67,32,51,17,167
4276,50,15,51,17,133
4278,68,32,99,19,218
4280,103,31,52,14,200
4281,85,31,52,14,182
4283,52,31,52,14,149
4284,66,33,68,17,184
4286,64,33,52,15,164
4287,69,14,52,15,150
4288,52,14,52,15,133
4289,66,17,66,18,167
4290,285,15,68,16,384
4293,68,15,133,18,234
4295,67,15,100,18,200
4296,52,15,100,18,185
4297,166,15,68,16,265
4298,67,33,66,18,184
4300,50,17,66,18,151
4301,51,33,101,16,201
4303,68,15,68,16,167
4308,68,33,84,16,201
4309,50,33,84,16,183
4311,68,16,51,16,151
4312,99,34,67,16,216
4315,166,18,83,16,283
4316,51,16,67,16,150
4317,168,18,100,15,301
4318,67,34,68,15,184
4320,51,16,68,15,150
4321,65,18,83,16,182
4323,66,18,100,15,199
4324,68,32,102,15,217
4326,66,33,69,15,183
4327,152,31,100,15,298
4328,100,34,63,17,214
4329,50,35,132,15,232
4331,165,18,66,16,265
4332,69,31,100,15,215
4336,63,35,66,16,180
4337,65,18,66,16,165
4338,67,33,66,18,184
4339,98,18,51,15,182
4340,68,33,51,15,167
4342,66,33,88,14,201
4343,51,33,88,14,186
4345,51,33,69,15,168
4347,50,34,66,18,168
4348,169,32,50,17,268
4349,70,14,67,16,167
4350,69,31,101,17,218
4351,52,31,101,17,201
4354,67,32,50,17,166
4357,65,18,65,19,167
4358,65,34,98,17,214
4360,50,17,98,17,182
4361,167,17,68,16,268
4362,301,32,100,17,450
4363,67,15,50,17,149
4364,50,15,50,17,132
4365,66,16,68,16,166
4366,67,34,68,16,185
4367,65,17,68,16,166
4368,50,17,68,16,151
4370,84,18,167,14,283
4371,152,32,100,17,301
4374,67,34,100,14,215
4376,67,32,100,17,216
4379,301,16,66,16,399
4380,51,14,133,18,216
4381,149,33,101,17,300
4382,68,32,66,18,184
4383,63,18,66,18,165
4385,51,33,167,17,268
4386,65,33,101,17,216
4387,51,33,101,17,202
4389,83,33,100,16,232
4390,67,33,100,16,216
4391,50,33,100,16,199
4392,67,34,66,16,183
4394,51,16,66,16,149
4397,66,16,102,15,199
4398,66,33,102,15,216
4400,49,17,102,15,183
4401,67,16,68,15,166
4404,102,31,69,15,217
4405,51,33,100,15,199
4406,68,31,69,15,183
4407,65,16,69,15,165
4408,64,37,98,15,214
4411,53,32,66,15,166
4412,69,31,118,18,236
4413,52,31,118,18,219
4414,98,31,168,17,314
4415,66,18,83,18,185
4417,51,31,168,17,267
4419,68,15,83,17,183
4420,65,36,64,17,182
4421,50,36,64,17,167
4422,52,18,64,17,151
4424,167,35,82,18,302
4425,82,34,50,18,184
4427,99,16,117,18,250
4428,67,33,117,18,235
4429,101,18,82,18,219
4430,67,35,82,18,202
4431,85,32,99,19,235
4432,50,18,82,18,168
4434,99,36,50,17,202
4435,66,16,67,19,168
4437,66,18,50,17,151
4438,68,31,100,18,217
4439,52,31,100,18,201
4442,149,15,53,17,234
4443,52,32,65,18,167
4444,68,32,86,17,203
4445,67,14,86,17,184
4446,64,33,53,17,167
4448,50,15,53,17,135
4449,65,16,68,16,165
4450,67,36,98,17,218
4451,68,17,98,17,200
4452,53,17,98,17,185
4453,52,32,66,17,167
4454,68,33,99,17,217
4455,148,33,51,16,248
4457,99,16,66,18,199
4458,66,33,66,18,183
4460,66,33,51,16,166
4461,51,33,51,16,151
4465,66,16,201,18,301
4467,50,33,66,20,169
4468,67,34,101,16,218
4469,67,16,101,16,200
4470,67,32,69,16,184
4471,469,15,67,18,569
4472,86,15,67,18,186
4473,83,34,51,15,183
4474,52,15,67,18,152
4475,100,17,67,17,201
4477,100,15,66,17,198
4480,51,15,66,17,149
4481,50,34,100,17,201
4482,151,16,132,19,318
4483,81,34,51,16,182
4484,100,34,132,19,285
4485,169,16,66,19,270
4486,66,34,132,19,251
4487,67,16,132,19,234
4488,52,16,132,19,219
4489,151,32,67,18,268
4490,51,16,67,17,151
4491,66,16,66,19,167
4492,100,32,67,18,217
4493,83,32,67,18,200
4495,50,32,67,18,167
4497,50,35,165,18,268
4498,67,32,100,17,216
4499,100,16,66,17,199
4500,67,34,66,17,184
4501,66,16,66,17,165
4502,50,16,66,17,149
4503,51,33,66,18,168
4504,100,33,52,16,201
4505,82,33,52,16,183
4506,151,16,65,17,249
4507,67,16,52,16,151
4508,66,33,67,16,182
4509,69,15,67,16,167
4510,66,35,65,17,183
4512,100,33,119,15,267
4513,50,32,69,16,167
4517,285,33,68,14,400
4518,69,31,85,15,200
4520,102,32,67,17,218
4521,102,15,67,17,201
4522,98,33,68,16,215
4523,100,15,68,16,199
4524,67,33,68,16,184
4525,67,15,68,16,166
4526,50,15,68,16,149
4527,65,17,67,17,166
4528,151,15,68,17,251
4530,51,17,50,15,133
4533,50,32,68,17,167
4536,68,32,84,16,200
4538,152,16,67,16,251
4540,65,34,83,17,199
4542,67,33,67,16,183
4543,67,16,67,16,166
4545,101,17,66,20,204
4546,100,32,54,13,199
4547,301,22,93,16,432
4548,67,32,54,13,166
4549,100,18,101,14,233
4550,99,33,68,14,214
4551,65,18,101,14,198
4552,66,33,68,14,181
4553,83,34,66,19,202
4554,54,13,68,14,149
4555,51,34,66,19,170
4556,67,34,73,9,183
4557,81,32,118,16,247
4559,52,32,118,16,218
4560,107,25,68,16,216
4561,69,22,93,16,200
4562,73,25,68,16,182
4565,99,16,100,16,231
4566,109,17,101,16,243
4567,166,18,132,17,333
4568,68,33,101,16,218
4569,65,17,101,16,199
4571,98,18,132,17,265
4572,67,33,132,17,249
4573,66,18,132,17,233
4574,101,31,67,17,216
4575,66,18,65,17,166
4576,67,31,67,17,182
4577,102,15,50,17,184
4578,50,15,67,17,149
4581,66,16,68,17,167
4582,84,17,51,16,168
4583,65,17,51,16,149
4584,50,17,51,16,134
4585,101,16,68,15,200
4587,300,18,65,17,400
4588,51,16,68,15,150
4589,66,16,101,16,199
4590,66,35,98,18,217
4591,66,18,98,18,200
4593,51,33,83,15,182
4594,301,31,53,15,400
4595,51,33,100,15,199
4596,98,33,67,18,216
4597,101,15,67,18,201
4599,100,18,65,17,200
4601,66,18,65,17,166
4603,100,15,102,17,234
4605,100,18,67,17,202
4606,65,35,67,17,184
4607,67,18,67,17,169
4608,68,31,53,15,167
4609,50,31,53,15,149
4610,66,36,66,16,184
4611,68,17,66,16,167
4612,84,15,100,18,217
4613,84,34,66,18,202
4614,102,32,52,16,202
4615,167,16,98,18,299
4616,66,32,52,16,166
4621,84,33,117,15,249
4623,51,33,117,15,216
4624,67,32,85,15,199
4625,66,15,85,15,181
4628,517,15,69,15,616
4629,66,17,67,15,165
4630,68,32,102,16,218
4631,67,15,102,16,200
4632,301,34,51,17,403
4633,151,33,67,15,266
4634,99,35,67,16,217
4635,99,18,67,16,200
4636,67,35,67,16,185
4638,284,17,64,17,382
4641,68,17,134,16,235
4642,100,32,69,16,217
4644,67,32,69,16,184
4645,50,32,69,16,167
4646,65,34,51,17,167
4647,67,16,51,17,151
4648,66,35,64,18,183
4649,51,35,64,18,168
4650,85,17,64,17,183
4652,51,17,64,17,149
4653,52,31,102,15,200
4654,64,33,69,15,181
4656,64,34,100,16,214
4657,100,18,65,16,199
4658,50,17,100,16,183
4659,66,18,65,16,165
4660,84,17,67,17,185
4662,50,17,67,17,151
4663,83,34,66,17,200
4664,99,33,66,19,217
4666,84,16,66,19,185
4667,66,16,66,19,167
4668,502,32,51,16,601
4669,51,33,52,16,152
4670,66,33,68,18,185
4671,101,16,99,16,232
4673,67,16,99,16,198
4674,52,16,99,16,183
4675,102,15,66,18,201
4676,68,33,66,18,185
4677,98,17,68,15,198
4678,51,15,66,18,150
4679,66,17,68,15,166
4680,66,33,50,18,167
4682,167,33,100,16,316
4683,85,33,99,17,234
4684,68,33,99,17,217
4686,50,18,99,17,184
4687,65,18,66,17,166
4688,865,34,99,18,1016
4689,66,18,100,16,200
4690,66,33,67,16,182
4691,68,16,67,16,167
4692,101,32,51,16,200
4694,68,32,51,16,167
4695,67,16,51,16,150
4696,101,33,66,18,218
4697,66,18,182,19,285
4698,83,16,66,18,183
4701,51,32,52,15,150
4702,99,33,69,15,216
4703,82,33,69,15,199
4704,66,33,69,15,183
4705,899,16,50,18,983
4708,67,35,66,15,183
4710,103,32,82,17,234
4711,50,34,63,18,165
4714,66,31,51,17,165
4716,99,32,101,15,247
4718,166,34,99,16,315
4719,52,32,101,15,200
4721,300,16,100,17,433
4723,51,33,100,17,201
4724,167,33,100,16,316
4725,68,18,99,16,201
4726,101,32,133,16,282
4727,51,34,65,16,166
4728,299,33,67,17,416
4729,101,16,100,16,233
4731,68,16,100,16,200
4732,65,33,67,16,181
4733,66,17,67,16,166
4735,549,33,68,17,667
4737,50,34,99,18,201
4741,65,17,68,15,165
4742,166,34,66,17,283
4743,101,17,66,16,200
4745,536,17,64,16,633
4750,66,33,101,15,215
4753,100,16,50,18,184
4754,1034,34,65,17,1150
4759,550,34,66,18,668
4760,101,33,101,17,252
4761,51,33,66,17,167
4762,66,33,101,17,217
4763,68,16,101,17,202
4766,66,36,64,19,185
4768,69,32,51,17,169
4770,100,36,64,16,216
4771,83,36,64,16,199
4772,83,17,64,16,180
4773,166,21,63,17,267
4774,51,17,64,16,148
4775,152,31,67,15,265
4776,86,14,201,15,316
4777,149,32,67,16,264
4778,101,31,67,15,214
4779,86,31,67,15,199
4780,69,31,67,15,182
4783,52,32,67,16,167
4784,98,32,68,15,213
4785,64,18,100,15,197
4787,51,32,68,15,166
4788,67,34,66,18,185
4789,84,34,67,15,200
4791,51,34,67,15,167
4792,68,32,101,15,216
4793,285,33,67,16,401
4794,66,35,233,15,349
4795,51,35,233,15,334
4796,67,32,66,18,183
4797,101,17,65,17,200
4799,83,32,50,18,183
4804,65,35,67,15,182
4805,67,18,67,15,167
4806,50,18,67,15,150
4808,102,33,69,13,217
4810,100,34,65,17,216
4811,65,18,69,13,165
4814,166,34,98,19,317
4815,87,30,68,15,200
4816,69,30,68,15,182
4818,99,34,98,19,250
4820,64,34,98,19,215
4821,51,34,98,19,202
4823,51,31,86,14,182
4825,68,16,51,14,149
4826,98,33,69,15,215
4827,67,16,52,16,151
4828,86,14,69,15,184
4829,100,16,66,18,200
4831,101,17,133,16,267
4833,66,17,133,16,232
4834,69,32,67,16,184
4835,65,17,67,16,165
4836,66,33,68,16,183
4837,67,15,68,16,166
4838,65,34,100,15,214
4840,50,17,100,15,182
4841,65,18,66,15,164
4842,50,18,66,15,149
4845,66,18,66,17,167
4847,50,33,166,17,266
4849,151,33,101,16,301
4850,166,33,101,17,317
4853,66,16,66,17,165
4855,50,33,101,16,200
4856,98,35,66,17,216
4857,66,16,101,17,200
4859,285,32,51,16,384
4861,100,17,66,18,201
4862,101,33,66,18,218
4864,165,35,66,17,283
4867,50,33,51,17,151
4868,99,35,66,17,217
4870,66,35,66,17,184
4871,67,17,66,17,167
4872,100,34,66,17,217
4873,67,15,51,16,149
4874,67,34,66,17,184
4877,66,16,67,18,167
4881,66,17,99,18,200
4882,166,34,84,16,300
4883,67,15,66,18,166
4884,52,15,66,18,151
4885,66,18,66,19,169
4887,81,34,84,16,215
4888,100,33,100,17,250
4889,68,16,84,16,184
4890,66,33,100,17,216
4892,53,14,100,17,184
4893,66,16,202,16,300
4894,66,34,100,17,217
4895,97,17,67,17,198
4896,100,35,100,16,251
4898,67,35,100,16,218
4899,84,32,68,16,200
4900,68,32,68,16,184
4902,50,17,68,16,151
4903,67,17,100,15,199
4904,66,34,116,17,233
4906,51,17,116,17,201
4907,99,18,50,17,184
4909,65,18,50,17,150
4911,65,18,84,17,184
4912,168,32,134,16,350
4913,51,34,67,15,167
4914,50,17,67,15,149
4915,102,17,66,16,201
4917,150,33,101,15,299
4918,99,34,167,17,317
4919,100,17,167,17,301
4920,300,34,67,16,417
4921,66,17,167,17,267
4922,66,33,101,15,215
4923,101,16,68,15,200
4924,67,33,68,15,183
4925,67,16,68,15,166
4927,50,34,67,17,168
4930,101,33,66,18,218
4931,51,33,67,16,167
4932,100,34,67,16,217
4933,51,33,66,18,168
4934,100,32,51,15,198
4935,101,16,51,15,183
4937,66,16,51,15,148
4939,86,31,68,17,202
4940,67,31,68,17,183
4942,51,15,68,17,151
4943,100,16,66,17,199
4945,100,15,102,16,233
4946,52,16,66,17,151
4949,99,17,50,17,183
4951,100,17,82,17,216
4952,68,34,82,17,201
4954,51,17,82,17,167
4955,51,33,66,17,167
4956,50,17,66,17,150
4957,99,17,66,16,198
4958,165,34,51,16,266
4960,66,32,68,17,183
4962,65,34,68,17,184
4964,66,34,51,16,167
4965,65,18,51,16,150
4966,68,34,67,15,184
4967,166,19,165,16,366
4968,51,17,67,15,150
4969,52,33,97,19,201
4970,51,16,97,19,183
4972,165,34,67,16,282
4973,84,29,136,16,265
4974,301,32,70,7,410
4976,63,35,69,15,182
4977,83,34,67,16,200
4978,64,34,67,16,181
4980,549,17,67,16,649
4981,68,17,65,16,166
4982,101,33,67,17,218
4985,65,17,67,17,166
4987,548,31,85,17,681
4988,100,33,114,16,263
4989,52,32,70,7,161
4992,102,28,181,17,328
4996,114,16,65,20,215
4997,77,16,65,20,178
4998,70,16,65,20,171
4999,82,15,68,16,181
5000,102,14,169,16,301
5001,100,35,67,19,221
5002,67,14,169,16,266
5004,68,15,67,19,169
5006,49,33,135,14,231
5007,51,17,135,14,217
5010,152,31,85,17,285
5011,53,16,97,18,184
5013,67,34,98,18,217
5014,147,33,66,19,265
5018,83,33,66,19,201
5019,1197,34,66,18,1315
5020,303,18,132,16,469
5021,67,35,64,18,184
5022,67,17,64,18,166
5024,53,31,51,17,152
5025,66,33,100,20,219
5026,67,14,100,20,201
5027,64,35,65,20,184
5029,101,32,69,16,218
5032,67,15,69,16,167
5034,168,16,69,15,268
5035,52,18,132,16,218
5036,53,31,65,18,167
5038,65,18,100,15,198
5039,65,31,69,15,180
5040,100,18,65,16,199
5041,65,36,65,16,182
5042,67,18,65,16,166
5043,67,33,65,17,182
5044,167,15,51,16,249
5045,69,32,100,16,217
5048,165,16,67,19,267
5049,65,32,51,16,164
5050,149,33,68,16,266
5053,67,32,67,19,185
5054,66,16,67,19,168
5055,51,16,67,19,153
5056,102,15,68,15,200
5060,99,18,152,16,285
5061,53,15,101,16,185
5062,65,18,152,16,251
5064,64,18,65,20,167
5065,101,31,70,13,215
5066,69,16,66,19,170
5067,152,16,83,15,266
5068,52,31,70,13,166
5070,67,15,66,17,165
5073,54,16,83,15,168
5076,64,17,99,16,196
5077,83,15,66,16,180
5078,103,15,133,17,268
5079,52,15,66,16,149
5082,66,15,66,17,164
5083,99,33,51,16,199
5084,148,33,51,16,248
5085,66,33,51,16,166
5086,81,34,66,18,199
5087,66,34,66,18,184
5088,101,16,51,16,184
5095,51,16,51,18,136
5096,69,16,131,19,235
5098,51,34,65,16,166
5099,103,31,51,16,201
5102,52,31,51,16,150
5103,97,35,99,18,249
5104,101,16,99,18,234
5105,63,35,99,18,215
5108,51,33,66,18,168
5109,102,32,101,18,253
5110,148,37,117,20,322
5112,64,17,101,18,200
5114,167,14,153,16,350
5115,50,15,68,18,151
5116,169,19,80,17,285
5119,68,32,153,16,269
5120,100,19,80,17,216
5121,63,38,80,17,198
5122,69,19,80,17,185
5123,70,36,61,18,185
5124,52,36,61,18,167
5125,102,33,93,6,234
5126,99,17,93,6,215
5127,64,33,93,6,196
5128,64,17,93,6,180
5129,61,34,59,6,160
5131,51,16,59,6,132
5132,51,35,98,18,202
5137,65,33,69,15,182
5138,56,18,69,15,158
5139,50,18,69,15,152
5140,164,19,201,16,400
5141,51,18,99,17,185
5144,482,35,66,16,599
5145,99,33,66,18,216
5146,62,19,201,16,298
5148,84,34,66,17,201
5149,51,16,66,18,151
5150,101,17,102,16,236
5151,67,32,102,16,217
5152,483,32,66,19,600
5153,66,34,68,16,184
5154,67,16,68,16,167
5157,102,33,131,16,282
5158,84,33,131,16,264
5159,101,33,133,15,282
5160,51,33,131,16,231
5161,100,32,66,16,214
5162,84,32,66,16,198
5163,148,16,101,16,281
5164,82,34,67,15,198
5165,99,32,101,16,248
5167,533,32,51,20,636
5168,67,16,101,16,200
5169,101,32,166,19,318
5172,51,32,166,19,268
5176,85,32,66,19,202
5177,68,32,66,19,185
5178,52,32,66,19,169
5179,66,37,82,16,201
5181,51,18,82,16,167
5182,53,29,53,16,151
5183,66,33,70,17,186
5184,100,16,67,14,197
5185,62,36,67,14,179
5187,53,16,67,14,150
5188,101,16,66,15,198
5190,67,16,66,15,164
5191,99,34,65,18,216
5192,65,18,99,18,200
5193,65,34,65,18,182
5196,52,32,51,20,155
5197,66,33,152,15,266
5198,67,16,152,15,250
5199,83,20,80,17,200
5201,103,30,52,15,200
5202,54,32,65,17,168
5203,100,35,65,19,219
5205,62,35,65,19,181
5206,85,32,135,18,270
5207,65,32,135,18,250
5208,52,32,135,18,237
5209,302,34,64,19,419
5210,68,14,51,16,149
5211,84,17,66,18,185
5212,99,16,53,15,183
5215,300,35,66,16,417
5218,51,33,67,16,167
5219,53,15,67,16,151
5220,99,17,67,16,199
5221,83,17,67,16,183
5222,65,17,67,16,165
5223,101,33,66,16,216
5224,83,33,66,16,198
5225,68,33,66,16,183
5227,67,31,51,18,167
5230,100,18,66,37,221
5232,291,32,67,18,408
5233,51,18,66,37,172
5237,66,37,104,16,223
5239,71,36,68,16,191
5240,55,36,68,16,175
5241,57,16,68,16,157
5242,54,15,102,16,187
5244,100,16,67,18,201
5245,68,32,67,18,185
5246,117,32,51,17,217
5247,51,16,67,18,152
5248,85,32,51,17,185
5249,67,32,51,17,167
5251,100,35,66,17,218
5252,100,17,66,17,200
5253,83,17,66,17,183
5254,67,17,66,17,167
5256,50,33,99,16,198
5257,51,17,99,16,183
5258,100,15,70,15,200
5259,66,32,70,15,183
5260,67,15,70,15,167
5261,99,36,64,16,215
5262,99,20,64,16,199
5263,102,31,66,18,217
5266,84,33,100,17,234
5267,100,33,67,17,217
5268,51,33,100,17,201
5269,97,35,65,17,214
5271,66,35,65,17,183
5272,67,17,65,17,166
5273,167,33,101,15,316
5274,101,16,67,16,200
5275,67,33,67,16,183
5279,67,33,101,15,216
5280,151,33,65,17,266
5281,101,34,65,18,218
5285,68,33,65,17,183
5286,100,17,68,16,201
5287,67,32,68,16,183
5288,300,16,133,17,466
5289,166,34,99,17,316
5291,65,35,67,17,184
5292,85,33,51,15,184
5293,68,33,51,15,167
5295,68,34,99,17,218
5297,84,15,84,18,201
5298,150,35,66,15,266
5299,499,35,83,17,634
5302,66,16,133,17,232
5303,84,18,66,15,183
5304,51,35,66,15,167
5305,51,18,66,15,150
5306,51,31,67,17,166
5307,66,35,183,15,299
5308,65,19,183,15,282
5314,1450,35,150,16,1651
5315,85,16,99,18,218
5316,51,33,99,18,201
5317,52,16,99,18,185
5318,66,17,66,18,167
5319,66,32,52,15,165
5321,65,34,68,16,183
5322,66,17,68,16,167
5323,165,35,66,18,284
5324,67,15,118,17,217
5325,52,15,118,17,202
5327,99,35,66,18,218
5329,66,35,66,18,185
5331,83,17,99,17,216
5332,67,17,99,17,200
5333,52,17,99,17,185
5334,50,32,67,17,166
5338,67,17,67,17,168
5339,67,32,52,15,166
5340,49,32,52,15,148
5342,49,35,67,16,167
5343,67,32,70,14,183
5345,52,15,70,14,151
5346,101,19,82,16,218
5347,67,35,82,16,200
5349,152,16,66,17,251
5350,151,34,66,15,266
5351,65,34,100,17,216
5353,64,34,66,17,181
5354,68,16,66,17,167
5355,52,16,66,17,151
5356,101,15,134,17,267
5357,68,32,134,17,251
5358,67,15,134,17,233
5359,166,34,67,15,282
5360,99,18,67,17,201
5361,66,33,67,17,183
5362,64,18,67,17,166
5363,67,33,67,18,185
5365,66,34,67,15,182
5367,67,33,67,17,184
5368,84,34,65,18,201
5369,51,16,67,17,151
5370,100,18,134,16,268
5371,51,16,65,18,150
5373,67,32,68,16,183
5374,99,15,85,17,216
5375,167,33,66,17,283
5376,68,15,85,17,185
5378,66,17,100,17,200
5380,66,18,66,17,167
5381,69,33,66,17,185
5383,50,17,66,17,150
5384,101,16,67,15,199
5385,66,33,67,15,181
5387,66,33,68,16,183
5388,66,16,68,16,166
5390,65,18,150,16,249
5391,101,32,68,16,217
5394,84,33,51,16,184
5395,99,35,150,16,300
5397,65,35,150,16,266
5399,84,16,166,18,284
5401,51,16,166,18,251
5403,66,33,99,18,216
5406,68,15,66,18,167
5407,84,16,66,18,184
5408,83,32,134,17,266
5409,151,15,67,17,250
5412,66,16,67,17,166
5413,84,15,67,17,183
5414,301,17,67,16,401
5415,101,33,99,17,250
5416,299,16,69,15,399
5417,67,33,99,17,216
5418,66,16,99,17,198
5421,50,17,65,17,149
5422,65,17,68,16,166
5423,66,33,68,16,183
5424,67,15,68,16,166
5427,101,32,69,15,217
5428,99,16,69,15,199
5429,68,32,69,15,184
5432,68,16,66,16,166
5433,83,18,86,31,218
5434,51,34,86,31,202
5435,101,34,134,15,284
5437,66,34,134,15,249
5438,66,18,134,15,233
5439,66,20,62,18,166
5440,102,16,132,17,267
5441,168,32,50,16,266
5443,51,16,132,17,216
5444,96,18,82,16,212
5446,65,18,82,16,181
5447,67,32,50,16,165
5448,102,15,67,16,200
5449,49,17,50,16,132
5450,68,15,67,16,166
5451,165,33,68,17,283
5452,101,16,66,18,201
5453,50,16,100,18,184
5454,98,17,101,17,233
5455,100,33,68,17,218
5456,66,17,101,17,201
5457,67,33,68,17,185
5458,68,14,68,17,167
5459,66,34,51,15,166
5460,68,16,51,15,150
5461,51,16,51,15,133
5462,64,18,83,17,182
5463,68,32,51,17,168
5464,67,15,51,17,150
5465,51,15,51,17,134
5466,68,16,168,17,269
5468,99,17,134,16,266
5469,51,17,84,17,169
5470,100,17,67,17,201
5471,50,17,134,16,217
5472,67,17,67,17,168
5475,51,17,66,16,150
5476,300,20,64,17,401
5477,67,33,65,18,183
5478,67,16,65,18,166
5479,98,33,69,16,216
5480,168,17,98,16,299
5482,66,15,69,16,166
5483,83,16,51,14,164
5484,67,16,51,14,148
5485,51,16,51,14,132
5487,69,30,68,16,183
5489,168,32,67,18,285
5490,532,16,67,17,632
5491,69,29,152,16,266
5492,817,33,65,18,933
5493,68,35,65,18,186
5494,65,19,65,18,167
5495,64,32,67,18,181
5497,152,16,68,14,250
5498,51,33,136,14,234
5500,66,16,67,17,166
5502,153,31,85,15,284
5503,52,16,68,14,150
5504,65,18,66,17,166
5505,67,35,98,18,218
5506,164,18,83,16,281
5507,166,33,66,17,282
5508,53,31,85,15,184
5511,98,33,66,17,214
5512,285,31,151,18,485
5513,67,33,66,17,183
5514,50,33,66,17,166
5518,65,16,67,17,165
5519,50,16,67,17,150
5520,66,18,67,16,167
5522,100,18,98,18,234
5523,67,35,98,18,218
5524,67,18,98,18,201
5526,52,31,151,18,252
5531,67,35,100,16,218
5533,100,33,64,18,215
5534,52,34,97,18,201
5535,69,33,64,18,184
5536,166,16,67,17,266
5537,165,34,66,18,283
5538,84,31,52,16,183
5539,97,34,67,17,215
5540,51,31,52,16,150
5541,98,34,66,18,216
5543,65,34,66,18,183
5544,67,16,66,18,167
5547,100,35,166,16,317
5548,66,16,101,16,199
5551,51,17,166,16,250
5553,167,34,118,16,335
5555,66,33,102,15,216
5556,65,17,102,15,199
5557,66,33,100,17,216
5558,67,17,100,17,201
5559,83,17,118,16,234
5560,67,17,118,16,218
5561,67,35,66,17,185
5562,51,35,66,17,169
5563,100,35,83,16,234
5564,67,16,52,16,151
5567,66,33,66,17,182
5568,51,33,66,17,167
5570,51,33,66,16,166
5572,66,16,66,18,166
5573,66,33,67,17,183
5575,99,34,66,18,217
5576,65,17,51,15,148
5579,67,32,67,18,184
5580,100,17,66,18,201
5581,151,15,168,17,351
5582,65,17,66,18,166
5583,66,33,84,16,199
5584,100,15,168,17,300
5592,167,16,67,17,267
5594,68,15,67,16,166
5595,101,33,67,17,218
5596,66,17,66,16,165
5598,66,16,67,17,166
5599,51,16,67,17,151
5600,50,33,51,17,151
5601,66,34,67,16,183
5602,65,18,67,16,166
5603,67,34,65,18,184
5604,68,17,65,18,168
5605,51,17,65,18,151
5609,65,35,200,16,316
5610,83,32,66,18,199
5611,83,16,66,18,183
5613,51,16,66,18,151
5614,100,15,51,16,182
5615,83,15,51,16,165
5616,100,16,84,16,216
5617,168,32,101,16,317
5618,68,16,84,16,184
5619,67,33,118,16,234
5620,99,18,83,16,216
5621,102,32,101,16,251
5622,100,16,101,16,233
5623,68,32,101,16,217
5625,51,16,101,16,184
5626,50,34,67,16,167
5627,66,33,50,17,166
5628,299,19,66,16,400
5629,67,34,68,13,182
5630,165,19,65,17,266
5631,67,33,84,15,199
5632,66,17,84,15,182
5633,50,17,84,15,166
5634,1068,17,100,15,1200
5635,68,32,65,17,182
5637,67,32,101,17,217
5638,69,15,101,17,202
5639,97,36,66,16,215
5640,51,33,68,17,169
5641,65,36,66,16,183
5642,65,19,66,16,166
5643,166,34,150,18,368
5644,68,16,99,18,201
5645,68,34,65,18,185
5646,68,17,65,18,168
5647,66,31,67,17,181
5648,66,15,67,17,165
5650,66,16,150,18,250
5651,98,34,83,18,233
5652,99,17,83,18,217
5653,101,34,67,15,217
5654,66,17,83,18,184
5655,67,34,67,15,183
5656,49,34,67,15,165
5659,83,18,65,18,184
5661,67,33,67,15,182
5663,99,35,67,16,217
5664,300,16,68,17,401
5666,68,17,67,16,168
5667,67,32,51,16,166
5668,550,33,66,18,667
5669,67,35,67,14,183
5671,300,32,66,18,416
5673,166,36,66,15,283
5674,51,35,233,16,335
5675,99,32,68,17,216
5677,67,32,68,17,184
5678,300,17,67,16,400
5679,64,36,66,15,181
5680,69,17,66,15,167
5682,52,32,66,18,168
5684,150,31,102,16,299
5686,65,17,66,18,166
5687,49,17,66,18,150
5689,67,31,102,16,216
5690,52,31,102,16,201
5691,66,35,67,16,184
5692,100,17,100,15,232
5693,66,34,100,15,215
5695,52,17,100,15,184
5697,166,34,133,17,350
5698,66,17,66,18,167
5700,51,34,97,20,202
5701,67,32,65,20,184
5702,101,16,133,17,267
5703,66,34,133,17,250
5706,72,45,100,18,235
5707,300,33,66,17,416
5708,98,19,83,16,216
5710,96,16,100,17,229
5711,70,32,100,17,219
5712,66,16,100,17,199
5715,83,16,66,17,182
5716,67,16,66,17,166
5717,150,16,66,17,249
5718,50,33,66,19,168
5721,83,16,66,17,182
5723,50,16,66,17,149
5724,68,15,66,39,188
5726,99,17,158,16,290
5727,66,34,158,16,274
5728,64,17,158,16,255
5730,51,39,52,19,161
5731,73,21,64,34,192
5733,75,16,67,16,174
5734,52,33,117,16,218
5736,64,34,67,16,181
5737,61,22,67,16,166
5739,64,18,49,16,147
5741,56,33,67,16,172
5742,67,32,166,20,285
5743,51,32,166,20,269
5744,166,35,66,16,283
5745,67,16,131,20,234
5747,67,16,69,14,166
5748,51,16,69,14,150
5749,65,17,65,20,167
5750,167,34,66,15,282
5751,99,16,70,15,200
5752,169,28,169,18,384
5753,66,16,70,15,167
5754,101,34,66,15,216
5755,69,16,100,15,200
5758,70,28,169,18,285
5759,65,13,169,18,265
5760,62,38,98,19,217
5761,151,31,69,16,267
5762,66,32,135,16,249
5763,51,32,135,16,234
5765,85,31,69,16,201
5766,67,31,69,16,183
5767,168,16,66,20,270
5769,66,14,52,16,148
5770,64,36,67,14,181
5771,66,18,67,14,165
5772,69,32,66,20,187
5773,66,16,66,20,168
5774,52,16,66,20,154
5775,99,17,69,15,200
5776,67,31,69,15,182
5777,102,15,65,19,201
5778,66,35,65,19,185
5779,69,15,65,19,168
5781,52,34,66,17,169
5782,69,31,52,15,167
5783,64,16,52,15,147
5784,100,32,67,16,215
5785,50,35,67,15,167
5786,66,32,67,16,181
5788,52,15,67,16,150
5789,149,33,66,16,264
5790,99,34,66,18,217
5791,65,17,67,16,165
5793,64,18,66,18,166
5794,99,33,66,18,216
5795,51,33,66,16,166
5796,100,33,51,16,200
5797,51,33,66,18,168
5798,150,16,67,18,251
5799,50,33,51,16,150
5803,66,16,67,18,167
5804,51,16,67,18,152
5805,66,19,66,18,169
5806,68,33,51,17,169
5807,50,33,51,17,151
5809,302,18,65,15,400
5813,50,32,67,17,166
5814,67,35,67,15,184
5815,64,20,67,15,166
5816,67,32,101,14,214
5817,67,17,101,14,199
5819,52,35,66,14,167
5820,67,30,50,19,166
5821,52,30,50,19,151
5825,51,33,100,16,200
5826,50,19,100,16,185
5827,98,19,50,15,182
5828,65,34,50,15,164
5832,68,31,68,15,182
5833,53,31,68,15,167
5834,50,15,68,15,148
5835,502,15,70,13,600
5836,166,32,56,12,266
5838,167,35,65,17,284
5840,102,32,56,12,202
5841,85,32,56,12,185
5842,155,12,67,15,249
5844,166,35,83,17,301
5847,166,17,101,17,301
5848,56,12,67,15,150
5849,64,16,118,17,215
5850,65,35,83,17,200
5852,99,35,168,13,315
5853,66,17,101,17,201
5854,67,35,168,13,283
5855,68,17,168,13,266
5856,67,33,65,19,184
5857,68,17,65,19,169
5859,100,15,70,13,198
5860,66,32,70,13,181
5862,65,45,74,15,199
5863,95,25,64,16,200
5864,51,26,74,15,166
5865,60,25,64,16,165
5866,119,15,101,18,253
5867,115,34,67,18,234
5868,74,15,101,18,208
5869,81,34,67,18,200
5870,64,34,67,18,183
5871,101,16,102,16,235
5872,67,32,102,16,217
5873,65,16,102,16,199
5874,66,35,67,16,184
5875,85,32,100,17,234
5876,85,14,100,17,216
5877,51,32,100,17,200
5880,100,32,52,16,200
5881,65,17,84,16,182
5882,100,36,66,15,217
5884,65,36,66,15,182
5885,285,29,110,9,433
5887,54,32,68,14,168
5888,52,16,68,14,150
5890,66,34,66,16,182
5892,68,33,67,14,182
5895,52,33,86,19,190
5896,66,34,52,19,171
5897,52,34,52,19,157
5898,96,42,95,17,250
5899,53,29,110,9,201
5900,173,27,57,9,266
5901,89,27,68,17,201
5902,52,19,95,17,183
5903,57,27,68,17,169
5904,57,12,68,17,154
5906,127,34,63,48,272
5908,68,32,76,21,197
5909,59,34,63,48,204
5910,99,27,109,53,288
5911,57,9,63,48,177
5915,606,40,87,14,747
5916,136,53,92,24,305
5917,69,40,53,12,174
5918,88,53,92,24,257
5919,132,92,58,15,297
5920,93,92,58,15,258
5921,86,92,58,15,251
5922,53,92,58,15,218
5923,150,15,145,32,342
5924,138,15,145,32,330
5925,218,32,60,40,350
5927,49,34,203,40,326
5928,54,9,203,40,306
5930,145,32,60,40,277
5931,120,32,60,40,252
5932,158,45,90,37,330
5934,171,40,87,14,312
5935,553,33,58,18,662
5937,81,40,87,14,222
5939,186,25,66,20,297
5941,50,37,79,26,192
5942,76,39,66,20,201
5943,162,17,51,16,246
5944,57,12,66,20,155
5945,61,18,80,19,178
5946,164,31,73,33,301
5947,52,26,88,16,182
5948,66,37,51,16,170
5949,64,17,51,16,148
5950,63,36,104,33,236
5951,52,36,104,33,225
5953,53,31,73,33,190
5954,51,16,73,33,173
5955,98,25,58,18,199
5956,62,42,58,18,180
5958,106,25,168,16,315
5960,100,33,51,16,200
5962,58,33,51,16,158
5963,184,30,53,9,276
5965,68,17,100,16,201
5966,68,32,68,16,184
5967,50,32,68,16,166
5970,70,30,53,9,162
5971,161,20,66,17,264
5972,121,9,101,17,248
5973,-99908,0,0,0,-99908
5974,160,33,67,16,276
5975,72,9,101,17,199
5977,61,20,66,17,164
5978,309,35,66,16,426
5979,68,33,67,16,184
5980,53,33,67,16,169
5981,101,32,67,15,215
5982,86,32,67,15,200
5983,68,32,67,15,182
5984,102,17,67,17,203
5988,68,17,100,15,200
5990,51,33,133,16,233
5991,-100222,0,0,0,-100222
5992,67,15,101,16,199
5995,67,33,132,17,249
5998,83,33,66,17,199
