序号,发送->接收,接收->转发,转发->接收,接收->处理,总计
1,0,46,0,25,71
2,0,25,0,16,41
3,14,31,0,19,64
5,0,15,0,19,34
6,0,36,0,17,53
7,0,17,0,17,34
9,0,15,0,18,33
11,0,18,0,16,34
12,0,31,0,15,46
13,0,15,0,15,30
14,0,33,0,17,50
15,0,18,0,17,35
16,0,33,0,17,50
17,0,16,0,17,33
18,0,36,0,15,51
19,0,19,0,15,34
22,0,33,0,15,48
23,0,17,0,15,32
24,0,33,15,24,72
25,0,18,15,24,57
26,0,39,0,9,48
27,0,24,0,9,33
30,0,34,0,17,51
33,0,15,18,14,47
34,0,32,19,15,66
35,0,14,19,15,48
37,0,15,0,17,32
39,0,18,0,17,35
40,0,32,0,17,49
43,0,17,0,17,34
44,0,32,0,22,54
45,0,15,0,22,37
46,0,34,0,17,51
47,0,12,0,17,29
49,0,15,0,17,32
51,0,19,0,16,35
52,0,33,0,18,51
53,0,17,0,18,35
54,0,32,0,17,49
56,0,35,0,17,52
58,0,34,0,14,48
60,0,39,0,27,66
61,0,25,0,27,52
62,0,27,0,17,44
63,0,17,0,17,34
64,0,34,0,15,49
65,0,17,0,15,32
67,0,16,0,18,34
68,0,34,0,16,50
69,0,16,0,16,32
70,0,32,0,19,51
71,0,16,0,19,35
72,0,36,17,16,69
73,0,17,17,16,50
75,0,16,0,18,34
76,0,34,15,16,65
77,0,16,15,16,47
79,0,16,0,18,34
81,0,16,0,16,32
82,0,33,0,19,52
83,0,17,0,19,36
84,0,34,0,17,51
88,0,35,0,17,52
89,0,18,0,17,35
90,0,34,0,16,50
92,0,33,16,18,67
93,0,17,16,18,51
94,0,34,0,16,50
96,0,34,14,18,66
97,0,18,14,18,50
98,0,32,0,17,49
100,0,34,0,16,50
101,0,17,0,16,33
102,0,33,0,16,49
103,0,17,0,16,33
104,0,32,0,16,48
105,0,16,0,16,32
106,0,33,17,16,66
108,0,33,0,17,50
109,0,16,0,17,33
111,0,17,0,17,34
112,0,34,0,15,49
113,0,17,0,15,32
114,0,33,15,18,66
115,0,18,15,18,51
116,0,33,0,16,49
117,0,18,0,16,34
118,0,32,0,19,51
120,0,36,0,20,56
122,0,33,15,16,64
124,0,31,0,20,51
125,0,16,0,20,36
126,0,36,15,18,69
128,0,33,0,14,47
129,0,18,0,14,32
130,0,31,0,18,49
131,0,17,0,18,35
132,0,36,14,17,67
134,0,31,0,19,50
135,0,17,0,19,36
136,0,36,0,17,53
138,0,31,0,16,47
140,0,36,0,14,50
142,0,33,0,15,48
143,0,19,0,15,34
144,0,32,0,16,48
146,0,34,0,15,49
148,0,33,0,15,48
149,0,18,0,15,33
151,0,17,0,16,33
152,0,33,18,18,69
153,0,17,18,18,53
154,0,36,0,17,53
157,0,15,0,17,32
158,0,33,0,17,50
159,0,16,0,17,33
160,0,33,0,18,51
161,0,16,0,18,34
162,0,33,0,18,51
163,0,15,0,18,33
164,0,34,0,17,51
165,0,16,0,17,33
166,0,34,0,16,50
168,0,32,0,20,52
169,0,16,0,20,36
170,0,35,0,17,52
171,0,15,0,17,32
172,0,33,0,15,48
173,0,16,0,15,31
174,0,33,0,15,48
175,0,18,0,15,33
177,0,18,0,16,34
178,0,32,0,17,49
180,0,36,0,16,52
181,0,19,0,16,35
182,0,32,0,15,47
183,0,16,0,15,31
184,0,33,0,17,50
185,0,18,0,17,35
188,0,31,0,18,49
189,0,16,0,18,34
192,0,33,0,18,51
193,0,18,0,18,36
195,0,16,0,17,33
196,0,34,0,17,51
197,0,17,0,17,34
198,0,33,0,16,49
199,0,16,0,16,32
200,0,34,0,15,49
203,0,16,0,19,35
204,0,35,16,18,69
205,0,16,16,18,50
206,0,34,18,15,67
207,0,18,18,15,51
208,0,33,0,15,48
209,0,15,0,15,30
210,0,32,18,16,66
212,0,34,0,18,52
213,0,16,0,18,34
215,0,17,0,16,33
216,0,34,0,14,48
217,0,18,0,14,32
218,0,32,0,16,48
220,0,32,0,16,48
221,0,16,0,16,32
225,0,16,0,14,30
226,0,32,0,18,50
228,0,34,0,15,49
229,0,16,0,15,31
230,0,33,0,17,50
231,0,18,0,17,35
232,0,34,0,17,51
233,0,17,0,17,34
234,0,34,0,16,50
236,0,32,0,18,50
237,0,16,0,18,34
238,0,34,0,16,50
239,0,16,0,16,32
240,0,33,0,15,48
242,0,34,0,15,49
243,0,19,0,15,34
245,0,18,0,18,36
246,0,33,0,17,50
248,0,33,0,18,51
249,0,16,0,18,34
250,0,34,0,17,51
252,0,34,0,16,50
253,0,17,0,16,33
258,0,33,0,17,50
259,0,17,0,17,34
260,0,35,0,15,50
261,0,18,0,15,33
262,0,31,19,16,66
265,0,16,0,18,34
266,0,33,20,12,65
267,0,15,20,12,47
268,0,32,17,18,67
269,0,12,17,18,47
270,0,35,0,17,52
271,0,18,0,17,35
272,0,32,0,17,49
274,0,34,17,15,66
275,0,17,17,15,49
276,0,32,0,19,51
277,0,15,0,19,34
279,0,17,0,16,33
281,0,17,0,15,32
283,0,16,0,20,36
284,0,35,0,16,51
287,0,18,0,17,35
288,0,32,0,17,49
289,0,15,0,17,32
290,0,33,0,18,51
292,0,34,0,17,51
293,0,16,0,17,33
294,0,34,0,17,51
297,0,15,0,17,32
298,0,34,18,16,68
299,0,17,18,16,51
300,0,34,0,15,49
301,0,16,0,15,31
302,0,33,0,17,50
304,0,34,0,16,50
307,0,15,0,18,33
309,0,18,0,16,34
311,0,17,0,17,34
312,0,33,0,16,49
313,0,16,0,16,32
314,0,33,0,18,51
315,0,17,0,18,35
316,0,33,0,17,50
317,0,15,0,17,32
318,0,35,0,16,51
319,0,18,0,16,34
321,0,15,0,19,34
322,0,34,0,16,50
324,0,33,0,16,49
325,0,17,0,16,33
327,0,19,0,17,36
329,0,16,0,15,31
330,0,34,0,15,49
332,0,32,0,17,49
334,0,35,0,16,51
335,0,18,0,16,34
336,0,32,0,15,47
337,0,16,0,15,31
338,0,33,0,16,49
339,0,18,0,16,34
341,0,17,0,16,33
342,0,34,0,16,50
343,0,18,0,16,34
345,0,17,0,16,33
346,0,33,0,17,50
347,0,17,0,17,34
348,0,37,0,13,50
350,0,29,18,18,65
351,0,16,18,18,52
353,0,18,0,14,32
354,0,32,0,15,47
355,0,18,0,15,33
356,0,33,18,15,66
357,0,18,18,15,51
360,0,34,0,16,50
361,0,18,0,16,34
362,0,33,0,17,50
365,0,17,0,16,33
367,0,16,0,18,34
369,0,15,0,18,33
370,0,34,0,18,52
371,0,16,0,18,34
373,0,17,0,15,32
375,0,18,0,15,33
377,0,19,0,17,36
378,0,32,0,17,49
379,0,15,0,17,32
380,0,33,0,18,51
381,0,16,0,18,34
384,0,33,0,18,51
386,0,33,0,17,50
389,0,16,0,17,33
390,0,35,14,19,68
391,0,18,14,19,51
392,0,33,0,17,50
393,0,19,0,17,36
394,0,34,0,16,50
395,0,17,0,16,33
396,0,31,0,16,47
397,0,15,0,16,31
399,0,18,18,15,51
400,0,33,0,17,50
401,0,15,0,17,32
402,0,33,0,17,50
403,0,16,0,17,33
404,0,35,0,17,52
406,0,34,0,15,49
407,0,17,0,15,32
408,0,32,0,18,50
409,0,17,0,18,35
410,0,35,0,14,49
413,0,16,0,19,35
414,0,34,0,19,53
415,0,15,0,19,34
416,0,35,0,17,52
417,0,16,0,17,33
419,0,16,0,17,33
420,0,32,0,18,50
421,0,15,0,18,33
424,0,33,0,16,49
425,0,18,0,16,34
426,0,32,0,16,48
427,0,16,0,16,32
428,0,36,0,15,51
429,0,20,0,15,35
430,0,34,0,13,47
431,0,19,0,13,32
432,0,30,0,16,46
434,0,33,0,17,50
435,0,17,0,17,34
436,0,33,0,17,50
437,0,16,0,17,33
438,0,35,0,18,53
439,0,18,0,18,36
440,0,35,0,15,50
442,0,32,0,18,50
443,0,17,0,18,35
444,0,31,0,17,48
445,0,13,0,17,30
447,0,17,0,19,36
448,0,36,0,16,52
449,0,17,0,16,33
450,0,33,0,16,49
451,0,17,0,16,33
452,0,33,0,18,51
453,0,17,0,18,35
454,0,34,0,14,48
458,0,32,0,17,49
459,0,17,0,17,34
460,0,33,0,18,51
461,0,16,0,18,34
463,0,15,0,18,33
464,0,37,0,12,49
465,0,19,0,12,31
466,0,31,0,16,47
467,0,19,0,16,35
468,0,33,0,17,50
469,0,17,0,17,34
472,0,33,0,19,52
473,0,15,0,19,34
474,0,33,0,18,51
475,0,14,0,18,32
476,0,36,0,15,51
478,0,33,0,15,48
481,0,18,0,17,35
483,0,16,0,17,33
485,0,16,0,18,34
486,0,34,16,16,66
487,0,16,16,16,48
488,0,32,0,16,48
489,0,16,0,16,32
490,0,34,0,18,52
491,0,18,0,18,36
492,0,34,0,16,50
493,0,16,0,16,32
494,0,35,0,16,51
495,0,19,0,16,35
496,0,31,0,16,47
498,0,34,0,17,51
499,0,18,0,17,35
500,0,32,0,20,52
501,0,15,0,20,35
502,0,35,0,17,52
503,0,15,0,17,32
504,0,34,0,15,49
505,0,17,0,15,32
507,0,17,0,17,34
508,0,34,0,15,49
509,0,17,0,15,32
511,0,16,0,17,33
514,0,36,0,15,51
515,0,17,0,15,32
517,0,18,0,14,32
518,0,31,0,17,48
524,0,35,0,17,52
525,0,19,0,17,36
526,0,33,0,15,48
527,0,16,0,15,31
529,0,17,0,20,37
530,0,37,0,13,50
531,0,17,0,13,30
533,0,16,0,19,35
534,0,34,0,17,51
535,0,15,0,17,32
536,0,35,0,15,50
537,0,18,0,15,33
538,15,18,0,17,50
540,0,33,0,15,48
541,0,16,0,15,31
542,0,35,0,15,50
544,0,30,0,19,49
545,0,15,0,19,34
546,0,35,0,18,53
547,0,16,0,18,34
549,0,14,0,16,30
551,0,19,0,15,34
552,0,32,0,18,50
554,0,33,0,17,50
556,0,35,0,17,52
557,0,18,0,17,35
559,0,14,0,17,31
560,0,35,0,17,52
561,0,18,0,17,35
562,0,33,0,17,50
563,0,16,0,17,33
566,0,32,0,16,48
567,0,17,0,16,33
568,0,31,0,18,49
570,0,35,0,17,52
571,0,17,0,17,34
572,0,34,0,17,51
573,0,17,0,17,34
575,0,15,0,16,31
576,0,33,0,18,51
577,0,17,0,18,35
578,0,35,0,15,50
579,0,17,0,15,32
580,0,31,0,18,49
581,0,16,0,18,34
583,0,16,0,18,34
584,0,34,0,15,49
586,0,32,0,19,51
588,0,34,0,18,52
589,0,15,0,18,33
592,0,35,0,16,51
593,0,16,0,16,32
594,0,32,0,17,49
595,0,16,0,17,33
597,0,17,0,18,35
598,0,35,0,14,49
599,0,17,0,14,31
600,0,33,0,16,49
601,0,19,0,16,35
602,0,33,16,16,65
603,0,17,16,16,49
604,0,32,0,17,49
606,0,33,0,18,51
607,0,16,0,18,34
608,0,34,0,15,49
609,0,16,0,15,31
613,0,16,0,17,33
615,0,16,0,17,33
616,0,36,0,14,50
617,0,19,0,14,33
618,0,32,0,15,47
621,0,18,0,17,35
624,0,35,0,18,53
625,0,17,0,18,35
626,0,32,0,20,52
627,0,14,0,20,34
628,0,34,0,16,50
629,0,14,0,16,30
630,0,34,17,19,70
631,0,18,17,19,54
633,0,19,0,14,33
634,0,32,0,14,46
637,0,17,0,17,34
638,0,34,0,16,50
640,0,35,0,16,51
641,0,19,0,16,35
643,0,15,0,18,33
644,0,34,0,17,51
645,0,16,0,17,33
648,0,32,0,17,49
650,0,33,0,16,49
651,0,16,0,16,32
654,0,32,0,16,48
655,0,17,0,16,33
656,0,33,0,17,50
657,0,17,0,17,34
659,0,16,18,17,51
660,0,35,0,14,49
661,0,17,0,14,31
662,0,33,0,15,48
663,0,19,0,15,34
664,0,32,0,17,49
666,0,32,0,19,51
667,0,15,0,19,34
668,0,34,0,18,52
669,0,15,0,18,33
670,0,33,0,17,50
671,0,15,0,17,32
672,0,35,0,15,50
673,0,18,0,15,33
674,0,35,0,14,49
675,0,20,0,14,34
676,0,32,0,17,49
677,0,18,0,17,35
678,0,34,0,17,51
679,0,17,0,17,34
680,0,32,17,18,67
681,0,15,17,18,50
684,0,32,0,17,49
685,0,16,0,17,33
686,0,33,18,16,67
687,0,16,18,16,50
688,0,34,0,16,50
694,0,31,0,16,47
695,0,17,0,16,33
696,0,33,0,16,49
697,0,17,0,16,33
698,0,34,0,17,51
700,0,32,0,17,49
701,0,15,0,17,32
703,0,17,0,16,33
704,0,32,0,17,49
705,0,16,0,17,33
706,0,35,0,16,51
707,0,18,0,16,34
711,0,12,19,18,49
712,19,18,0,17,54
713,0,18,0,17,35
714,0,33,0,17,50
715,0,16,0,17,33
716,0,32,0,19,51
717,0,15,0,19,34
718,0,35,0,17,52
720,0,33,0,16,49
721,0,16,0,16,32
722,0,34,0,15,49
723,0,18,0,15,33
725,0,19,0,15,34
726,0,32,0,16,48
728,0,34,0,15,49
729,0,18,0,15,33
730,0,31,0,20,51
731,0,16,0,20,36
732,0,36,0,15,51
733,0,16,0,15,31
736,0,32,0,18,50
737,0,16,0,18,34
738,0,32,0,17,49
740,0,36,0,15,51
743,0,19,0,15,34
744,0,33,0,15,48
745,0,18,0,15,33
747,0,16,19,15,50
748,0,34,0,16,50
749,0,15,0,16,31
750,0,33,0,18,51
751,0,17,0,18,35
752,0,33,0,17,50
753,0,15,0,17,32
754,0,35,0,18,53
755,0,18,0,18,36
756,0,32,0,18,50
758,0,34,0,17,51
759,0,16,0,17,33
760,0,33,0,19,52
762,0,36,0,15,51
763,0,17,0,15,32
764,0,30,0,19,49
765,0,15,0,19,34
767,0,16,0,16,32
771,0,16,0,17,33
772,0,33,0,16,49
773,0,16,0,16,32
774,0,32,0,18,50
775,0,16,0,18,34
776,0,37,15,18,70
777,0,19,15,18,52
778,0,33,17,16,66
779,0,18,17,16,51
780,0,33,0,16,49
781,0,16,0,16,32
782,0,33,0,17,50
783,0,17,0,17,34
785,0,17,0,16,33
786,0,31,0,19,50
787,0,15,0,19,34
788,0,33,0,18,51
790,0,33,0,17,50
791,0,15,0,17,32
792,0,34,0,17,51
793,0,17,0,17,34
794,0,35,0,16,51
795,0,18,0,16,34
797,0,17,0,17,34
798,0,31,0,18,49
799,0,14,0,18,32
801,0,18,0,16,34
802,0,32,0,17,49
804,0,33,0,17,50
805,0,16,0,17,33
806,0,35,0,17,52
809,0,16,0,19,35
810,0,36,0,14,50
811,0,17,0,14,31
812,0,29,0,18,47
813,0,15,0,18,33
815,0,17,0,19,36
816,0,34,0,15,49
817,0,15,0,15,30
818,0,32,0,18,50
819,0,17,0,18,35
820,0,32,0,19,51
822,0,35,0,17,52
823,0,16,0,17,33
824,0,34,0,15,49
825,0,17,0,15,32
826,0,33,0,15,48
828,0,34,0,18,52
829,0,19,0,18,37
831,0,13,0,17,30
832,0,37,0,14,51
833,0,20,0,14,34
834,0,29,0,18,47
835,0,15,0,18,33
836,0,35,0,17,52
837,0,17,0,17,34
838,0,37,12,17,66
839,0,20,12,17,49
842,0,34,0,16,50
844,0,32,0,17,49
847,0,19,0,17,36
848,0,29,0,19,48
849,0,12,0,19,31
850,0,36,0,16,52
851,0,17,0,16,33
852,0,35,0,15,50
853,0,19,0,15,34
855,0,17,0,16,33
856,0,33,0,18,51
857,0,17,0,18,35
858,0,36,0,14,50
859,0,18,0,14,32
860,0,33,0,14,47
862,0,31,0,16,47
863,0,17,0,16,33
864,0,33,0,16,49
866,0,34,0,19,53
867,0,18,0,19,37
868,0,35,0,15,50
869,0,16,0,15,31
871,0,15,18,16,49
872,0,34,0,18,52
875,0,15,0,19,34
876,0,34,0,19,53
877,0,15,0,19,34
879,0,14,17,18,49
881,0,18,0,16,34
882,0,34,15,18,67
883,0,18,15,18,51
886,0,32,0,17,49
889,0,19,0,15,34
890,0,30,0,17,47
893,0,18,0,15,33
894,0,33,0,17,50
895,0,18,0,17,35
897,0,18,0,16,34
901,0,14,0,19,33
902,0,34,0,17,51
903,0,15,0,17,32
904,0,33,0,17,50
906,0,33,0,17,50
907,0,16,0,17,33
908,0,34,17,15,66
911,0,15,0,18,33
912,0,35,0,17,52
913,0,17,0,17,34
914,0,32,0,17,49
915,0,15,0,17,32
917,0,18,0,16,34
918,0,32,0,17,49
919,0,16,0,17,33
920,0,34,0,19,53
922,0,35,14,17,66
924,0,31,0,17,48
925,0,17,0,17,34
926,0,32,0,18,50
928,0,36,0,15,51
929,0,18,0,15,33
930,0,32,0,16,48
931,0,17,0,16,33
935,0,17,0,14,31
936,0,33,0,17,50
937,0,19,0,17,36
938,0,34,0,15,49
939,0,17,0,15,32
942,0,36,0,16,52
943,0,19,0,16,35
946,0,33,15,19,67
948,0,34,0,15,49
949,0,19,0,15,34
950,0,31,19,15,65
951,0,16,19,15,50
953,0,15,0,17,32
954,0,33,0,17,50
956,0,33,0,19,52
957,0,16,0,19,35
958,0,35,0,15,50
960,0,33,0,16,49
962,0,33,16,18,67
963,0,17,16,18,51
964,0,34,0,18,52
965,0,18,0,18,36
967,0,14,0,18,32
969,0,17,0,17,34
970,0,34,0,14,48
975,0,19,0,14,33
976,0,33,0,15,48
977,0,19,0,15,34
978,0,31,0,18,49
979,0,16,0,18,34
982,0,34,0,18,52
983,0,16,0,18,34
986,0,33,18,16,67
987,0,14,18,16,48
988,0,34,0,16,50
989,0,16,0,16,32
991,0,18,0,14,32
993,0,18,0,19,37
995,0,15,0,15,30
997,0,18,0,16,34
999,0,16,0,17,33
1000,0,35,0,15,50
1001,0,18,0,15,33
1002,0,34,0,15,49
1003,0,19,0,15,34
1004,0,33,0,17,50
1005,0,18,0,17,35
1006,0,32,15,18,65
1007,0,15,15,18,48
1008,0,33,0,15,48
1009,0,18,0,15,33
1011,0,20,0,17,37
1012,0,32,0,17,49
1013,0,15,0,17,32
1014,0,32,0,19,51
1017,0,17,0,15,32
1018,0,31,17,19,67
1019,0,16,17,19,52
1020,0,36,0,16,52
1021,0,19,0,16,35
1025,0,17,0,15,32
1026,0,33,0,16,49
1030,0,33,0,16,49
1031,0,15,0,16,31
1033,0,17,0,17,34
1034,0,33,0,19,52
1035,0,16,0,19,35
1036,0,35,0,15,50
1038,0,32,18,16,66
1039,0,17,18,16,51
1040,0,34,0,19,53
1042,0,34,0,17,51
1044,0,32,0,18,50
1046,0,33,18,15,66
1047,0,15,18,15,48
1048,0,33,0,20,53
1051,0,14,0,16,30
1052,0,35,0,16,51
1054,0,34,0,16,50
1055,0,18,0,16,34
1056,0,33,0,15,48
1057,0,17,0,15,32
1058,0,32,0,16,48
1059,0,17,0,16,33
1060,0,33,0,17,50
1061,0,17,0,17,34
1062,0,35,0,15,50
1063,0,18,0,15,33
1065,0,17,0,16,33
1066,0,34,0,16,50
1067,0,18,0,16,34
1069,0,18,0,15,33
1070,0,33,0,15,48
1071,0,18,0,15,33
1072,0,33,0,15,48
1073,0,18,0,15,33
1074,0,34,0,17,51
1075,0,19,0,17,36
1076,0,31,0,17,48
1077,0,14,0,17,31
1081,0,17,17,16,50
1082,0,33,0,18,51
1083,0,16,0,18,34
1084,0,32,0,19,51
1086,0,36,0,14,50
1087,0,17,0,14,31
1088,0,32,0,16,48
1089,0,18,0,16,34
1090,0,34,0,16,50
1095,0,18,0,17,35
1096,0,32,0,18,50
1097,0,15,0,18,33
1098,0,36,0,15,51
1100,0,32,0,17,49
1101,0,17,0,17,34
1102,0,34,15,18,67
1103,0,17,15,18,50
1105,0,18,0,17,35
1106,0,33,0,18,51
1109,0,16,0,16,32
1111,0,17,0,16,33
1112,0,35,0,15,50
1113,0,19,0,15,34
1114,0,32,0,16,48
1117,0,19,0,13,32
1118,0,32,0,17,49
1119,0,19,0,17,36
1120,0,33,0,16,49
1121,0,16,0,16,32
1122,0,32,0,18,50
1124,0,35,0,14,49
1125,0,17,0,14,31
1126,0,33,0,15,48
1129,0,19,0,15,34
1131,0,19,14,18,51
1132,0,32,0,15,47
1133,0,18,0,15,33
1134,0,32,0,16,48
1135,0,17,0,16,33
1136,0,34,0,17,51
1137,0,18,0,17,35
1138,0,33,0,18,51
1140,0,33,0,18,51
1141,0,15,0,18,33
1143,0,15,0,19,34
1144,0,36,0,15,51
1147,0,16,0,16,32
1148,0,33,0,18,51
1150,0,34,0,16,50
1151,0,16,0,16,32
1155,0,15,0,18,33
1156,0,34,0,16,50
1159,0,17,0,16,33
1160,0,33,0,18,51
1161,0,17,0,18,35
1162,0,34,0,18,52
1163,0,16,0,18,34
1166,0,35,0,15,50
1167,0,17,0,15,32
1168,0,32,0,16,48
1169,0,17,0,16,33
1170,0,35,0,16,51
1172,0,31,0,19,50
1173,0,15,0,19,34
1175,0,15,0,17,32
1176,0,32,0,17,49
1177,0,15,0,17,32
1178,0,34,0,20,54
1180,0,35,0,17,52
1182,0,34,0,16,50
1183,0,17,0,16,33
1186,0,33,0,17,50
1188,0,32,0,16,48
1189,0,15,0,16,31
1192,0,34,0,16,50
1193,0,17,0,16,33
1194,0,32,0,18,50
1196,0,34,0,16,50
1197,0,16,0,16,32
1198,0,34,0,17,51
1199,0,18,0,17,35
1200,0,33,0,16,49
1202,0,32,0,18,50
1204,0,33,0,20,53
1206,0,35,0,16,51
1207,0,15,0,16,31
1210,0,33,0,15,48
1212,0,33,0,18,51
1213,0,18,0,18,36
1214,0,35,0,15,50
1216,0,31,0,17,48
1218,0,35,0,17,52
1219,0,18,0,17,35
1220,0,33,0,15,48
1221,0,16,0,15,31
1222,0,33,0,18,51
1224,0,31,0,18,49
1225,0,13,0,18,31
1226,0,35,0,16,51
1227,0,17,0,16,33
1228,0,33,0,18,51
1229,0,17,0,18,35
1230,0,34,0,17,51
1233,0,15,0,19,34
1234,0,36,0,17,53
1236,0,33,0,14,47
1237,0,16,0,14,30
1238,0,33,0,16,49
1239,0,19,0,16,35
1241,0,16,0,17,33
1243,0,16,0,18,34
1245,0,16,0,17,33
1246,0,32,0,18,50
1247,0,15,0,18,33
1249,0,17,0,16,33
1250,0,35,0,15,50
1251,0,19,0,15,34
1254,0,33,0,16,49
1255,0,15,0,16,31
1256,0,35,0,15,50
1258,0,35,0,13,48
1260,0,30,0,18,48
1261,0,17,0,18,35
1263,0,15,0,19,34
1264,0,35,0,16,51
1266,0,32,0,16,48
1267,0,16,0,16,32
1269,0,18,0,18,36
1270,0,34,0,15,49
1273,0,17,0,18,35
1274,0,34,0,17,51
1275,0,16,0,17,33
1276,0,33,0,17,50
1277,0,16,0,17,33
1278,0,33,0,16,49
1279,0,16,0,16,32
1280,0,34,0,16,50
1282,0,34,0,15,49
1283,0,18,0,15,33
1284,0,34,0,14,48
1286,0,32,0,17,49
1289,0,16,16,18,50
1293,0,15,0,18,33
1294,0,34,0,16,50
1295,0,16,0,16,32
1296,0,38,0,12,50
1297,0,22,0,12,34
1298,0,30,0,14,44
1299,0,18,0,14,32
1301,0,19,0,17,36
1303,0,15,19,16,50
1305,0,16,0,17,33
1307,0,16,16,18,50
1308,0,34,0,17,51
1310,0,32,0,17,49
1313,0,16,0,17,33
1314,0,34,0,16,50
1315,0,17,0,16,33
1316,0,33,0,17,50
1317,0,17,0,17,34
1321,0,14,18,17,49
1322,0,35,0,16,51
1323,0,17,0,16,33
1324,0,32,0,17,49
1325,0,16,0,17,33
1327,0,18,0,16,34
1328,0,32,0,16,48
1329,0,16,0,16,32
1331,0,17,0,18,35
1332,0,37,0,12,49
1333,0,19,0,12,31
1334,0,31,0,14,45
1335,0,19,0,14,33
1336,0,33,0,16,49
1337,0,19,0,16,35
1338,0,34,0,16,50
1339,0,18,0,16,34
1340,0,32,0,16,48
1343,0,18,0,17,35
1344,0,32,0,17,49
1345,0,15,0,17,32
1346,0,34,0,16,50
1348,0,34,0,16,50
1349,0,18,0,16,34
1350,0,33,0,16,49
1351,0,17,0,16,33
1352,0,32,0,17,49
1353,0,16,0,17,33
1356,0,35,0,16,51
1357,0,19,0,16,35
1358,0,32,0,15,47
1359,0,16,0,15,31
1360,0,34,0,16,50
1361,0,19,0,16,35
1363,0,17,0,17,34
1364,0,33,0,15,48
1365,0,16,0,15,31
1366,0,33,0,18,51
1369,0,14,0,18,32
1370,0,35,0,15,50
1371,0,17,0,15,32
1372,0,34,0,15,49
1373,0,19,0,15,34
1375,0,16,18,16,50
1376,0,34,0,16,50
1379,0,19,16,15,50
1380,0,31,0,16,47
1381,0,15,0,16,31
1382,0,34,0,18,52
1384,0,32,0,19,51
1385,0,14,0,19,33
1386,0,36,0,15,51
1387,0,17,0,15,32
1388,0,33,0,16,49
1389,0,18,0,16,34
1390,0,31,0,19,50
1391,0,15,0,19,34
1392,0,35,0,16,51
1394,0,33,0,16,49
1395,0,17,0,16,33
1396,0,34,0,15,49
1397,0,18,0,15,33
1398,0,33,0,15,48
1400,0,32,0,19,51
1402,0,32,0,21,53
1404,0,35,0,19,54
1405,0,14,0,19,33
1406,0,35,0,15,50
1407,0,16,0,15,31
1409,0,19,0,15,34
1413,0,17,0,18,35
1414,0,33,0,15,48
1416,0,34,0,17,51
1417,0,19,0,17,36
1419,0,15,17,17,49
1420,0,34,0,18,52
1422,0,33,0,16,49
1423,0,15,0,16,31
1425,0,17,17,18,52
1426,0,35,0,14,49
1427,0,18,0,14,32
1430,0,36,14,18,68
1431,0,18,14,18,50
1434,0,33,0,18,51
1435,0,16,0,18,34
1436,0,33,0,16,49
1437,0,15,0,16,31
1438,0,32,0,17,49
1439,0,16,0,17,33
1440,0,35,0,17,52
1441,0,18,0,17,35
1442,0,33,16,18,67
1443,0,16,16,18,50
1446,0,34,0,15,49
1447,0,17,0,15,32
1448,0,31,0,18,49
1449,0,16,0,18,34
1451,0,16,17,18,51
1453,0,18,0,14,32
1456,0,32,16,17,65
1457,0,16,16,17,49
1458,0,33,0,17,50
1459,0,17,0,17,34
1460,0,34,0,16,50
1461,0,17,0,16,33
1462,0,34,0,16,50
1463,0,18,0,16,34
1465,0,17,0,17,34
1466,0,32,0,17,49
1467,0,15,0,17,32
1469,0,18,0,15,33
1471,0,19,16,15,50
1472,0,31,0,17,48
1476,0,30,18,17,65
1477,0,14,18,17,49
1479,0,17,0,18,35
1480,0,35,15,16,66
1481,0,17,15,16,48
1482,0,31,0,18,49
1483,0,16,0,18,34
1484,0,36,0,15,51
1486,0,31,0,17,48
1487,0,16,0,17,33
1488,0,35,0,15,50
1491,0,19,0,15,34
1492,0,32,0,16,48
1494,0,33,0,16,49
1495,0,17,0,16,33
1496,0,34,0,14,48
1498,0,33,0,15,48
1500,0,33,0,17,50
1501,0,18,0,17,35
1502,0,32,0,17,49
1504,0,37,0,15,52
1505,0,20,0,15,35
1508,0,34,0,18,52
1509,0,15,0,18,33
1510,0,32,0,18,50
1511,0,14,0,18,32
1512,0,34,0,17,51
1513,0,16,0,17,33
1514,0,35,0,14,49
1515,0,18,0,14,32
1516,0,33,0,14,47
1518,0,33,0,14,47
1519,0,19,0,14,33
1520,0,32,0,15,47
1521,0,18,0,15,33
1522,0,32,0,17,49
1525,0,18,0,15,33
1526,0,32,0,17,49
1527,0,17,0,17,34
1528,0,35,0,18,53
1529,0,18,0,18,36
1531,0,15,0,16,31
1532,0,32,0,17,49
1533,0,16,0,17,33
1535,0,19,0,14,33
1536,0,33,0,16,49
1538,0,33,0,16,49
1540,0,32,0,16,48
1541,0,16,0,16,32
1542,0,34,0,17,51
1543,0,18,0,17,35
1544,0,32,18,18,68
1545,0,15,18,18,51
1546,0,36,16,16,68
1547,0,18,16,16,50
1548,0,32,17,17,66
1549,0,16,17,17,50
1550,0,34,15,18,67
1552,0,33,0,15,48
1553,0,18,0,15,33
1554,0,34,0,14,48
1556,0,31,0,18,49
1557,0,17,0,18,35
1558,0,33,0,18,51
1559,0,15,0,18,33
1560,0,34,0,17,51
1561,0,16,0,17,33
1562,0,34,17,16,67
1564,0,33,0,17,50
1565,0,16,0,17,33
1567,0,16,17,17,50
1569,0,17,0,18,35
1570,0,33,0,17,50
1573,0,17,0,16,33
1574,0,33,0,17,50
1575,0,17,0,17,34
1576,0,32,0,19,51
1577,0,15,0,19,34
1578,0,35,0,15,50
1580,0,32,0,18,50
1581,0,17,0,18,35
1583,0,17,0,18,35
1586,0,31,0,18,49
1587,0,16,0,18,34
1588,0,34,0,18,52
1589,0,16,0,18,34
1590,0,34,0,16,50
1591,0,16,0,16,32
1592,0,33,0,17,50
1593,0,17,0,17,34
1594,0,32,0,19,51
1595,0,15,0,19,34
1596,0,37,15,15,67
1598,0,30,0,17,47
1599,0,15,0,17,32
1600,0,35,0,17,52
1602,0,33,0,17,50
1604,0,34,0,17,51
1607,0,15,0,17,32
1608,0,35,16,16,67
1609,0,18,16,16,50
1610,0,32,0,16,48
1611,0,16,0,16,32
1614,0,33,0,16,49
1616,0,33,0,19,52
1619,0,15,0,17,32
1621,0,17,0,18,35
1623,0,15,0,18,33
1624,0,32,0,20,52
1625,0,14,0,20,34
1626,0,35,0,16,51
1627,0,15,0,16,31
1629,0,16,0,16,32
1630,0,34,0,16,50
1632,0,34,0,17,51
1633,0,18,0,17,35
1634,0,32,0,17,49
1635,0,15,0,17,32
1636,0,35,16,18,69
1641,0,19,0,15,34
1642,0,32,0,17,49
1643,0,17,0,17,34
1644,0,33,0,16,49
1645,0,16,0,16,32
1646,0,34,17,16,67
1647,0,18,17,16,51
1648,0,33,0,18,51
1651,0,15,0,18,33
1652,0,34,0,17,51
1653,0,16,0,17,33
1654,0,34,0,17,51
1655,0,17,0,17,34
1657,0,15,0,16,31
1658,0,36,0,15,51
1659,0,20,0,15,35
1660,0,32,0,17,49
1661,0,17,0,17,34
1662,0,32,0,16,48
1664,0,34,0,18,52
1665,0,18,0,18,36
1667,0,19,0,13,32
1668,0,31,0,17,48
1670,0,31,0,18,49
1671,0,14,0,18,32
1672,0,35,0,15,50
1674,0,31,0,19,50
1675,0,16,0,19,35
1676,0,36,0,16,52
1677,0,17,0,16,33
1679,0,17,0,17,34
1680,0,33,0,17,50
1681,0,16,0,17,33
1682,0,34,0,17,51
1683,0,17,0,17,34
1684,0,31,0,17,48
1685,0,14,0,17,31
1686,0,34,0,19,53
1689,0,15,0,16,31
1691,0,16,0,18,34
1693,0,15,0,17,32
1694,0,35,16,16,67
1695,0,18,16,16,50
1696,0,32,0,18,50
1697,0,16,0,18,34
1698,0,34,0,17,51
1700,0,33,18,17,68
1701,0,16,18,17,51
1702,0,35,0,17,52
1703,0,17,0,17,34
1705,0,15,0,16,31
1707,0,17,0,17,34
1708,0,35,17,15,67
1709,0,18,17,15,50
1710,0,32,0,18,50
1711,0,15,0,18,33
1712,0,35,15,20,70
1713,0,17,15,20,52
1714,0,35,0,15,50
1715,0,20,0,15,35
1716,0,31,0,17,48
1718,0,34,0,16,50
1721,0,15,0,19,34
1722,0,35,0,15,50
1724,0,34,0,15,49
1727,0,16,0,18,34
1728,0,34,0,17,51
1729,0,16,0,17,33
1731,0,19,0,14,33
1732,0,30,0,19,49
1733,0,16,0,19,35
1734,0,36,0,14,50
1735,0,17,0,14,31
1736,0,33,0,14,47
1737,0,19,0,14,33
1738,0,33,16,16,65
1739,0,19,16,16,51
1740,0,32,0,17,49
1741,0,16,0,17,33
1742,0,36,0,14,50
1743,0,19,0,14,33
1744,0,32,0,16,48
1746,0,32,0,17,49
1748,0,35,0,14,49
1749,0,18,0,14,32
1751,0,18,19,14,51
1752,0,33,0,17,50
1753,0,14,0,17,31
1754,0,34,0,17,51
1756,0,34,18,13,65
1757,0,17,18,13,48
1758,0,31,0,18,49
1759,0,13,0,18,31
1760,0,36,0,17,53
1761,0,18,0,17,35
1764,0,33,0,17,50
1765,0,16,0,17,33
1766,0,34,18,15,67
1767,0,17,18,15,50
1768,0,33,0,17,50
1770,0,33,0,18,51
1771,0,16,0,18,34
1772,0,33,0,17,50
1774,0,34,0,18,52
1776,0,34,0,16,50
1777,0,16,0,16,32
1778,0,33,0,18,51
1779,0,17,0,18,35
1780,0,35,0,18,53
1781,0,17,0,18,35
1782,0,31,0,19,50
1783,0,13,0,19,32
1785,0,14,0,19,33
1788,0,32,0,15,47
1789,0,15,0,15,30
1790,0,33,17,18,68
1791,0,18,17,18,53
1794,0,32,0,17,49
1795,0,18,0,17,35
1796,0,34,0,17,51
1797,0,17,0,17,34
1798,0,32,0,15,47
1799,0,15,0,15,30
1800,0,33,0,16,49
1803,0,19,0,17,36
1804,0,32,0,16,48
1805,0,15,0,16,31
1807,0,18,0,16,34
1808,0,33,0,18,51
1810,0,32,0,18,50
1811,0,14,0,18,32
1812,0,36,14,18,68
1813,0,18,14,18,50
1814,0,32,0,16,48
1817,0,16,0,18,34
1819,0,16,0,18,34
1821,0,16,0,19,35
1822,0,35,0,16,51
1823,0,16,0,16,32
1825,0,16,0,16,32
1826,0,33,0,16,49
1827,0,17,0,16,33
1828,0,33,0,18,51
1829,0,17,0,18,35
1833,0,17,0,17,34
1834,0,32,0,19,51
1835,0,15,0,19,34
1837,0,16,0,16,32
1839,0,15,0,18,33
1840,0,34,0,17,51
1842,0,35,0,15,50
1845,0,17,0,16,33
1846,16,19,15,16,66
1847,0,19,15,16,50
1848,0,31,16,19,66
1849,0,16,16,19,51
1850,0,35,0,18,53
1851,0,19,0,18,37
1852,0,33,0,15,48
1853,0,15,0,15,30
1854,0,32,0,18,50
1857,0,16,0,16,32
1858,0,33,0,18,51
1860,0,36,14,16,66
1861,0,18,14,16,48
1862,0,30,0,19,49
1863,0,16,0,19,35
1864,0,35,0,16,51
1866,0,32,0,17,49
1867,0,16,0,17,33
1868,0,33,0,18,51
1869,0,16,0,18,34
1870,0,34,0,17,51
1873,0,17,0,16,33
1874,0,34,0,15,49
1876,0,32,0,19,51
1877,0,17,0,19,36
1878,0,33,0,16,49
1879,0,14,0,16,30
1880,0,35,0,19,54
1881,0,19,0,19,38
1882,0,32,0,20,52
1883,0,13,0,20,33
1885,0,15,0,16,31
1886,0,32,0,17,49
1887,0,16,0,17,33
1888,0,33,0,18,51
1891,0,16,0,17,33
1893,0,15,0,20,35
1894,0,34,0,16,50
1897,0,18,0,18,36
1898,0,33,0,16,49
1899,0,15,0,16,31
1900,0,35,0,14,49
1901,0,19,0,14,33
1902,0,31,0,17,48
1903,0,17,0,17,34
1904,0,34,0,16,50
1905,0,17,0,16,33
1906,0,32,0,18,50
1907,0,16,0,18,34
1911,0,16,0,17,33
1912,0,34,16,19,69
1913,0,17,16,19,52
1914,0,35,0,13,48
1915,0,19,0,13,32
1916,0,30,0,18,48
1919,0,16,0,16,32
1922,0,36,15,19,70
1923,0,18,15,19,52
1924,0,34,0,17,51
1925,0,19,0,17,36
1926,0,33,15,16,64
1927,0,16,15,16,47
1928,0,31,0,17,48
1929,0,16,0,17,33
1930,0,35,0,17,52
1932,0,34,0,16,50
1935,0,15,0,18,33
1936,0,35,0,16,51
1939,0,16,0,19,35
1940,0,33,0,17,50
1942,0,36,0,16,52
1943,0,19,0,16,35
1944,0,33,0,16,49
1946,0,32,0,18,50
1947,0,16,0,18,34
1948,0,34,0,17,51
1951,0,16,0,15,31
1954,0,35,0,15,50
1955,0,17,0,15,32
1956,0,34,0,17,51
1957,0,19,0,17,36
1958,0,33,0,18,51
1959,0,16,0,18,34
1960,0,32,0,17,49
1961,0,14,0,17,31
1963,0,19,0,14,33
1964,0,30,0,17,47
1966,0,34,0,18,52
1967,0,17,0,18,35
1968,0,34,0,18,52
1969,0,16,0,18,34
1973,0,16,0,15,31
1976,0,32,0,16,48
1978,0,34,0,17,51
1979,0,18,0,17,35
1980,0,32,0,16,48
1982,0,33,0,17,50
1983,0,17,0,17,34
1984,0,33,18,17,68
1985,0,16,18,17,51
1987,0,17,0,16,33
1989,0,16,18,15,49
1991,0,15,0,17,32
1992,0,33,0,16,49
1993,0,16,0,16,32
1994,0,33,0,19,52
1995,0,17,0,19,36
2000,0,32,19,16,67
2001,0,16,19,16,51
2002,0,35,0,14,49
2003,0,16,0,14,30
2005,0,20,16,16,52
2006,0,32,17,16,65
2007,0,16,17,16,49
2008,0,33,0,18,51
2013,0,19,0,15,34
2014,0,33,0,13,46
2015,0,18,0,13,31
2016,0,32,0,16,48
2018,0,31,0,19,50
2019,0,15,0,19,34
2020,0,33,0,17,50
2021,0,14,0,17,31
2022,0,36,0,16,52
2023,0,19,0,16,35
2025,0,17,0,15,32
2026,0,32,0,16,48
2027,0,17,0,16,33
2028,0,33,0,18,51
2029,0,17,0,18,35
2030,0,34,0,16,50
2031,0,16,0,16,32
2032,0,32,0,18,50
2033,0,16,0,18,34
2034,0,35,0,18,53
2035,0,17,0,18,35
2037,0,15,0,16,31
2039,0,16,0,17,33
2041,0,17,0,17,34
2042,0,33,0,18,51
2043,0,16,0,18,34
2044,0,34,17,18,69
2045,0,16,17,18,51
2046,0,35,0,20,55
2047,0,18,0,20,38
2048,0,32,0,17,49
2049,0,12,0,17,29
2050,0,36,0,15,51
2052,0,32,0,18,50
2054,0,33,0,17,50
2055,0,15,0,17,32
2056,0,31,0,20,51
2057,0,14,0,20,34
2058,0,36,20,11,67
2059,0,16,20,11,47
2060,0,31,0,17,48
2061,0,11,0,17,28
2062,0,33,18,16,67
2063,0,16,18,16,50
2065,0,16,0,16,32
2066,0,33,17,19,69
2068,0,36,0,14,50
2069,0,19,0,14,33
2070,0,31,0,16,47
2072,0,33,0,19,52
2074,0,33,0,18,51
2077,0,16,0,17,33
2079,0,18,0,16,34
2080,0,31,0,17,48
2081,0,15,0,17,32
2082,0,35,0,17,52
2083,0,18,0,17,35
2085,0,15,0,18,33
2086,0,33,0,24,57
2087,0,15,0,24,39
2088,0,36,0,24,60
2089,0,12,0,24,36
2091,0,43,0,17,60
2092,19,18,0,17,54
2093,0,18,0,17,35
2095,0,13,0,18,31
2098,0,35,0,17,52
2099,0,17,0,17,34
2100,0,35,0,16,51
2101,0,18,0,16,34
2102,0,32,0,21,53
2103,0,16,0,21,37
2104,0,33,0,19,52
2106,0,34,0,16,50
2108,0,35,16,17,68
2109,0,19,16,17,52
2110,0,33,0,14,47
2111,0,17,0,14,31
2112,0,32,17,16,65
2113,0,18,17,16,51
2114,0,33,0,17,50
2115,0,16,0,17,33
2116,0,34,0,15,49
2119,0,17,17,16,50
2120,0,33,0,17,50
2121,0,16,0,17,33
2122,0,34,0,19,53
2124,0,34,0,16,50
2125,0,15,0,16,31
2126,0,34,0,14,48
2127,0,18,0,14,32
2128,0,31,0,19,50
2129,0,17,0,19,36
2130,0,34,0,17,51
2131,0,15,0,17,32
2132,0,35,0,16,51
2133,0,18,0,16,34
2134,0,33,15,17,65
2136,0,32,0,19,51
2137,0,17,0,19,36
2138,0,33,0,19,52
2139,0,14,0,19,33
2140,0,34,0,16,50
2141,0,15,0,16,31
2142,0,33,0,17,50
2144,0,36,0,15,51
2145,0,19,0,15,34
2146,0,32,0,16,48
2147,0,17,0,16,33
2148,0,33,0,17,50
2150,0,32,0,17,49
2151,0,15,0,17,32
2153,0,18,0,15,33
2155,0,17,0,18,35
2157,0,17,16,16,49
2158,0,32,0,17,49
2159,0,16,0,17,33
2160,0,33,0,18,51
2162,0,34,17,15,66
2165,0,15,17,18,50
2166,0,35,0,17,52
2169,0,15,18,16,49
2171,0,16,21,14,51
2172,0,35,0,14,49
2173,0,14,0,14,28
2174,0,33,0,16,49
2175,0,19,0,16,35
2178,16,17,0,17,50
2179,0,17,0,17,34
2180,0,34,0,17,51
2181,0,17,0,17,34
2182,0,35,0,16,51
2183,0,18,0,16,34
2185,0,15,17,17,49
2186,17,17,0,17,51
2187,0,17,0,17,34
2188,0,34,0,16,50
2189,0,17,0,16,33
2190,0,32,0,17,49
2191,0,16,0,17,33
2192,0,35,0,15,50
2195,0,16,0,17,33
2196,0,36,0,16,52
2198,0,31,0,17,48
2199,0,15,0,17,32
2201,0,16,0,17,33
2203,0,21,0,14,35
2205,0,15,0,18,33
2206,0,34,0,17,51
2207,0,16,0,17,33
2211,0,18,0,20,38
2212,0,36,0,15,51
2213,0,16,0,15,31
2214,0,31,0,17,48
2215,0,16,0,17,33
2216,0,32,0,16,48
2217,0,15,0,16,31
2218,0,34,0,17,51
2219,0,18,0,17,35
2221,0,15,0,19,34
2222,0,36,0,15,51
2223,0,17,0,15,32
2224,0,33,0,16,49
2225,0,18,0,16,34
2228,0,34,0,17,51
2229,0,16,0,17,33
2230,0,34,0,16,50
2233,0,17,0,17,34
2234,0,34,0,16,50
2236,0,33,0,16,49
2237,0,17,0,16,33
2238,0,33,0,15,48
2240,0,33,0,17,50
2241,0,18,0,17,35
2243,0,16,0,18,34
2245,0,16,0,15,31
2246,0,35,0,15,50
2247,0,20,0,15,35
2248,0,33,0,14,47
2249,18,31,0,17,66
2250,0,31,0,17,48
2251,0,17,0,17,34
2252,0,35,0,16,51
2253,0,18,0,16,34
2255,0,17,0,16,33
2256,0,33,0,16,49
2257,0,17,0,16,33
2259,0,16,0,18,34
2261,0,17,0,15,32
2265,0,18,0,15,33
2266,0,35,17,16,68
2268,17,16,0,16,49
2270,0,35,0,13,48
2273,0,18,0,17,35
2274,0,35,0,16,51
2275,0,18,0,16,34
2276,0,31,0,19,50
2277,0,15,0,19,34
2278,0,39,0,28,67
2279,0,20,0,28,48
2280,0,28,16,20,64
2281,0,17,16,20,53
2282,0,36,0,17,53
2283,0,20,0,17,37
2284,0,32,16,15,63
2285,0,15,16,15,46
2286,0,31,0,20,51
2287,0,15,0,20,35
2289,0,15,0,16,31
2290,0,32,0,17,49
2291,0,16,0,17,33
2292,0,33,0,19,52
2293,0,16,0,19,35
2294,0,37,0,15,52
2296,0,31,0,17,48
2298,0,35,0,15,50
2299,0,18,0,15,33
2300,0,34,0,13,47
2302,0,33,0,17,50
2303,0,20,0,17,37
2305,0,16,0,16,32
2306,0,32,0,17,49
2307,0,16,0,17,33
2308,0,36,0,16,52
2309,0,19,0,16,35
2311,0,14,0,19,33
2314,0,35,0,14,49
2315,0,17,0,14,31
2316,0,34,0,13,47
2317,0,20,0,13,33
2318,0,30,0,19,49
2319,0,17,0,19,36
2320,0,35,0,16,51
2321,0,16,0,16,32
2322,0,33,0,16,49
2323,0,17,0,16,33
2324,0,35,0,17,52
2325,0,19,0,17,36
2326,0,34,0,13,47
2327,0,17,0,13,30
2330,0,34,0,17,51
2331,0,15,0,17,32
2333,0,15,0,17,32
2335,0,17,0,18,35
2336,0,34,0,16,50
2337,0,16,0,16,32
2338,0,35,0,14,49
2340,0,32,0,18,50
2341,0,18,0,18,36
2342,0,35,14,15,64
2343,0,17,14,15,46
2344,0,29,19,18,66
2345,0,15,19,18,52
2347,0,18,15,17,50
2348,0,32,18,15,65
2349,0,17,18,15,50
2350,0,33,17,18,68
2353,0,18,0,17,35
2356,0,33,17,16,66
2357,0,15,17,16,48
2358,0,33,17,15,65
2360,0,32,0,18,50
2362,0,36,0,16,52
2364,0,31,0,20,51
2365,0,15,0,20,35
2366,0,33,0,17,50
2367,0,13,0,17,30
2368,0,34,0,17,51
2369,0,17,0,17,34
2371,0,19,0,15,34
2372,0,34,0,31,65
2373,0,19,0,31,50
2374,0,31,0,16,47
2375,0,18,0,16,34
2377,0,16,0,18,34
2378,0,34,0,16,50
2379,0,16,0,16,32
2381,0,19,0,14,33
2382,0,33,0,15,48
2383,0,19,0,15,34
2384,0,32,0,18,50
2385,0,17,0,18,35
2388,0,33,0,17,50
2389,0,17,0,17,34
2390,0,34,0,16,50
2391,0,17,0,16,33
2393,0,18,0,16,34
2394,0,33,0,15,48
2395,0,17,0,15,32
2397,0,17,16,16,49
2398,0,32,0,17,49
2399,0,16,0,17,33
2400,0,34,0,16,50
2401,0,17,0,16,33
2402,0,34,0,18,52
2403,0,18,0,18,36
2404,0,34,0,15,49
2405,0,16,0,15,31
2407,0,18,0,17,35
2408,0,34,0,16,50
2409,0,17,0,16,33
2410,0,34,0,15,49
2412,0,30,0,19,49
2414,0,35,0,16,51
2415,0,16,0,16,32
2416,0,35,0,16,51
2417,0,19,0,16,35
2418,0,32,0,16,48
2419,0,16,0,16,32
2420,0,34,0,15,49
2422,0,32,0,18,50
2425,0,16,0,18,34
2426,0,34,0,15,49
2427,0,16,0,15,31
2428,0,32,0,16,48
2429,0,17,0,16,33
2430,0,34,0,16,50
2431,0,18,0,16,34
2432,0,34,0,15,49
2434,0,33,0,16,49
2435,0,18,0,16,34
2439,0,20,0,15,35
2440,0,31,0,18,49
2441,0,16,0,18,34
2442,0,34,0,16,50
2444,0,33,0,17,50
2445,0,17,0,17,34
2446,0,32,0,19,51
2450,0,33,0,16,49
2451,0,16,0,16,32
2452,0,34,0,17,51
2453,0,18,0,17,35
2454,0,33,0,18,51
2456,0,34,0,15,49
2457,0,16,0,15,31
2458,0,33,0,16,49
2460,0,31,18,17,66
2461,0,15,18,17,50
2462,0,35,0,16,51
2463,0,17,0,16,33
2465,0,18,15,17,50
2469,0,16,18,16,50
2470,0,34,0,16,50
2473,0,18,15,17,50
2474,0,32,0,16,48
2477,0,17,19,16,52
2478,0,35,0,17,52
2479,0,16,0,17,33
2480,0,31,0,20,51
2481,0,14,0,20,34
2482,0,35,0,18,53
2483,0,15,0,18,33
2484,0,34,16,17,67
2485,0,16,16,17,49
2486,0,33,0,17,50
2487,0,17,0,17,34
2488,0,31,0,17,48
2489,0,14,0,17,31
2491,0,18,0,18,36
2492,0,32,0,17,49
2493,0,14,0,17,31
2495,0,16,0,18,34
2496,0,35,0,17,52
2497,0,17,0,17,34
2502,0,33,0,16,49
2503,0,21,0,16,37
2505,0,17,0,16,33
2508,0,34,0,13,47
2510,0,31,0,17,48
2511,0,18,0,17,35
2512,0,35,0,15,50
2514,0,32,0,16,48
2515,0,17,0,16,33
2516,0,32,0,17,49
2518,0,34,0,17,51
2519,0,17,0,17,34
2520,0,34,0,18,52
2523,0,14,0,19,33
2524,0,35,0,15,50
2525,0,16,0,15,31
2526,0,31,0,19,50
2527,0,16,0,19,35
2531,0,16,0,16,32
2532,0,33,0,15,48
2534,0,33,0,18,51
2536,0,33,0,16,49
2537,0,15,0,16,31
2538,0,32,0,20,52
2540,0,36,0,16,52
2541,0,16,0,16,32
2542,0,32,0,21,53
2543,0,16,0,21,37
2544,0,21,0,29,50
2547,0,17,0,17,34
2549,0,17,16,18,51
2550,0,34,0,15,49
2552,0,31,0,19,50
2553,0,16,0,19,35
2554,0,34,0,18,52
2555,0,15,0,18,33
2556,0,33,0,17,50
2557,0,15,0,17,32
2559,0,18,0,15,33
2560,0,32,0,17,49
2561,0,17,0,17,34
2562,0,33,0,18,51
2563,0,16,0,18,34
2564,0,36,0,15,51
2566,0,31,0,17,48
2567,0,16,0,17,33
2572,0,34,0,17,51
2573,0,16,0,17,33
2574,0,32,0,18,50
2575,0,15,0,18,33
2577,0,17,0,16,33
2578,0,33,16,17,66
2579,0,17,16,17,50
2581,0,17,0,17,34
2583,0,16,17,17,50
2584,0,34,0,15,49
2586,0,30,0,19,49
2587,0,15,0,19,34
2588,0,36,0,17,53
2590,0,33,16,18,67
2591,0,16,16,18,50
2592,0,34,0,18,52
2593,0,18,0,18,36
2594,0,35,0,15,50
2595,0,17,0,15,32
2596,0,32,16,16,64
2597,0,17,16,16,49
2600,0,35,0,14,49
2602,0,33,0,14,47
2603,0,19,0,14,33
2605,0,20,0,16,36
2606,0,32,0,17,49
2607,0,16,0,17,33
2608,0,33,0,17,50
2609,0,16,0,17,33
2611,0,17,0,16,33
2612,0,34,0,16,50
2614,0,32,0,17,49
2615,0,16,0,17,33
2617,0,17,0,16,33
2618,0,32,0,18,50
2620,0,34,0,16,50
2621,0,16,0,16,32
2624,0,35,15,16,66
2625,0,17,15,16,48
2626,0,31,0,17,48
2627,0,16,0,17,33
2629,0,22,0,29,51
2630,0,29,0,17,46
2631,16,35,14,19,84
2633,0,18,14,19,51
2634,0,33,0,15,48
2635,0,19,0,15,34
2636,0,32,0,16,48
2637,0,17,0,16,33
2638,0,33,0,18,51
2639,0,17,0,18,35
2642,0,32,0,16,48
2644,0,34,0,15,49
2645,0,18,0,15,33
2646,0,34,0,15,49
2648,0,32,0,17,49
2649,0,17,0,17,34
2650,0,33,0,17,50
2652,0,32,0,19,51
2653,0,15,0,19,34
2654,0,37,0,15,52
2655,0,18,0,15,33
2656,0,32,0,16,48
2657,0,17,0,16,33
2658,0,32,0,19,51
2660,0,35,0,15,50
2661,0,16,0,15,31
2662,0,34,0,15,49
2663,0,19,0,15,34
2664,0,31,0,18,49
2666,0,34,0,18,52
2667,0,16,0,18,34
2669,0,16,0,16,32
2670,0,32,0,17,49
2673,0,19,0,15,34
2674,0,32,0,15,47
2675,0,17,0,15,32
2676,0,31,0,18,49
2677,0,16,0,18,34
2680,0,32,0,16,48
2681,0,16,0,16,32
2682,0,32,0,19,51
2683,0,16,0,19,35
2685,0,16,0,16,32
2686,0,34,0,14,48
2687,0,18,0,14,32
2688,0,31,0,16,47
2691,0,18,0,16,34
2692,0,35,0,15,50
2693,0,19,0,15,34
2694,0,31,0,18,49
2696,0,35,0,17,52
2697,0,17,0,17,34
2698,0,32,0,17,49
2699,0,15,0,17,32
2700,0,34,0,16,50
2701,0,17,0,16,33
2702,0,34,0,15,49
2703,0,18,0,15,33
2704,0,32,0,18,50
2705,0,17,0,18,35
2706,0,34,0,16,50
2709,0,18,0,17,35
2710,0,32,0,17,49
2712,0,37,14,15,66
2713,0,20,14,15,49
2714,0,29,18,17,64
2715,0,15,18,17,50
2717,0,17,0,15,32
2718,0,33,16,17,66
2719,0,18,16,17,51
2720,0,33,0,17,50
2722,0,33,0,17,50
2724,0,33,0,16,49
2725,0,16,0,16,32
2727,0,17,0,19,36
2728,0,34,0,18,52
2730,0,33,0,19,52
2735,0,14,0,19,33
2737,0,17,0,15,32
2738,0,32,0,16,48
2739,0,17,0,16,33
2740,0,34,15,19,68
2742,0,34,14,17,65
2743,0,19,14,17,50
2744,0,31,0,17,48
2745,0,17,0,17,34
2747,0,18,16,17,51
2748,0,33,0,16,49
2750,0,33,0,16,49
2752,0,34,17,15,66
2753,0,18,17,15,50
2754,0,32,0,17,49
2755,0,15,0,17,32
2757,0,18,0,15,33
2758,0,32,0,17,49
2759,0,17,0,17,34
2760,0,35,0,15,50
2761,0,18,0,15,33
2763,0,19,15,17,51
2764,0,32,16,17,65
2766,0,33,0,17,50
2767,0,17,0,17,34
2771,0,17,0,16,33
2774,0,35,0,15,50
2775,0,18,0,15,33
2776,0,33,0,15,48
2777,0,18,0,15,33
2778,0,34,0,15,49
2779,0,19,0,15,34
2780,0,31,0,18,49
2781,0,16,0,18,34
2782,0,36,0,15,51
2783,0,18,0,15,33
2784,0,34,0,14,48
2785,0,19,0,14,33
2786,0,30,0,18,48
2787,0,16,0,18,34
2788,0,35,0,17,52
2789,0,17,0,17,34
2793,0,16,0,18,34
2794,0,32,0,17,49
2795,0,14,0,17,31
2797,0,17,0,17,34
2798,0,34,0,17,51
2799,0,17,0,17,34
2800,0,33,0,18,51
2802,0,37,0,18,55
2803,0,19,0,18,37
2804,0,18,0,29,47
2805,0,45,0,18,63
2806,0,33,0,18,51
2809,0,15,0,18,33
2810,0,34,0,17,51
2811,0,16,0,17,33
2812,0,33,0,16,49
2814,0,35,0,16,51
2815,0,19,0,16,35
2816,0,33,0,15,48
2817,0,17,0,15,32
2818,0,33,0,16,49
2821,0,17,0,17,34
2822,0,34,0,15,49
2823,0,17,0,15,32
2825,0,16,0,18,34
2827,0,16,0,18,34
2828,0,35,0,17,52
2831,0,14,0,19,33
2832,0,35,0,15,50
2833,0,16,0,15,31
2834,0,34,0,16,50
2836,0,32,0,16,48
2837,0,16,0,16,32
2838,0,33,0,20,53
2839,0,17,0,20,37
2841,0,14,0,16,30
2842,0,34,0,17,51
2843,0,18,0,17,35
2844,0,33,0,17,50
2845,0,16,0,17,33
2846,0,34,0,17,51
2847,0,17,0,17,34
2848,0,33,0,17,50
2849,0,16,0,17,33
2850,0,31,0,19,50
2851,0,14,0,19,33
2852,0,36,0,18,54
2853,0,17,0,18,35
2855,0,14,16,19,49
2856,0,35,0,15,50
2857,0,19,0,15,34
2859,0,18,0,15,33
2860,0,33,0,15,48
2862,0,32,0,16,48
2863,0,17,0,16,33
2865,0,18,16,16,50
2866,0,32,0,17,49
2867,0,16,0,17,33
2869,0,17,0,19,36
2870,0,34,0,17,51
2871,0,15,0,17,32
2873,0,18,14,19,51
2874,0,33,0,16,49
2876,0,32,0,19,51
2877,0,16,0,19,35
2878,0,35,0,15,50
2879,0,16,0,15,31
2880,0,31,0,16,47
2882,0,33,19,16,68
2883,0,17,19,16,52
2886,0,32,0,19,51
2887,0,16,0,19,35
2888,0,35,0,17,52
2890,0,32,0,16,48
2892,0,35,0,16,51
2896,0,36,0,15,51
2900,0,35,0,18,53
2901,0,16,0,18,34
2903,0,15,0,18,33
2904,0,33,0,17,50
2906,0,33,0,17,50
2907,0,16,0,17,33
2909,0,17,0,18,35
2910,0,35,0,15,50
2911,0,17,0,15,32
2912,0,32,0,16,48
2913,0,17,0,16,33
2914,0,33,0,17,50
2915,0,17,0,17,34
2917,0,16,0,18,34
2918,0,34,0,16,50
2920,0,32,0,18,50
2922,0,36,0,15,51
2923,0,18,0,15,33
2924,0,32,0,18,50
2925,0,17,0,18,35
2927,0,16,0,16,32
2928,0,32,0,18,50
2929,0,16,0,18,34
2930,0,35,0,18,53
2931,0,17,0,18,35
2932,0,31,0,19,50
2933,0,13,0,19,32
2934,0,33,0,20,53
2935,0,14,0,20,34
2936,0,34,0,19,53
2938,0,35,0,15,50
2941,0,22,0,32,54
2942,0,32,0,15,47
2943,20,29,0,16,65
2944,0,29,0,16,45
2946,0,34,0,18,52
2947,0,18,0,18,36
2948,0,33,0,17,50
2949,0,15,0,17,32
2952,0,32,0,17,49
2955,0,15,0,18,33
2957,0,16,0,19,35
2958,0,33,0,16,49
2959,0,14,0,16,30
2960,0,35,0,18,53
2961,0,19,0,18,37
2962,0,31,0,17,48
2963,0,13,0,17,30
2964,0,33,0,18,51
2965,0,16,0,18,34
2966,0,35,0,18,53
2968,0,34,0,15,49
2969,0,16,0,15,31
2972,0,32,0,18,50
2974,0,35,0,15,50
2975,0,17,0,15,32
2976,0,32,0,16,48
2977,0,17,0,16,33
2978,0,34,0,18,52
2980,0,34,0,15,49
2981,0,16,0,15,31
2982,0,32,0,18,50
2983,0,17,0,18,35
2984,0,35,0,16,51
2985,0,17,0,16,33
2987,0,18,0,16,34
2989,0,15,0,17,32
2990,0,34,0,17,51
2991,0,17,0,17,34
2994,0,32,0,19,51
2995,0,16,0,19,35
2996,0,36,0,15,51
2997,0,17,0,15,32
2998,0,33,0,15,48
3000,0,34,0,15,49
3001,0,19,0,15,34
3003,0,18,0,18,36
3006,0,36,0,15,51
3007,0,18,0,15,33
3009,0,16,0,18,34
3010,0,34,0,17,51
3011,0,16,0,17,33
3012,0,34,0,15,49
3014,0,34,0,15,49
3015,0,19,0,15,34
3016,0,31,0,18,49
3019,0,16,0,17,33
3020,0,33,0,17,50
3022,0,35,0,16,51
3023,0,18,0,16,34
3024,0,31,0,18,49
3026,0,36,14,18,68
3027,0,18,14,18,50
3028,0,32,16,18,66
3029,0,18,16,18,52
3031,0,18,0,18,36
3032,0,36,0,30,66
3033,0,18,0,30,48
3035,16,34,0,15,65
3036,0,34,0,15,49
3037,0,17,0,15,32
3038,0,34,0,15,49
3040,0,33,0,16,49
3041,0,18,0,16,34
3043,0,18,16,15,49
3044,0,31,0,18,49
3045,0,15,0,18,33
3047,0,17,0,16,33
3048,0,31,0,18,49
3050,0,33,0,19,52
3051,0,15,0,19,34
3052,0,34,0,19,53
3053,0,15,0,19,34
3054,0,34,0,18,52
3056,0,35,0,17,52
3058,0,31,0,17,48
3061,0,17,0,16,33
3062,0,33,0,18,51
3063,0,17,0,18,35
3064,0,35,0,16,51
3065,0,17,0,16,33
3066,0,33,0,15,48
3068,0,32,0,17,49
3071,0,16,0,17,33
3072,0,36,0,15,51
3073,0,19,0,15,34
3074,0,33,0,16,49
3075,0,18,0,16,34
3076,0,31,0,20,51
3078,0,34,0,19,53
3079,0,14,0,19,33
3082,0,31,0,19,50
3083,0,17,0,19,36
3084,0,34,0,17,51
3085,0,15,0,17,32
3086,0,34,0,17,51
3088,0,34,0,17,51
3089,0,17,0,17,34
3090,0,34,0,14,48
3093,0,18,0,17,35
3094,0,35,0,14,49
3095,0,18,0,14,32
3097,0,18,0,16,34
3098,0,34,0,16,50
3099,0,18,0,16,34
3100,0,31,0,17,48
3101,0,15,0,17,32
3103,0,17,17,16,50
3104,0,33,0,17,50
3105,0,16,0,17,33
3106,0,36,0,16,52
3107,0,19,0,16,35
3108,0,32,0,18,50
3109,0,16,0,18,34
3110,0,32,0,19,51
3111,0,14,0,19,33
3112,0,35,0,17,52
3113,0,16,0,17,33
3114,0,33,0,17,50
3116,0,34,0,16,50
3117,0,17,0,16,33
3118,0,32,0,17,49
3119,0,16,0,17,33
3121,0,16,0,18,34
3122,0,34,0,18,52
3123,0,16,0,18,34
3125,0,14,18,17,49
3126,0,35,0,16,51
3127,0,17,0,16,33
3128,0,33,0,18,51
3129,0,17,0,18,35
3130,0,32,0,18,50
3132,0,35,17,15,67
3133,0,17,17,15,49
3134,0,32,0,16,48
3136,0,34,0,16,50
3138,0,34,0,16,50
3139,0,18,0,16,34
3140,0,36,12,20,68
3142,0,32,0,16,48
3146,0,32,0,17,49
3147,0,16,0,17,33
3149,0,17,18,15,50
3150,0,33,0,18,51
3151,0,15,0,18,33
3152,0,33,19,14,66
3153,0,15,19,14,48
3155,0,14,0,19,33
3157,0,15,18,15,48
3158,0,33,0,19,52
3159,0,15,0,19,34
3161,0,16,0,17,33
3164,0,30,0,18,48
3165,0,15,0,18,33
3167,0,16,0,17,33
3168,0,33,0,18,51
3169,0,16,0,18,34
3170,0,34,0,18,52
3172,0,33,0,18,51
3175,0,17,0,17,34
3176,0,31,17,19,67
3177,0,14,17,19,50
3178,0,36,0,16,52
3180,0,30,0,20,50
3182,0,35,0,17,52
3183,0,15,0,17,32
3184,0,34,0,17,51
3185,0,17,0,17,34
3187,0,15,0,17,32
3188,0,34,0,15,49
3189,0,17,0,15,32
3192,0,32,18,15,65
3193,0,18,18,15,51
3196,0,35,0,17,52
3199,0,14,0,16,30
3201,0,19,0,17,36
3202,0,31,0,17,48
3203,0,14,0,17,31
3204,0,36,0,16,52
3206,0,33,16,15,64
3207,0,17,16,15,48
3208,0,31,0,19,50
3211,0,16,0,17,33
3212,0,34,0,14,48
3214,0,34,15,18,67
3216,0,33,15,16,64
3217,0,18,15,16,49
3218,0,31,0,18,49
3219,0,16,0,18,34
3220,0,35,0,16,51
3221,0,17,0,16,33
3222,0,30,0,19,49
3224,0,35,0,19,54
3225,0,16,0,19,35
3226,0,36,0,14,50
3227,0,17,0,14,31
3228,0,33,15,16,64
3229,0,19,15,16,50
3231,0,16,0,18,34
3232,0,34,16,17,67
3233,0,16,16,17,49
3234,0,33,0,17,50
3235,0,17,0,17,34
3236,0,34,0,17,51
3238,0,34,0,16,50
3239,0,17,0,16,33
3241,0,18,0,16,34
3242,0,31,0,17,48
3243,0,15,0,17,32
3244,0,35,0,15,50
3245,0,18,0,15,33
3247,0,19,15,18,52
3249,0,18,0,17,35
3250,0,33,0,16,49
3252,0,32,0,19,51
3256,0,33,0,18,51
3258,0,35,14,16,65
3259,0,17,14,16,47
3262,0,36,0,14,50
3263,0,18,0,14,32
3265,0,19,15,17,51
3267,0,17,0,16,33
3269,0,17,0,16,33
3270,0,33,0,16,49
3271,0,17,0,16,33
3272,0,34,0,17,51
3273,0,18,0,17,35
3274,0,36,0,14,50
3275,0,19,0,14,33
3277,0,17,0,15,32
3278,0,34,0,15,49
3279,0,19,0,15,34
3280,0,34,0,16,50
3281,0,19,0,16,35
3282,0,31,0,16,47
3283,0,15,0,16,31
3284,0,35,0,15,50
3286,0,32,0,19,51
3287,0,17,0,19,36
3288,0,32,0,19,51
3289,0,13,0,19,32
3290,0,35,0,16,51
3291,0,16,0,16,32
3293,0,19,15,17,51
3294,0,32,0,16,48
3295,0,17,0,16,33
3296,0,34,0,15,49
3297,0,18,0,15,33
3298,0,31,0,18,49
3299,0,16,0,18,34
3300,0,36,0,16,52
3301,0,18,0,16,34
3304,0,32,0,18,50
3306,0,34,0,15,49
3307,0,16,0,15,31
3309,0,18,0,18,36
3310,0,33,0,19,52
3311,0,15,0,19,34
3312,0,34,0,17,51
3314,0,35,0,16,51
3315,0,18,0,16,34
3316,0,31,19,16,66
3317,0,15,19,16,50
3318,0,35,0,16,51
3319,0,16,0,16,32
3321,0,19,0,15,34
3322,0,33,15,18,66
3324,0,33,0,14,47
3326,0,31,0,19,50
3327,0,17,0,19,36
3328,0,35,0,17,52
3330,0,32,0,17,49
3331,0,15,0,17,32
3332,0,35,0,16,51
3333,0,18,0,16,34
3334,0,32,0,19,51
3335,0,16,0,19,35
3336,0,34,0,18,52
3342,0,36,0,16,52
3343,0,18,0,16,34
3344,0,32,0,18,50
3345,0,16,0,18,34
3346,0,32,0,18,50
3348,0,35,0,17,52
3349,0,17,0,17,34
3350,0,35,0,14,49
3352,0,33,0,16,49
3353,0,19,0,16,35
3354,0,33,0,17,50
3355,0,17,0,17,34
3356,0,31,0,17,48
3357,0,14,0,17,31
3358,0,35,0,16,51
3360,0,33,0,16,49
3362,0,33,0,17,50
3364,0,34,0,16,50
3366,0,33,0,16,49
3367,0,17,0,16,33
3368,0,33,0,17,50
3369,0,17,0,17,34
3370,0,34,0,17,51
3371,0,17,0,17,34
3372,0,33,0,15,48
3373,0,16,0,15,31
3374,0,32,0,18,50
3376,0,36,0,16,52
3377,0,18,0,16,34
3378,0,33,0,15,48
3379,0,17,0,15,32
3381,0,18,0,17,35
3383,0,17,0,15,32
3384,0,33,0,15,48
3385,0,18,0,15,33
3386,0,32,0,16,48
3387,0,17,0,16,33
3388,0,34,0,17,51
3393,0,14,0,19,33
3396,0,32,0,20,52
3397,0,15,0,20,35
3398,0,34,0,16,50
3399,0,14,0,16,30
3400,0,33,0,16,49
3401,0,17,0,16,33
3402,0,33,0,19,52
3403,0,17,0,19,36
3404,0,33,0,17,50
3406,0,34,0,16,50
3407,0,17,0,16,33
3408,0,33,0,18,51
3409,0,17,0,18,35
3410,0,34,0,18,52
3411,0,16,0,18,34
3413,0,16,0,17,33
3415,0,17,0,17,34
3417,0,16,0,16,32
3419,0,18,0,15,33
3420,0,32,0,18,50
3421,0,17,0,18,35
3422,0,35,0,15,50
3423,0,17,0,15,32
3424,0,32,0,15,47
3425,0,17,0,15,32
3427,0,16,0,18,34
3428,0,36,0,15,51
3430,0,33,0,15,48
3431,0,18,0,15,33
3432,0,32,0,17,49
3434,0,33,0,17,50
3435,0,16,0,17,33
3436,0,36,0,15,51
3438,0,33,0,16,49
3439,0,18,0,16,34
3441,0,17,0,15,32
3442,0,34,0,15,49
3443,0,19,0,15,34
3444,0,30,0,18,48
3445,0,15,0,18,33
3447,0,18,0,16,34
3448,0,35,0,15,50
3450,0,31,0,15,46
3451,0,16,0,15,31
3452,0,33,0,15,48
3453,0,18,0,15,33
3454,0,34,0,15,49
3455,0,19,0,15,34
3456,0,33,0,18,51
3458,0,33,0,16,49
3459,0,15,0,16,31
3460,0,34,0,16,50
3461,0,18,0,16,34
3462,0,34,0,16,50
3463,0,18,0,16,34
3464,0,33,0,17,50
3465,0,17,0,17,34
3466,0,31,18,17,66
3467,0,14,18,17,49
3468,0,35,0,19,54
3469,0,17,0,19,36
3470,0,32,0,18,50
3473,0,17,0,15,32
3474,0,32,17,19,68
3475,0,17,17,19,53
3477,0,19,0,16,35
3478,0,35,0,29,64
3479,0,19,0,29,48
3480,0,29,0,19,48
3484,0,33,0,16,49
3485,0,16,0,16,32
3489,0,17,0,17,34
3490,0,33,0,17,50
3491,0,16,0,17,33
3492,0,32,0,17,49
3493,0,15,0,17,32
3494,0,35,0,15,50
3495,0,18,0,15,33
3496,0,32,0,18,50
3498,0,35,0,16,51
3500,0,33,0,15,48
3502,0,33,0,17,50
3505,0,17,0,15,32
3506,0,32,0,17,49
3508,0,34,0,15,49
3509,0,17,0,15,32
3510,0,32,0,18,50
3511,0,17,0,18,35
3513,0,17,0,17,34
3515,0,18,16,13,47
3520,0,34,0,17,51
3524,0,34,0,15,49
3527,0,18,0,17,35
3529,0,14,0,17,31
3530,0,34,0,17,51
3532,0,33,17,16,66
3533,0,16,17,16,49
3534,0,33,0,18,51
3537,0,19,0,16,35
3538,0,31,0,19,50
3541,0,15,0,17,32
3542,0,32,0,19,51
3543,0,15,0,19,34
3545,0,17,0,16,33
3546,0,30,0,19,49
3547,0,14,0,19,33
3550,0,33,16,17,66
3551,0,15,16,17,48
3553,0,17,0,20,37
3554,0,35,0,16,51
3555,0,15,0,16,31
3556,0,32,16,19,67
3557,0,16,16,19,51
3558,0,35,0,15,50
3559,0,19,0,15,34
3560,0,34,14,18,66
3561,0,19,14,18,51
3563,0,18,0,16,34
3564,0,33,0,18,51
3565,0,17,0,18,35
3566,0,34,0,15,49
3567,0,16,0,15,31
3568,0,33,16,17,66
3569,0,18,16,17,51
3570,0,33,0,16,49
3571,0,17,0,16,33
3572,0,34,0,16,50
3573,0,18,0,16,34
3574,0,31,18,18,67
3575,0,15,18,18,51
3576,0,36,0,16,52
3577,0,18,0,16,34
3578,0,34,0,14,48
3579,0,18,0,14,32
3582,0,33,0,17,50
3583,0,17,0,17,34
3584,0,32,0,19,51
3586,0,33,0,18,51
3587,0,14,0,18,32
3588,0,36,0,17,53
3589,0,18,0,17,35
3590,0,32,0,16,48
3594,0,33,0,17,50
3595,0,18,0,17,35
3596,0,33,17,17,67
3597,0,16,17,17,50
3598,0,34,15,17,66
3599,0,17,15,17,49
3600,0,32,0,18,50
3601,0,17,0,18,35
3602,0,34,0,18,52
3603,0,16,0,18,34
3607,0,17,0,17,34
3608,0,33,0,18,51
3609,0,16,0,18,34
3610,0,34,16,16,66
3612,0,32,20,14,66
3613,0,16,20,14,50
3615,0,14,0,17,31
3619,0,17,17,15,49
3620,0,32,0,17,49
3621,0,15,0,17,32
3622,0,34,17,17,68
3624,0,34,0,16,50
3625,0,17,0,16,33
3627,0,16,0,19,35
3629,0,14,0,17,31
3630,0,33,18,17,68
3632,0,35,0,15,50
3633,0,17,0,15,32
3635,0,20,15,16,51
3636,0,31,0,18,49
3637,0,16,0,18,34
3638,0,33,0,15,48
3640,0,33,16,17,66
3641,0,18,16,17,51
3643,0,17,0,18,35
3644,0,35,0,14,49
3645,0,17,0,14,31
3647,0,20,0,15,35
3649,0,16,0,18,34
3650,0,33,0,19,52
3651,0,15,0,19,34
3652,0,34,0,18,52
3655,0,16,0,17,33
3657,0,16,19,15,50
3658,19,15,0,16,50
3660,0,37,0,30,67
3661,0,21,0,30,51
3663,0,17,0,16,33
3664,0,31,0,19,50
3665,0,15,0,19,34
3666,0,35,0,18,53
3667,0,16,0,18,34
3668,0,34,0,16,50
3669,0,16,0,16,32
3670,0,34,0,16,50
3671,0,18,0,16,34
3672,0,33,0,15,48
3676,0,33,0,18,51
3678,0,34,0,14,48
3679,0,16,0,14,30
3680,0,33,0,15,48
3681,0,19,0,15,34
3682,0,34,0,14,48
3683,0,19,0,14,33
3684,0,31,0,17,48
3686,0,36,0,14,50
3688,0,31,0,17,48
3689,0,17,0,17,34
3690,0,35,0,16,51
3691,0,18,0,16,34
3692,0,33,0,17,50
3693,0,17,0,17,34
3696,0,34,0,15,49
3701,0,16,0,17,33
3702,0,32,0,18,50
3703,0,15,0,18,33
3704,0,34,0,17,51
3705,0,16,0,17,33
3707,0,14,0,18,32
3708,0,36,0,17,53
3713,0,17,0,16,33
3714,0,33,0,17,50
3715,0,17,0,17,34
3716,0,36,14,17,67
3717,0,19,14,17,50
3718,0,31,19,15,65
3722,0,33,19,17,69
3723,0,16,19,17,52
3724,0,36,0,13,49
3726,0,32,0,15,47
3727,0,19,0,15,34
3729,0,18,0,16,34
3731,0,16,0,16,32
3733,0,17,0,17,34
3735,0,16,0,19,35
3737,0,17,0,15,32
3739,0,18,0,16,34
3740,0,32,0,15,47
3742,0,34,0,15,49
3743,0,19,0,15,34
3744,0,34,0,15,49
3745,0,19,0,15,34
3746,0,33,0,15,48
3749,0,17,0,18,35
3752,0,31,0,17,48
3756,0,34,0,17,51
3758,0,34,0,16,50
3759,0,17,0,16,33
3760,0,33,0,16,49
3761,0,17,0,16,33
3762,0,32,0,18,50
3763,0,16,0,18,34
3764,0,35,0,15,50
3765,0,17,0,15,32
3766,0,34,0,16,50
3767,0,19,0,16,35
3768,0,32,0,16,48
3769,0,16,0,16,32
3773,0,16,0,15,31
3774,0,33,0,18,51
3778,0,33,0,15,48
3780,0,33,0,16,49
3782,0,32,0,17,49
3783,0,16,0,17,33
3784,0,36,0,15,51
3786,0,33,0,16,49
3788,0,31,0,17,48
3789,0,15,0,17,32
3790,0,34,0,18,52
3792,0,32,0,18,50
3793,0,14,0,18,32
3794,0,35,0,16,51
3795,0,17,0,16,33
3796,0,34,0,15,49
3798,0,34,0,16,50
3799,0,19,0,16,35
3800,0,32,18,16,66
3801,0,16,18,16,50
3802,0,34,0,16,50
3803,0,16,0,16,32
3804,0,33,0,17,50
3805,0,17,0,17,34
3806,0,32,0,19,51
3807,0,15,0,19,34
3808,0,34,0,17,51
3809,0,15,0,17,32
3810,0,34,0,18,52
3812,0,34,17,16,67
3813,0,16,17,16,49
3814,0,33,0,16,49
3815,0,16,0,16,32
3816,0,32,0,17,49
3817,0,16,0,17,33
3821,0,17,15,19,51
3822,0,34,15,18,67
3823,0,19,15,18,52
3825,0,18,15,18,51
3827,0,18,0,16,34
3828,0,33,0,17,50
3830,0,32,0,17,49
3832,0,34,0,16,50
3833,0,17,0,16,33
3834,0,35,0,16,51
3836,0,31,0,18,49
3837,0,15,0,18,33
3838,0,34,0,18,52
3839,0,16,0,18,34
3841,0,17,17,15,49
3843,0,15,0,17,32
3844,0,34,0,15,49
3846,0,32,18,16,66
3847,0,17,18,16,51
3849,0,16,0,18,34
3853,0,18,0,17,35
3854,0,33,0,16,49
3855,0,16,0,16,32
3856,0,32,0,17,49
3857,0,16,0,17,33
3859,0,16,0,19,35
3860,0,36,0,14,50
3861,0,17,0,14,31
3865,0,16,0,16,32
3867,0,18,0,16,34
3868,0,33,17,16,66
3869,0,17,17,16,50
3870,0,33,0,17,50
3871,0,16,0,17,33
3873,0,18,16,15,49
3875,0,15,0,16,31
3876,0,34,0,16,50
3877,0,18,0,16,34
3879,0,18,0,18,36
3880,0,32,0,17,49
3881,0,14,0,17,31
3882,0,35,0,15,50
3884,0,31,19,16,66
3885,0,16,19,16,51
3887,0,16,0,15,31
3888,0,34,0,17,51
3889,0,19,0,17,36
3890,0,31,0,18,49
3891,0,14,0,18,32
3892,0,34,0,17,51
3894,0,35,0,16,51
3895,0,18,0,16,34
3897,0,15,0,17,32
3898,0,34,0,17,51
3899,0,17,0,17,34
3900,0,35,0,16,51
3901,0,18,0,16,34
3902,0,32,0,16,48
3903,0,16,0,16,32
3904,0,36,0,14,50
3905,0,20,0,14,34
3907,0,17,17,17,51
3911,0,16,0,18,34
3912,0,35,0,18,53
3913,0,17,0,18,35
3914,0,33,0,20,53
3915,0,15,0,20,35
3916,0,34,0,17,51
3918,0,33,0,17,50
3919,0,16,0,17,33
3921,0,15,0,19,34
3924,0,33,18,18,69
3925,0,17,18,18,53
3927,0,18,0,15,33
3928,0,30,0,19,49
3929,0,15,0,19,34
3930,0,37,16,17,70
3931,0,18,16,17,51
3932,0,33,0,16,49
3933,0,17,0,16,33
3934,0,32,16,16,64
3935,0,16,16,16,48
3936,0,32,0,17,49
3937,0,16,0,17,33
3939,0,18,0,15,33
3940,0,33,0,16,49
3941,0,18,0,16,34
3942,0,34,0,14,48
3943,0,18,0,14,32
3945,0,18,0,16,34
3946,0,34,0,17,51
3947,0,18,0,17,35
3949,0,17,0,15,32
3950,0,32,0,16,48
3951,0,17,0,16,33
3952,0,35,0,15,50
3953,0,19,0,15,34
3955,0,16,0,18,34
3956,0,35,0,17,52
3957,0,17,0,17,34
3959,0,16,0,16,32
3961,0,16,0,17,33
3962,0,35,16,18,69
3963,0,18,16,18,52
3964,0,34,14,17,65
3965,0,18,14,17,49
3966,0,31,0,18,49
3967,0,17,0,18,35
3969,0,17,16,17,50
3972,0,33,0,16,49
3974,0,34,14,19,67
3976,0,33,0,15,48
3977,0,19,0,15,34
3978,0,32,0,16,48
3979,0,17,0,16,33
3980,0,34,0,17,51
3981,0,18,0,17,35
3982,0,35,0,16,51
3984,0,33,0,17,50
3986,0,33,0,15,48
3987,0,16,0,15,31
3990,0,31,0,17,48
3991,0,15,0,17,32
3994,0,32,0,17,49
3995,0,16,0,17,33
3997,0,17,0,16,33
3999,0,21,0,29,50
4000,0,29,0,17,46
4001,17,35,15,18,85
4002,0,35,15,18,68
4003,0,18,15,18,51
4004,0,33,0,15,48
4005,0,18,0,15,33
4006,0,34,0,15,49
4008,0,33,0,15,48
4009,0,18,0,15,33
4010,0,33,0,16,49
4011,0,18,0,16,34
4013,0,17,0,17,34
4015,0,15,17,16,48
4020,0,32,0,19,51
4021,0,17,0,19,36
4022,0,35,0,15,50
4024,0,31,0,18,49
4026,0,34,18,16,68
4027,0,16,18,16,50
4029,0,16,0,18,34
4031,0,15,0,16,31
4032,0,33,0,19,52
4033,0,17,0,19,36
4035,0,17,14,18,49
4036,0,32,0,20,52
4038,0,20,0,29,49
4040,0,33,0,15,48
4041,0,18,0,15,33
4042,0,33,0,17,50
4043,0,18,0,17,35
4045,0,16,0,15,31
4046,0,34,0,17,51
4047,0,19,0,17,36
4048,0,32,0,18,50
4049,0,15,0,18,33
4050,0,34,0,16,50
4051,0,16,0,16,32
4052,0,32,0,18,50
4053,0,16,0,18,34
4054,0,33,0,17,50
4055,0,15,0,17,32
4056,0,34,0,18,52
4058,0,34,0,18,52
4060,0,34,0,17,51
4061,0,16,0,17,33
4062,0,32,0,18,50
4063,0,15,0,18,33
4064,0,34,16,17,67
4065,0,16,16,17,49
4066,0,33,0,17,50
4068,0,34,0,18,52
4071,0,14,0,18,32
4072,0,38,0,30,68
4076,0,34,0,15,49
4077,0,17,0,15,32
4079,0,18,0,16,34
4081,0,16,0,18,34
4083,0,17,0,17,34
4085,0,16,0,17,33
4086,0,31,0,19,50
4087,0,14,0,19,33
4089,0,16,0,16,32
4093,0,17,0,17,34
4095,0,18,0,17,35
4096,0,32,0,17,49
4097,0,15,0,17,32
4099,0,18,0,16,34
4100,0,31,0,19,50
4101,0,15,0,19,34
4103,0,16,0,17,33
4104,0,34,0,15,49
4105,0,17,0,15,32
4106,0,33,0,15,48
4107,0,18,0,15,33
4108,0,33,0,16,49
4109,0,18,0,16,34
4110,0,32,17,18,67
4111,0,16,17,18,51
4112,0,35,0,17,52
4113,0,18,0,17,35
4115,0,15,0,21,36
4116,0,21,0,30,51
4117,0,46,0,16,62
4118,0,30,0,16,46
4120,0,33,0,17,50
4122,0,34,0,16,50
4123,0,17,0,16,33
4124,0,32,0,18,50
4126,0,33,0,17,50
4127,0,15,0,17,32
4128,0,34,0,18,52
4129,0,17,0,18,35
4130,0,34,0,16,50
4131,0,16,0,16,32
4132,0,35,16,16,67
4133,0,19,16,16,51
4134,0,32,17,16,65
4135,0,16,17,16,49
4136,0,33,0,17,50
4137,0,16,0,17,33
4138,0,34,0,17,51
4141,0,15,0,17,32
4143,0,16,18,17,51
4145,0,17,0,15,32
4147,0,17,17,18,52
4148,0,35,0,16,51
4149,0,18,0,16,34
4150,0,32,0,17,49
4151,0,16,0,17,33
4154,0,33,17,15,65
4155,0,16,17,15,48
4157,0,15,0,18,33
4159,0,17,0,17,34
4160,0,32,0,18,50
4162,0,36,14,19,69
4163,0,18,14,19,51
4164,0,33,0,15,48
4165,0,19,0,15,34
4166,0,31,0,18,49
4167,0,16,0,18,34
4168,0,34,0,19,53
4169,0,16,0,19,35
4170,0,33,0,18,51
4171,0,14,0,18,32
4174,0,34,0,15,49
4175,0,16,0,15,31
4177,0,17,0,18,35
4179,0,17,0,16,33
4180,0,33,0,16,49
4181,0,17,0,16,33
4183,0,17,0,16,33
4184,0,33,0,18,51
4185,0,17,0,18,35
4187,0,15,0,18,33
4190,0,35,0,15,50
4191,0,16,0,15,31
4192,0,32,0,17,49
4194,0,35,0,16,51
4195,0,18,0,16,34
4196,0,32,0,16,48
4197,0,16,0,16,32
4199,0,18,0,17,35
4200,0,36,0,13,49
4203,0,17,0,16,33
4204,0,33,0,15,48
4205,0,17,0,15,32
4206,0,33,0,16,49
4208,0,35,0,15,50
4209,0,19,0,15,34
4210,0,33,0,15,48
4211,0,18,0,15,33
4213,0,18,0,17,35
4214,0,33,0,18,51
4215,0,16,0,18,34
4217,0,15,0,18,33
4218,0,33,0,17,50
4219,0,15,0,17,32
4221,0,18,15,18,51
4222,0,33,0,17,50
4223,0,18,0,17,35
4225,0,17,0,17,34
4226,0,31,0,17,48
4227,0,14,0,17,31
4228,0,34,0,17,51
4229,0,17,0,17,34
4230,0,35,15,17,67
4231,0,18,15,17,50
4232,0,32,0,17,49
4236,0,35,0,15,50
4237,0,16,0,15,31
4239,0,17,0,16,33
4240,0,34,0,17,51
4243,0,17,0,15,32
4244,0,34,0,16,50
4245,0,19,0,16,35
4246,0,33,0,17,50
4247,0,17,0,17,34
4249,0,17,0,14,31
4250,0,32,0,16,48
4251,0,18,0,16,34
4252,0,33,0,15,48
4253,0,17,0,15,32
4254,0,32,17,17,66
4255,0,17,17,17,51
4256,0,34,17,16,67
4257,0,17,17,16,50
4259,0,16,0,18,34
4260,0,34,16,19,69
4262,0,35,0,16,51
4265,0,18,15,17,50
4267,0,17,0,16,33
4268,0,32,0,18,50
4269,0,16,0,18,34
4270,0,35,0,17,52
4271,0,17,0,17,34
4272,0,35,0,14,49
4274,0,30,0,17,47
4276,0,34,0,18,52
4278,0,33,0,18,51
4280,0,33,0,18,51
4281,0,15,0,18,33
4283,0,18,0,14,32
4284,0,32,0,15,47
4286,0,34,0,17,51
4287,0,19,0,17,36
4288,0,31,0,17,48
4289,0,14,0,17,31
4290,0,35,0,17,52
4293,0,16,0,17,33
4295,0,18,0,15,33
4296,0,33,15,17,65
4297,0,18,15,17,50
4298,0,32,0,16,48
4300,0,32,0,18,50
4301,0,16,0,18,34
4303,0,17,17,17,51
4308,0,32,18,15,65
4309,0,15,18,15,48
4311,0,15,0,16,31
4312,0,33,0,19,52
4315,0,16,0,16,32
4316,0,34,15,17,66
4317,0,18,15,17,50
4318,0,32,0,18,50
4320,0,33,0,18,51
4321,0,15,0,18,33
4323,0,15,0,18,33
4324,0,35,0,18,53
4326,0,33,0,15,48
4327,0,15,0,15,30
4328,0,33,0,17,50
4329,0,18,0,17,35
4331,0,16,0,17,33
4332,0,33,0,16,49
4336,0,35,0,15,50
4337,0,17,0,15,32
4338,0,33,0,17,50
4339,0,18,0,17,35
4340,0,34,0,15,49
4342,0,33,0,15,48
4343,0,18,0,15,33
4345,0,19,0,16,35
4347,0,15,0,17,32
4348,0,34,0,17,51
4349,0,17,0,17,34
4350,0,34,0,18,52
4351,0,17,0,18,35
4354,0,34,0,15,49
4357,0,16,0,18,34
4358,0,35,0,17,52
4360,0,35,0,16,51
4361,0,18,0,16,34
4362,0,31,0,17,48
4363,0,15,0,17,32
4364,0,33,0,18,51
4365,0,16,0,18,34
4366,0,35,0,15,50
4367,0,17,0,15,32
4368,0,34,0,15,49
4370,0,34,0,14,48
4371,0,19,0,14,33
4374,0,31,0,19,50
4376,0,35,0,15,50
4379,0,17,0,16,33
4380,0,33,18,15,66
4381,0,17,18,15,50
4382,0,33,0,17,50
4383,0,15,0,17,32
4385,0,16,0,17,33
4386,0,34,0,17,51
4387,0,17,0,17,34
4389,0,16,0,17,33
4390,0,35,15,17,67
4391,0,18,15,17,50
4392,0,32,0,20,52
4394,0,33,0,18,51
4397,0,17,0,16,33
4398,0,33,0,17,50
4400,0,32,0,19,51
4401,0,15,0,19,34
4404,0,35,17,16,68
4405,0,18,17,16,51
4406,0,33,0,18,51
4407,0,16,0,18,34
4408,0,34,0,17,51
4411,0,14,17,20,51
4412,0,37,0,15,52
4413,0,20,0,15,35
4414,0,32,0,16,48
4415,0,17,0,16,33
4417,0,17,17,17,51
4419,0,17,16,16,49
4420,0,32,0,18,50
4421,0,16,0,18,34
4422,0,34,0,17,51
4424,0,33,0,17,50
4425,0,16,0,17,33
4427,0,17,17,16,50
4428,0,33,0,17,50
4429,0,16,0,17,33
4430,0,33,0,18,51
4431,0,16,0,18,34
4432,0,34,0,16,50
4434,0,34,16,17,67
4435,0,18,16,17,51
4437,0,17,0,15,32
4438,0,32,0,16,48
4439,0,17,0,16,33
4442,0,33,0,17,50
4443,0,17,0,17,34
4444,0,37,0,31,68
4445,0,20,0,31,51
4446,0,31,15,17,63
4448,0,32,0,15,47
4449,0,17,0,15,32
4450,0,33,0,18,51
4451,0,18,0,18,36
4452,0,34,0,15,49
4453,0,16,0,15,31
4454,0,33,0,16,49
4455,0,18,0,16,34
4457,0,17,0,17,34
4458,0,34,0,17,51
4460,0,34,0,15,49
4461,0,17,0,15,32
4465,0,16,0,15,31
4467,0,17,0,18,35
4468,0,33,0,18,51
4469,0,15,0,18,33
4470,0,35,0,17,52
4471,0,17,0,17,34
4472,0,32,0,17,49
4473,0,15,0,17,32
4474,0,35,0,16,51
4475,0,18,0,16,34
4477,0,17,0,17,34
4480,0,34,0,15,49
4481,0,19,0,15,34
4482,0,32,0,16,48
4483,0,17,0,16,33
4484,0,32,0,18,50
4485,0,16,0,18,34
4486,0,32,20,16,68
4487,0,14,20,16,50
4488,0,36,0,16,52
4489,0,16,0,16,32
4490,0,33,0,16,49
4491,0,17,0,16,33
4492,0,35,0,15,50
4493,0,19,0,15,34
4495,0,16,0,17,33
4497,0,16,17,17,50
4498,0,34,0,17,51
4499,0,17,0,17,34
4500,0,33,0,17,50
4501,0,16,0,17,33
4502,0,35,0,17,52
4503,0,18,0,17,35
4504,0,32,0,16,48
4505,0,15,0,16,31
4506,0,35,0,15,50
4507,0,19,0,15,34
4508,0,31,0,17,48
4509,0,16,0,17,33
4510,0,35,0,16,51
4512,0,32,0,18,50
4513,0,16,0,18,34
4517,0,20,0,16,36
4518,0,30,0,18,48
4520,0,35,0,15,50
4521,0,17,0,15,32
4522,0,33,0,15,48
4523,0,18,0,15,33
4524,0,32,0,19,51
4525,0,17,0,19,36
4526,0,35,0,17,52
4527,0,16,0,17,33
4528,0,32,0,16,48
4530,0,35,0,19,54
4533,0,46,18,16,80
4536,0,34,0,15,49
4538,0,32,17,19,68
4540,0,36,14,19,69
4542,0,33,15,16,64
4543,0,19,15,16,50
4545,0,16,0,20,36
4546,0,36,0,15,51
4547,0,16,0,15,31
4548,0,31,0,17,48
4549,0,16,0,17,33
4550,0,34,0,17,51
4551,0,17,0,17,34
4552,0,33,0,18,51
4553,0,16,0,18,34
4554,0,35,0,16,51
4555,0,17,0,16,33
4556,0,32,16,19,67
4557,0,16,16,19,51
4559,0,19,14,17,50
4560,0,31,0,18,49
4561,0,17,0,18,35
4562,0,35,0,16,51
4565,0,18,16,17,51
4566,0,33,0,16,49
4567,0,17,0,16,33
4568,0,32,15,17,64
4569,0,16,15,17,48
4571,0,17,0,19,36
4572,0,35,0,16,51
4573,0,16,0,16,32
4574,0,32,18,17,67
4575,0,16,18,17,51
4576,0,35,16,17,68
4577,0,17,16,17,50
4578,0,33,0,18,51
4581,0,15,0,18,33
4582,0,32,0,18,50
4583,0,14,0,18,32
4584,0,34,0,18,52
4585,0,16,0,18,34
4587,0,17,0,15,32
4588,0,34,0,14,48
4589,0,19,0,14,33
4590,0,33,0,16,49
4591,0,19,0,16,35
4593,0,15,0,18,33
4594,0,34,0,18,52
4595,0,16,0,18,34
4596,0,35,0,17,52
4597,0,17,0,17,34
4599,0,15,0,18,33
4601,0,15,0,16,31
4603,0,17,0,17,34
4605,0,16,0,19,35
4606,0,37,0,13,50
4607,0,18,0,13,31
4608,0,31,0,15,46
4609,0,18,0,15,33
4610,0,33,0,17,50
4611,0,18,0,17,35
4612,0,32,0,20,52
4613,0,15,0,20,35
4614,0,37,0,16,53
4615,0,17,0,16,33
4616,0,32,0,17,49
4621,0,16,0,19,35
4623,0,16,0,15,31
4624,0,34,0,15,49
4625,0,19,0,15,34
4628,0,33,0,14,47
4629,0,15,0,14,29
4630,0,34,0,14,48
4631,0,20,0,14,34
4632,0,32,0,16,48
4633,0,18,0,16,34
4634,0,35,0,19,54
4635,0,19,0,19,38
4636,0,19,0,31,50
4638,19,16,0,17,52
4641,0,15,16,17,48
4642,0,33,0,16,49
4644,0,35,0,16,51
4645,0,19,0,16,35
4646,0,33,0,17,50
4647,0,17,0,17,34
4648,0,34,14,19,67
4649,0,17,14,19,50
4650,0,33,0,18,51
4652,0,32,0,16,48
4653,0,14,0,16,30
4654,0,33,0,18,51
4656,0,36,0,15,51
4657,0,18,0,15,33
4658,0,31,0,19,50
4659,0,16,0,19,35
4660,0,34,0,18,52
4662,0,36,0,16,52
4663,0,18,0,16,34
4664,0,31,0,16,47
4666,0,33,0,16,49
4667,0,17,0,16,33
4668,0,33,0,18,51
4669,0,17,0,18,35
4670,0,34,0,16,50
4671,0,16,0,16,32
4673,0,15,0,19,34
4674,0,35,0,19,54
4675,0,16,0,19,35
4676,0,34,0,15,49
4677,0,15,0,15,30
4678,0,32,0,18,50
4679,0,17,0,18,35
4680,0,34,19,16,69
4682,0,35,0,16,51
4683,0,16,0,16,32
4684,0,31,0,16,47
4686,0,34,16,17,67
4687,0,18,16,17,51
4688,0,33,17,16,66
4689,0,17,17,16,50
4690,0,33,0,18,51
4691,0,16,0,18,34
4692,0,35,0,15,50
4694,0,33,16,16,65
4695,0,18,16,16,50
4696,0,32,0,19,51
4697,0,16,0,19,35
4698,0,34,0,15,49
4701,0,19,0,16,35
4702,0,31,0,19,50
4703,0,15,0,19,34
4704,0,36,0,17,53
4705,0,17,0,17,34
4708,0,36,0,15,51
4710,0,32,0,19,51
4711,0,17,0,19,36
4714,0,35,0,15,50
4716,0,33,0,16,49
4718,0,32,0,18,50
4719,0,16,0,18,34
4721,0,13,0,18,31
4723,0,18,0,16,34
4724,0,32,0,17,49
4725,0,16,0,17,33
4726,0,35,0,15,50
4727,0,18,0,15,33
4728,0,33,0,16,49
4729,0,18,0,16,34
4731,0,18,0,16,34
4732,0,33,16,17,66
4733,0,17,16,17,50
4735,0,17,0,17,34
4737,0,16,0,16,32
4741,0,15,0,17,32
4742,0,35,0,16,51
4743,0,18,0,16,34
4745,0,16,0,18,34
4750,0,34,0,15,49
4753,0,19,0,14,33
4754,0,35,0,15,50
4759,0,16,0,18,34
4760,0,33,0,19,52
4761,0,15,0,19,34
4762,0,35,0,15,50
4763,0,16,0,15,31
4766,0,32,0,16,48
4768,0,33,0,16,49
4770,0,34,0,15,49
4771,0,18,0,15,33
4772,0,33,0,16,49
4773,0,18,0,16,34
4774,0,34,0,15,49
4775,0,18,0,15,33
4776,0,32,0,16,48
4777,0,17,0,16,33
4778,0,35,0,17,52
4779,0,19,0,17,36
4780,0,32,0,19,51
4783,0,16,0,16,32
4784,0,34,0,16,50
4785,0,18,0,16,34
4787,0,15,0,17,32
4788,0,34,0,16,50
4789,0,17,0,16,33
4791,0,19,0,16,35
4792,0,32,0,15,47
4793,0,16,0,15,31
4794,0,34,15,17,66
4795,0,19,15,17,51
4796,0,32,0,16,48
4797,0,17,0,16,33
4799,0,18,0,17,35
4804,0,35,0,18,53
4805,0,17,0,18,35
4806,0,18,13,19,50
4808,0,35,15,18,68
4810,0,33,0,18,51
4811,0,18,0,18,36
4814,0,34,17,17,68
4815,0,15,17,17,49
4816,0,34,17,17,68
4818,0,34,0,14,48
4820,0,32,0,18,50
4821,0,18,0,18,36
4823,0,16,0,16,32
4825,0,17,0,16,33
4826,0,34,0,16,50
4827,0,18,0,16,34
4828,0,31,0,19,50
4829,0,15,0,19,34
4831,0,17,0,15,32
4833,0,18,0,16,34
4834,0,33,0,17,50
4835,0,17,0,17,34
4836,0,32,0,19,51
4837,0,15,0,19,34
4838,0,33,0,19,52
4840,0,33,0,19,52
4841,0,14,0,19,33
4842,0,36,0,16,52
4845,0,17,0,16,33
4847,0,17,0,16,33
4849,0,16,0,17,33
4850,0,35,0,16,51
4853,0,16,0,16,32
4855,0,17,17,17,51
4856,0,34,16,19,69
4857,0,17,16,19,52
4859,0,19,0,14,33
4861,0,17,0,17,34
4862,0,35,0,15,50
4864,0,34,0,15,49
4867,0,17,0,16,33
4868,0,33,0,17,50
4870,0,32,0,17,49
4871,0,15,0,17,32
4872,0,34,0,17,51
4873,0,17,0,17,34
4874,0,35,0,18,53
4877,0,16,0,17,33
4881,0,17,0,19,36
4882,0,35,0,14,49
4883,0,16,0,14,30
4884,0,31,0,16,47
4885,0,17,0,16,33
4887,0,19,0,15,34
4888,0,32,15,20,67
4889,0,17,15,20,52
4890,0,35,0,17,52
4892,0,31,0,17,48
4893,0,14,0,17,31
4894,0,34,0,18,52
4895,0,17,0,18,35
4896,0,33,0,16,49
4898,0,33,0,18,51
4899,0,17,0,18,35
4900,0,35,16,16,67
4902,0,32,0,18,50
4903,0,16,0,18,34
4904,0,34,0,17,51
4906,0,32,0,18,50
4907,0,15,0,18,33
4909,0,17,0,16,33
4911,0,17,0,17,34
4912,0,33,0,17,50
4913,0,16,0,17,33
4914,0,34,0,16,50
4915,0,17,0,16,33
4917,0,17,0,18,35
4918,0,32,0,18,50
4919,0,14,0,18,32
4920,0,35,0,18,53
4921,0,17,0,18,35
4922,0,32,0,17,49
4923,0,14,0,17,31
4924,0,35,0,15,50
4925,0,18,0,15,33
4927,0,20,0,15,35
4930,0,34,0,16,50
4931,0,16,0,16,32
4932,0,34,0,15,49
4933,0,18,0,15,33
4934,0,33,0,18,51
4935,0,18,0,18,36
4937,0,15,0,18,33
4939,0,17,0,15,32
4940,0,33,0,15,48
4942,0,33,0,16,49
4943,0,18,0,16,34
4945,0,18,0,16,34
4946,0,35,0,13,48
4949,0,17,0,17,34
4951,0,16,0,18,34
4952,0,35,0,16,51
4954,0,33,0,17,50
4955,0,17,0,17,34
4956,0,32,0,16,48
4957,0,15,0,16,31
4958,0,34,0,17,51
4960,0,34,0,14,48
4962,0,31,0,17,48
4964,0,36,0,15,51
4965,0,19,0,15,34
4966,0,29,24,28,81
4967,0,14,24,28,66
4968,24,46,0,18,88
4969,0,46,0,18,64
4970,0,34,0,18,52
4972,0,36,0,15,51
4973,0,18,0,15,33
4974,0,32,0,14,46
4976,0,34,0,15,49
4977,0,20,0,15,35
4978,0,34,0,14,48
4980,0,29,0,17,46
4981,0,15,0,17,32
4982,0,35,0,17,52
4985,0,16,0,19,35
4987,0,14,0,17,31
4988,0,35,0,15,50
4989,0,18,0,15,33
4992,0,34,0,17,51
4996,0,35,0,16,51
4997,0,17,0,16,33
4998,0,32,0,19,51
4999,0,16,0,19,35
5000,0,33,0,18,51
5001,0,14,0,18,32
5002,0,35,0,16,51
5004,0,33,0,16,49
5006,0,33,0,18,51
5007,0,17,0,18,35
5010,0,33,0,18,51
5011,0,16,0,18,34
5013,0,15,0,20,35
5014,0,34,0,16,50
5018,0,36,15,17,68
5019,0,18,15,17,50
5020,0,32,0,15,47
5021,0,17,0,15,32
5022,0,32,0,17,49
5024,0,38,0,29,67
5025,0,21,0,29,50
5026,0,29,18,16,63
5027,17,34,0,17,68
5029,0,16,0,17,33
5032,0,33,0,18,51
5034,0,34,16,17,67
5035,0,16,16,17,49
5036,0,33,16,17,66
5038,0,33,0,16,49
5039,0,17,0,16,33
5040,0,34,0,17,51
5041,0,18,0,17,35
5042,0,33,17,17,67
5043,0,16,17,17,50
5044,0,34,0,17,51
5045,0,17,0,17,34
5048,0,33,18,16,67
5049,0,16,18,16,50
5050,18,16,0,18,52
5053,0,16,16,16,48
5054,0,32,0,17,49
5055,0,16,0,17,33
5056,0,34,18,17,69
5060,0,32,16,18,66
5061,0,17,16,18,51
5062,0,34,15,17,66
5064,0,32,0,18,50
5065,0,17,0,18,35
5066,0,35,15,17,67
5067,0,17,15,17,49
5068,0,32,17,16,65
5070,0,33,0,17,50
5073,0,17,0,17,34
5076,0,32,0,17,49
5077,0,18,0,17,35
5078,0,36,13,17,66
5079,0,19,13,17,49
5082,0,35,0,16,51
5083,0,19,0,16,35
5084,0,33,0,15,48
5085,0,17,0,15,32
5086,0,33,0,17,50
5087,0,18,0,17,35
5088,0,34,0,14,48
5095,0,16,0,18,34
5096,0,34,0,21,55
5098,0,34,0,17,51
5099,0,13,0,17,30
5102,0,33,0,18,51
5103,0,17,0,18,35
5104,0,32,0,18,50
5105,0,14,0,18,32
5108,0,36,0,15,51
5109,0,18,0,15,33
5110,0,31,0,16,47
5112,0,33,0,16,49
5114,0,35,0,16,51
5115,0,19,0,16,35
5116,0,36,0,31,67
5119,0,16,0,17,33
5120,0,33,0,15,48
5121,0,16,0,15,31
5122,0,37,0,31,68
5123,0,22,0,31,53
5124,0,31,0,13,44
5125,0,19,0,13,32
5126,0,30,0,20,50
5127,0,17,0,20,37
5128,0,34,0,16,50
5129,0,14,0,16,30
5131,0,19,0,17,36
5132,0,32,0,18,50
5137,0,16,0,18,34
5138,0,34,0,17,51
5139,0,16,0,17,33
5140,0,33,0,17,50
5141,0,16,0,17,33
5144,0,32,0,18,50
5145,0,15,0,18,33
5146,0,35,0,16,51
5148,0,34,0,14,48
5149,0,18,0,14,32
5150,0,30,0,20,50
5151,0,16,0,20,36
5152,0,34,0,17,51
5153,0,14,0,17,31
5154,0,33,0,16,49
5157,0,17,0,17,34
5158,0,35,0,17,52
5159,0,18,0,17,35
5160,0,34,0,16,50
5161,0,17,0,16,33
5162,0,31,0,20,51
5163,0,15,0,20,35
5164,0,34,0,16,50
5165,0,14,0,16,30
5167,0,18,0,16,34
5168,0,32,0,17,49
5169,0,16,0,17,33
5172,0,35,0,15,50
5176,0,36,0,14,50
5177,0,18,0,14,32
5178,0,33,0,15,48
5179,0,19,0,15,34
5181,0,17,0,16,33
5182,0,32,0,19,51
5183,0,16,0,19,35
5184,0,34,0,18,52
5185,0,15,0,18,33
5187,0,17,0,17,34
5188,0,32,0,18,50
5190,0,33,0,18,51
5191,0,15,0,18,33
5192,0,35,0,16,51
5193,0,17,0,16,33
5196,0,33,0,18,51
5197,0,16,0,18,34
5198,0,36,18,12,66
5199,0,18,18,12,48
5201,0,12,0,19,31
5202,0,36,16,16,68
5203,0,17,16,16,49
5205,0,16,0,18,34
5206,0,36,16,15,67
5207,0,18,16,15,49
5208,0,31,0,16,47
5209,0,15,0,16,31
5210,0,33,0,17,50
5211,0,17,0,17,34
5212,0,35,0,16,51
5215,0,17,0,15,32
5218,0,32,0,18,50
5219,0,17,0,18,35
5220,0,33,0,19,52
5221,0,15,0,19,34
5222,0,35,0,18,53
5223,0,16,0,18,34
5224,0,34,0,15,49
5225,0,16,0,15,31
5227,0,18,0,17,35
5230,0,32,0,16,48
5232,0,34,0,16,50
5233,0,18,0,16,34
5237,0,18,0,16,34
5239,0,16,0,14,30
5240,0,33,0,18,51
5241,0,19,0,18,37
5242,0,33,0,15,48
5244,0,33,0,16,49
5245,0,18,0,16,34
5246,0,34,0,16,50
5247,0,18,0,16,34
5248,0,33,0,16,49
5249,0,17,0,16,33
5251,0,17,0,17,34
5252,0,32,0,17,49
5253,0,15,0,17,32
5254,0,33,0,19,52
5256,0,35,17,15,67
5257,0,16,17,15,48
5258,0,32,0,17,49
5259,0,15,0,17,32
5260,0,36,0,16,52
5261,0,19,0,16,35
5262,0,31,0,16,47
5263,0,15,0,16,31
5266,0,33,0,15,48
5267,0,16,0,15,31
5268,0,34,0,15,49
5269,0,19,0,15,34
5271,0,16,0,18,34
5272,0,34,0,17,51
5273,0,16,0,17,33
5274,0,34,0,16,50
5275,0,17,0,16,33
5279,0,15,0,17,32
5280,0,35,0,15,50
5281,0,18,0,15,33
5285,0,16,17,17,50
5286,0,34,17,16,67
5287,0,17,17,16,50
5288,0,33,0,17,50
5289,0,16,0,17,33
5291,0,18,0,14,32
5292,0,32,0,16,48
5293,0,18,0,16,34
5295,0,18,0,16,34
5297,0,17,0,17,34
5298,0,32,0,18,50
5299,0,15,0,18,33
5302,0,33,0,14,47
5303,0,18,0,14,32
5304,0,33,0,17,50
5305,0,19,0,17,36
5306,0,32,0,17,49
5307,0,15,0,17,32
5308,0,34,0,18,52
5314,0,30,0,18,48
5315,0,15,0,18,33
5316,0,35,0,15,50
5317,0,17,0,15,32
5318,0,34,0,15,49
5319,0,19,0,15,34
5321,0,17,0,18,35
5322,0,35,0,15,50
5323,0,17,0,15,32
5324,0,32,0,17,49
5325,0,17,0,17,34
5327,0,17,0,16,33
5329,0,18,0,15,33
5331,0,18,0,14,32
5332,0,33,17,16,66
5333,0,19,17,16,52
5334,0,33,0,18,51
5338,0,31,0,18,49
5339,0,15,0,18,33
5340,0,34,0,18,52
5342,0,33,17,18,68
5343,0,15,17,18,50
5345,0,18,16,17,51
5346,0,33,16,16,65
5347,0,17,16,16,49
5349,0,16,18,17,51
5350,0,35,15,17,67
5351,0,17,15,17,49
5353,0,17,0,18,35
5354,0,34,16,17,67
5355,0,16,16,17,49
5356,0,33,0,17,50
5357,0,17,0,17,34
5358,0,34,0,16,50
5359,0,17,0,16,33
5360,0,34,17,16,67
5361,0,18,17,16,51
5362,0,33,17,16,66
5363,0,16,17,16,49
5365,0,16,0,17,33
5367,0,15,19,16,50
5368,0,35,0,17,52
5369,0,16,0,17,33
5370,0,34,0,14,48
5371,0,17,0,14,31
5373,0,19,0,15,34
5374,0,32,0,17,49
5375,0,17,0,17,34
5376,0,34,0,17,51
5378,0,34,0,17,51
5380,0,33,0,15,48
5381,0,16,0,15,31
5383,0,19,0,14,33
5384,0,32,18,17,67
5385,0,18,18,17,53
5387,0,17,0,17,34
5388,0,31,0,16,47
5390,0,34,0,16,50
5391,0,18,0,16,34
5394,0,33,0,15,48
5395,0,17,0,15,32
5397,0,18,0,17,35
5399,0,16,18,20,54
5401,0,20,0,28,48
5403,0,16,0,17,33
5406,0,36,0,16,52
5407,0,16,0,16,32
5408,0,33,0,17,50
5409,0,17,0,17,34
5412,0,34,17,16,67
5413,0,18,17,16,51
5414,0,33,0,17,50
5415,0,16,0,17,33
5416,0,35,15,16,66
5417,0,18,15,16,49
5418,0,31,0,17,48
5421,0,16,17,18,51
5422,0,35,0,15,50
5423,0,18,0,15,33
5424,0,34,0,17,51
5427,0,14,0,18,32
5428,0,35,0,16,51
5429,0,17,0,16,33
5432,0,34,0,16,50
5433,0,17,0,16,33
5434,0,34,0,15,49
5435,0,18,0,15,33
5437,0,16,0,18,34
5438,0,34,16,17,67
5439,0,16,16,17,49
5440,0,33,0,17,50
5441,0,17,0,17,34
5443,0,16,0,17,33
5444,0,32,0,20,52
5446,0,35,0,17,52
5447,0,15,0,17,32
5448,0,34,16,16,66
5449,0,17,16,16,49
5450,0,32,0,17,49
5451,0,16,0,17,33
5452,0,34,0,17,51
5453,0,17,0,17,34
5454,0,33,0,18,51
5455,0,16,0,18,34
5456,0,35,15,17,67
5457,0,17,15,17,49
5458,0,32,0,17,49
5459,0,17,0,17,34
5460,0,35,0,16,51
5461,0,18,0,16,34
5462,0,34,0,14,48
5463,0,18,0,14,32
5464,0,31,0,16,47
5465,0,17,0,16,33
5466,0,34,0,16,50
5468,0,33,0,16,49
5469,0,17,0,16,33
5470,0,33,0,18,51
5471,0,17,0,18,35
5472,0,34,0,17,51
5475,0,18,0,13,31
5476,0,34,0,16,50
5477,0,21,0,16,37
5478,0,31,0,17,48
5479,0,15,0,17,32
5480,0,32,0,17,49
5482,0,34,0,17,51
5483,0,17,0,17,34
5484,0,35,0,15,50
5485,0,18,0,15,33
5487,0,17,0,18,35
5489,0,16,0,16,32
5490,0,33,16,17,66
5491,0,17,16,17,50
5492,0,33,0,18,51
5493,0,17,0,18,35
5494,0,34,0,16,50
5495,0,16,0,16,32
5497,0,16,0,17,33
5498,0,34,0,17,51
5500,0,34,0,17,51
5502,0,33,0,16,49
5503,0,16,0,16,32
5504,0,33,0,17,50
5505,0,17,0,17,34
5506,0,34,0,17,51
5507,0,17,0,17,34
5508,0,34,0,15,49
5511,0,17,17,16,50
5512,0,33,0,18,51
5513,0,16,0,18,34
5514,0,33,0,18,51
5518,0,36,0,14,50
5519,0,19,0,14,33
5520,0,31,0,17,48
5522,0,34,0,17,51
5523,0,17,0,17,34
5524,0,34,0,17,51
5526,0,33,0,17,50
5531,0,16,0,17,33
5533,0,15,0,17,32
5534,0,35,0,16,51
5535,0,18,0,16,34
5536,0,31,0,19,50
5537,0,15,0,19,34
5538,0,35,0,16,51
5539,0,16,0,16,32
5540,0,33,0,16,49
5541,0,17,0,16,33
5543,0,16,0,18,34
5544,0,36,0,15,51
5547,0,18,0,15,33
5548,0,33,0,17,50
5551,0,15,18,16,49
5553,0,16,0,16,32
5555,0,16,0,17,33
5556,0,34,0,18,52
5557,0,17,0,18,35
5558,0,33,0,16,49
5559,0,15,0,16,31
5560,0,35,0,16,51
5561,0,19,0,16,35
5562,0,34,15,17,66
5563,0,18,15,17,50
5564,0,32,0,17,49
5567,0,17,0,17,34
5568,0,34,0,16,50
5570,0,33,0,16,49
5572,0,31,0,19,50
5573,0,15,0,19,34
5575,0,17,0,15,32
5576,0,33,0,14,47
5579,0,19,0,16,35
5580,0,33,0,16,49
5581,0,17,0,16,33
5582,0,32,0,17,49
5583,0,16,0,17,33
5584,0,35,0,16,51
5592,0,34,0,16,50
5594,0,33,0,17,50
5595,0,17,0,17,34
5596,0,35,0,16,51
5598,0,34,0,13,47
5599,0,18,0,13,31
5600,0,31,0,16,47
5601,0,18,0,16,34
5602,0,33,0,17,50
5603,0,17,0,17,34
5604,0,34,0,18,52
5605,0,17,0,18,35
5609,0,16,0,17,33
5610,0,35,0,15,50
5611,0,18,0,15,33
5613,0,19,0,17,36
5614,0,31,0,18,49
5615,0,14,0,18,32
5616,0,35,0,17,52
5617,0,17,0,17,34
5618,0,33,0,17,50
5619,0,16,0,17,33
5620,0,32,0,19,51
5621,0,15,0,19,34
5622,0,34,0,18,52
5623,0,15,0,18,33
5625,0,16,0,18,34
5626,0,33,0,17,50
5627,0,15,0,17,32
5628,0,33,0,19,52
5629,0,16,0,19,35
5630,0,35,0,15,50
5631,0,16,0,15,31
5632,0,31,0,18,49
5633,0,16,0,18,34
5634,0,34,0,18,52
5635,0,16,0,18,34
5637,0,16,0,18,34
5638,0,34,0,15,49
5639,0,16,0,15,31
5640,0,33,0,17,50
5641,0,18,0,17,35
5642,0,34,15,19,68
5643,0,17,15,19,51
5644,0,34,0,14,48
5645,0,19,0,14,33
5646,0,32,0,16,48
5647,0,18,0,16,34
5648,0,34,0,14,48
5650,0,33,0,16,49
5651,0,19,0,16,35
5652,0,33,0,17,50
5653,0,17,0,17,34
5654,0,34,0,17,51
5655,0,17,0,17,34
5656,0,32,0,16,48
5659,0,17,0,17,34
5661,0,16,0,17,33
5663,0,18,0,16,34
5664,0,33,0,16,49
5666,0,32,0,19,51
5667,0,16,0,19,35
5668,0,33,0,19,52
5669,0,14,0,19,33
5671,0,17,0,15,32
5673,0,17,0,18,35
5674,0,33,17,17,67
5675,0,15,17,17,49
5677,0,17,0,17,34
5678,0,33,0,16,49
5679,0,16,0,16,32
5680,0,32,0,17,49
5682,0,35,0,15,50
5684,0,32,0,17,49
5686,0,34,0,16,50
5687,0,17,0,16,33
5689,0,17,0,18,35
5690,0,34,0,16,50
5691,0,16,0,16,32
5692,0,32,0,17,49
5693,0,16,0,17,33
5695,0,18,0,17,35
5697,0,17,0,21,38
5698,0,21,0,27,48
5700,0,33,0,18,51
5701,0,19,0,18,37
5702,0,33,0,16,49
5703,0,15,0,16,31
5706,0,21,0,29,50
5707,0,47,0,17,64
5708,17,18,0,17,52
5710,0,33,0,18,51
5711,0,16,0,18,34
5712,0,37,0,30,67
5715,16,19,0,30,65
5716,0,19,0,30,49
5717,0,48,0,22,70
5718,17,18,0,22,57
5721,0,43,0,17,60
5723,0,14,0,17,31
5724,0,33,0,17,50
5726,0,37,0,13,50
5727,0,20,0,13,33
5728,0,32,0,19,51
5730,0,19,0,29,48
5731,0,49,0,15,64
5733,0,20,0,15,35
5734,0,34,0,33,67
5736,0,33,0,33,66
5737,0,17,0,33,50
5739,0,19,0,17,36
5741,0,34,0,32,66
5742,0,17,0,32,49
5743,0,46,0,17,63
5744,0,32,0,17,49
5745,0,14,0,17,31
5747,0,16,0,17,33
5748,0,34,0,20,54
5749,0,17,0,20,37
5750,0,20,0,31,51
5751,0,47,0,17,64
5752,0,34,0,17,51
5753,0,16,0,17,33
5754,0,33,0,16,49
5755,0,16,0,16,32
5758,0,36,0,16,52
5759,0,19,0,16,35
5760,0,32,0,16,48
5761,0,16,0,16,32
5762,0,34,16,18,68
5763,0,18,16,18,52
5765,0,18,0,17,35
5766,0,32,0,18,50
5767,0,15,0,18,33
5769,0,15,18,18,51
5770,0,36,0,16,52
5771,0,18,0,16,34
5772,0,28,0,20,48
5773,0,12,0,20,32
5774,0,35,0,18,53
5775,0,15,0,18,33
5776,0,37,0,15,52
5777,0,19,0,15,34
5778,0,30,0,18,48
5779,0,15,0,18,33
5781,0,15,0,19,34
5782,0,34,0,17,51
5783,0,15,0,17,32
5784,0,34,15,19,68
5785,0,17,15,19,51
5786,15,19,0,17,51
5788,0,32,0,17,49
5789,0,15,0,17,32
5790,0,33,0,19,52
5791,0,16,0,19,35
5793,0,16,0,14,30
5794,0,33,0,37,70
5795,0,19,0,37,56
5796,0,37,0,20,57
5797,0,20,0,18,38
5798,15,30,0,18,63
5799,0,30,0,18,48
5803,0,32,0,16,48
5804,0,18,0,16,34
5805,0,33,0,18,51
5806,0,17,0,18,35
5807,0,33,0,18,51
5809,0,33,0,18,51
5813,0,33,0,16,49
5814,0,15,0,16,31
5815,0,34,0,16,50
5816,0,18,0,16,34
5817,0,32,0,19,51
5819,0,33,0,18,51
5820,0,14,0,18,32
5821,0,34,0,18,52
5825,0,33,16,17,66
5826,0,17,16,17,50
5827,0,33,0,16,49
5828,0,17,0,16,33
5832,0,18,0,16,34
5833,0,32,0,16,48
5834,0,16,0,16,32
5835,0,33,0,18,51
5836,0,17,0,18,35
5838,0,17,15,18,50
5840,0,18,0,16,34
5841,0,32,17,18,67
5842,0,16,17,18,51
5844,0,18,0,16,34
5847,0,34,15,18,67
5848,0,16,15,18,49
5849,0,33,0,18,51
5850,0,18,0,18,36
5852,0,15,18,15,48
5853,0,33,0,18,51
5854,0,15,0,18,33
5855,0,34,0,18,52
5856,0,16,0,18,34
5857,0,33,0,18,51
5859,0,33,0,18,51
5860,0,15,0,18,33
5862,0,16,0,18,34
5863,0,32,19,16,67
5864,0,14,19,16,49
5865,0,35,0,15,50
5866,0,16,0,15,31
5867,0,33,17,18,68
5868,0,18,17,18,53
5869,0,35,0,15,50
5870,0,18,0,15,33
5871,0,31,17,17,65
5872,0,16,17,17,50
5873,0,34,0,17,51
5874,0,17,0,17,34
5875,0,35,0,15,50
5876,0,18,0,15,33
5877,0,31,18,17,66
5880,0,17,0,17,34
5881,0,32,0,17,49
5882,0,15,0,17,32
5884,0,17,17,16,50
5885,0,33,0,17,50
5887,0,33,17,17,67
5888,0,16,17,17,50
5890,0,17,0,16,33
5892,0,18,0,17,35
5895,0,32,0,19,51
5896,0,15,0,19,34
5897,0,34,0,17,51
5898,0,15,0,17,32
5899,0,33,0,18,51
5900,0,16,0,18,34
5901,0,34,0,16,50
5902,0,16,0,16,32
5903,0,34,0,16,50
5904,0,18,0,16,34
5906,0,16,0,17,33
5908,0,19,0,15,34
5909,0,30,0,18,48
5910,0,15,0,18,33
5911,0,35,0,15,50
5915,0,33,0,19,52
5916,0,15,0,19,34
5917,0,35,0,17,52
5918,0,16,0,17,33
5919,0,32,0,18,50
5920,0,15,0,18,33
5921,0,35,0,17,52
5922,0,17,0,17,34
5923,0,31,0,20,51
5924,0,14,0,20,34
5925,0,36,0,16,52
5927,0,34,0,16,50
5928,0,18,0,16,34
5930,0,15,0,16,31
5931,0,34,0,17,51
5932,0,18,0,17,35
5934,0,16,0,16,32
5935,0,34,0,17,51
5937,0,34,0,17,51
5939,0,33,0,17,50
5941,0,32,0,18,50
5942,0,15,0,18,33
5943,0,35,15,17,67
5944,0,17,15,17,49
5945,0,32,0,17,49
5946,0,17,0,17,34
5947,0,32,0,19,51
5948,0,15,0,19,34
5949,0,34,0,20,54
5950,0,15,0,20,35
5951,0,35,0,15,50
5953,0,33,0,15,48
5954,0,18,0,15,33
5955,0,32,0,18,50
5956,0,17,0,18,35
5958,0,18,0,14,32
5960,0,19,0,19,38
5962,0,11,18,19,48
5963,0,37,0,14,51
5965,0,34,0,14,48
5966,0,20,0,14,34
5967,0,31,0,18,49
5970,0,17,0,17,34
5971,0,29,0,19,48
5972,0,12,0,19,31
5973,0,36,0,16,52
5974,0,17,0,16,33
5975,0,32,0,35,67
5977,0,35,15,19,69
5978,0,20,15,19,54
5979,0,34,0,18,52
5980,0,19,0,18,37
5981,0,32,0,18,50
5982,0,14,0,18,32
5983,0,34,0,16,50
5984,0,16,0,16,32
5988,0,16,17,17,50
5990,0,17,0,16,33
5991,0,32,0,17,49
5992,0,16,0,17,33
5995,0,33,0,16,49
5998,0,18,0,48,66
