序号,发送->接收,接收->转发,转发->接收,接收->处理,总计
1,0,31,18,17,66
2,0,10,18,17,45
3,18,17,0,19,54
5,0,34,0,16,50
6,0,15,0,16,31
7,0,33,0,18,51
9,0,33,0,18,51
11,0,35,0,14,49
12,0,17,0,14,31
13,0,33,0,16,49
14,0,19,0,16,35
15,0,32,0,17,49
16,0,16,0,17,33
17,0,33,17,17,67
18,0,16,17,17,50
19,0,34,0,16,50
22,0,18,0,16,34
23,0,32,19,15,66
24,0,16,19,15,50
25,0,34,0,18,52
26,0,15,0,18,33
27,0,33,0,17,50
30,0,17,0,17,34
33,0,36,0,15,51
34,0,18,0,15,33
35,0,32,0,18,50
37,0,34,0,16,50
39,0,32,0,16,48
40,0,16,0,16,32
43,0,33,0,17,50
44,0,18,0,17,35
45,0,32,0,18,50
46,0,15,0,18,33
47,0,33,0,18,51
49,0,35,0,16,51
51,0,33,0,16,49
52,0,17,0,16,33
53,0,32,0,17,49
54,0,16,0,17,33
56,0,17,0,17,34
58,0,17,0,16,33
60,0,18,15,18,51
61,0,33,0,15,48
62,0,18,0,15,33
63,0,32,0,17,49
64,0,17,0,17,34
65,0,34,18,16,68
67,0,34,0,16,50
68,0,16,0,16,32
69,0,33,16,16,65
70,0,17,16,16,49
71,0,32,0,17,49
72,0,16,0,17,33
73,0,34,0,18,52
75,0,33,0,16,49
76,0,15,0,16,31
77,0,35,0,15,50
79,0,32,0,18,50
81,0,35,0,15,50
82,0,17,0,15,32
83,0,32,0,17,49
84,0,17,0,17,34
88,0,17,0,15,32
89,0,31,0,18,49
90,0,16,0,18,34
92,0,17,0,16,33
93,0,34,0,15,49
94,0,18,0,15,33
96,0,16,0,16,32
97,0,35,0,16,51
98,0,19,0,16,35
100,0,17,0,17,34
101,0,33,0,16,49
102,0,16,0,16,32
103,0,33,0,18,51
104,0,17,0,18,35
105,0,34,0,16,50
106,0,16,0,16,32
108,0,17,0,16,33
109,0,32,0,19,51
111,0,35,0,15,50
112,0,16,0,15,31
113,0,32,0,19,51
114,0,17,0,19,36
115,0,35,0,16,51
116,0,16,0,16,32
117,0,33,0,17,50
118,0,17,0,17,34
120,0,16,0,16,32
122,0,17,0,18,35
124,0,16,0,15,31
125,0,33,0,16,49
126,0,18,0,16,34
128,0,18,0,16,34
129,0,33,0,18,51
130,0,17,0,18,35
131,0,33,0,16,49
132,0,15,0,16,31
134,0,17,0,18,35
135,0,32,0,19,51
136,0,14,0,19,33
138,0,15,19,17,51
140,0,17,0,15,32
142,0,17,0,15,32
143,0,34,0,16,50
144,0,19,0,16,35
146,0,17,0,17,34
148,0,15,18,16,49
149,0,34,0,16,50
151,0,34,0,16,50
152,0,18,0,16,34
153,0,32,0,18,50
154,0,16,0,18,34
157,0,34,0,16,50
158,0,17,0,16,33
159,0,31,0,18,49
160,0,15,0,18,33
161,0,35,0,16,51
162,0,17,0,16,33
163,0,34,0,16,50
164,0,18,0,16,34
165,0,32,0,18,50
166,0,16,0,18,34
168,0,16,0,18,34
169,0,34,15,17,66
170,0,16,15,17,48
171,0,32,0,17,49
172,0,17,0,17,34
173,0,34,0,17,51
174,0,17,0,17,34
175,0,32,0,17,49
177,0,35,0,15,50
178,0,18,0,15,33
180,0,19,0,15,34
181,0,31,0,18,49
182,0,16,0,18,34
183,0,34,0,17,51
184,0,16,0,17,33
185,0,33,0,18,51
188,0,15,0,18,33
189,0,36,0,15,51
192,0,17,0,16,33
193,0,34,0,17,51
195,0,34,0,15,49
196,0,17,0,15,32
197,0,31,0,18,49
198,0,16,0,18,34
199,0,33,0,17,50
200,0,15,0,17,32
203,0,35,0,16,51
204,0,18,0,16,34
205,0,32,17,16,65
206,0,16,17,16,49
207,0,33,0,19,52
208,0,16,0,19,35
209,0,34,0,18,52
210,0,15,0,18,33
212,0,16,0,15,31
213,0,32,0,18,50
215,0,33,0,18,51
216,0,15,0,18,33
217,0,35,0,16,51
218,0,17,0,16,33
220,0,20,0,13,33
221,0,31,15,17,63
225,0,35,0,14,49
226,0,17,0,14,31
228,0,18,17,16,51
229,0,33,0,17,50
230,0,16,0,17,33
231,0,34,0,16,50
232,0,17,0,16,33
233,0,32,0,18,50
234,0,16,0,18,34
236,0,16,0,17,33
237,0,35,0,16,51
238,0,18,0,16,34
239,0,33,0,15,48
240,0,17,0,15,32
242,0,16,0,19,35
243,0,35,0,16,51
245,0,34,0,16,50
246,0,18,0,16,34
248,0,17,0,17,34
249,0,34,17,14,65
250,0,17,17,14,48
252,0,14,0,17,31
253,0,36,0,15,51
258,0,15,0,19,34
259,0,33,0,17,50
260,0,14,0,17,31
261,0,35,0,17,52
262,0,18,0,17,35
265,0,34,0,15,49
266,0,16,0,15,31
267,0,31,0,17,48
268,0,16,0,17,33
269,0,33,0,18,51
270,0,16,0,18,34
271,0,34,0,18,52
272,0,16,0,18,34
274,0,15,0,17,32
275,0,35,0,15,50
276,0,18,0,15,33
277,0,33,0,15,48
279,0,33,0,18,51
281,0,34,0,16,50
283,0,32,0,18,50
284,0,16,0,18,34
287,0,33,0,18,51
288,0,15,0,18,33
289,0,34,0,18,52
290,0,16,0,18,34
292,0,16,0,16,32
293,0,33,0,17,50
294,0,17,0,17,34
297,0,33,0,17,50
298,0,16,0,17,33
299,0,33,0,17,50
300,0,16,0,17,33
301,0,34,0,16,50
302,0,17,0,16,33
304,0,17,0,18,35
307,0,34,0,17,51
309,0,34,0,16,50
311,0,33,0,16,49
312,0,17,0,16,33
313,0,32,0,18,50
314,0,16,0,18,34
315,0,34,0,17,51
316,0,16,0,17,33
317,0,34,0,17,51
318,0,17,0,17,34
319,0,33,0,17,50
321,0,33,0,17,50
322,0,16,0,17,33
324,0,16,16,19,51
325,0,35,0,16,51
327,0,32,0,17,49
329,0,33,0,17,50
330,0,16,0,17,33
332,0,16,0,18,34
334,0,16,0,15,31
335,0,33,0,16,49
336,0,18,0,16,34
337,0,34,0,15,49
338,0,18,0,15,33
339,0,33,0,17,50
341,0,34,0,16,50
342,0,17,0,16,33
343,0,33,0,17,50
345,0,33,0,16,49
346,0,16,0,16,32
347,0,34,0,16,50
348,0,18,0,16,34
350,0,16,0,18,34
351,0,35,0,16,51
353,0,31,0,19,50
354,0,15,0,19,34
355,0,35,0,17,52
356,0,16,0,17,33
357,0,33,0,15,48
360,0,18,16,18,52
361,0,34,15,17,66
362,0,18,15,17,50
365,0,33,0,19,52
367,0,35,0,15,50
369,0,33,0,15,48
370,0,18,0,15,33
371,0,33,0,16,49
373,0,34,0,18,52
375,0,33,0,17,50
377,0,33,0,15,48
378,0,16,0,15,31
379,0,35,0,15,50
380,0,20,0,15,35
381,0,32,0,15,47
384,0,17,0,17,34
386,0,18,0,16,34
389,0,35,0,15,50
390,0,18,0,15,33
391,0,34,0,14,48
392,0,19,0,14,33
393,0,31,0,16,47
394,0,17,0,16,33
395,0,34,0,17,51
396,0,18,0,17,35
397,0,35,0,15,50
399,0,32,0,17,49
400,0,17,0,17,34
401,0,33,0,16,49
402,0,16,0,16,32
403,0,31,0,20,51
404,0,15,0,20,35
406,0,16,0,16,32
407,0,34,0,17,51
408,0,18,0,17,35
409,0,33,0,17,50
410,0,16,0,17,33
413,0,32,0,19,51
414,0,16,0,19,35
415,0,34,0,17,51
416,0,15,0,17,32
417,0,33,0,19,52
419,0,35,0,16,51
420,0,16,0,16,32
421,0,34,0,16,50
424,0,17,0,15,32
425,0,32,0,17,49
426,0,17,0,17,34
427,0,33,0,16,49
428,0,16,0,16,32
429,0,34,0,16,50
430,0,18,0,16,34
431,0,34,0,15,49
432,0,18,0,15,33
434,0,18,0,17,35
435,0,33,0,16,49
436,0,16,0,16,32
437,0,33,0,16,49
438,0,17,0,16,33
439,0,34,0,16,50
440,0,18,0,16,34
442,0,16,0,16,32
443,0,36,0,14,50
444,0,20,0,14,34
445,0,32,0,15,47
447,0,34,15,17,66
448,0,19,15,17,51
449,0,32,0,16,48
450,0,17,0,16,33
451,0,35,0,15,50
452,0,19,0,15,34
453,0,31,0,17,48
454,0,16,0,17,33
458,0,16,0,18,34
459,0,31,19,17,67
460,0,13,19,17,49
461,19,17,16,17,69
463,0,33,0,17,50
464,0,17,0,17,34
465,0,33,0,18,51
466,0,16,0,18,34
467,0,34,0,17,51
468,0,16,0,17,33
469,0,33,0,16,49
472,0,18,17,17,52
473,0,34,0,16,50
474,0,17,0,16,33
475,0,33,0,15,48
476,0,17,0,15,32
478,0,18,0,16,34
481,0,33,0,16,49
483,0,34,0,17,51
485,0,32,0,17,49
486,0,15,0,17,32
487,0,36,0,14,50
488,0,19,0,14,33
489,0,31,0,17,48
490,0,17,0,17,34
491,0,35,0,16,51
492,0,18,0,16,34
493,0,32,18,15,65
494,0,16,18,15,49
495,0,33,0,17,50
496,0,15,0,17,32
498,0,17,0,16,33
499,0,34,0,16,50
500,0,18,0,16,34
501,0,32,0,17,49
502,0,16,0,17,33
503,0,34,17,17,68
504,0,17,17,17,51
505,0,34,0,16,50
507,0,34,0,14,48
508,0,18,0,14,32
509,0,32,0,17,49
511,0,33,0,17,50
514,0,16,0,17,33
515,0,34,0,17,51
517,0,33,0,16,49
518,0,16,0,16,32
524,0,16,0,16,32
525,0,34,0,14,48
526,0,18,0,14,32
527,0,31,0,18,49
529,0,35,0,16,51
530,0,17,0,16,33
531,0,33,0,16,49
533,0,33,0,17,50
534,0,17,0,17,34
535,0,32,0,19,51
536,0,15,0,19,34
537,0,35,0,16,51
538,0,16,0,16,32
540,0,16,0,17,33
541,0,35,0,16,51
542,0,18,0,16,34
544,0,16,0,16,32
545,0,33,0,19,52
546,0,17,0,19,36
547,0,35,0,15,50
549,0,32,0,17,49
551,0,33,0,19,52
552,0,16,0,19,35
554,0,15,0,17,32
556,0,17,0,17,34
557,0,33,0,17,50
559,0,33,0,18,51
560,0,16,0,18,34
561,0,33,0,17,50
562,0,15,0,17,32
563,0,33,0,18,51
566,0,15,0,19,34
567,0,35,0,16,51
568,0,16,0,16,32
570,0,18,0,15,33
571,0,32,0,17,49
572,0,17,0,17,34
573,0,33,0,17,50
575,0,35,0,15,50
576,0,18,0,15,33
577,0,31,0,19,50
578,0,16,0,19,35
579,0,34,0,18,52
580,0,15,0,18,33
581,0,34,0,16,50
583,0,33,0,16,49
584,0,17,0,16,33
586,0,19,0,15,34
588,0,17,0,16,33
589,0,32,0,17,49
592,0,17,0,18,35
593,0,35,0,16,51
594,0,17,0,16,33
595,0,32,16,17,65
597,0,33,0,18,51
598,0,17,0,18,35
599,0,33,0,18,51
600,0,15,0,18,33
601,0,34,0,17,51
602,0,16,0,17,33
603,0,33,0,17,50
604,0,16,0,17,33
606,0,17,0,17,34
607,0,34,0,16,50
608,0,17,0,16,33
609,0,33,0,17,50
613,0,34,0,17,51
615,0,33,0,18,51
616,0,16,0,18,34
617,0,35,0,16,51
618,0,17,0,16,33
621,0,32,0,17,49
624,0,15,0,20,35
625,0,35,0,15,50
626,0,15,0,15,30
627,0,32,0,18,50
628,0,17,0,18,35
629,0,35,0,15,50
630,0,17,0,15,32
631,0,31,0,17,48
633,0,36,0,14,50
634,0,19,0,14,33
637,0,34,0,17,51
638,0,17,0,17,34
640,0,16,0,15,31
641,0,33,0,17,50
643,0,33,0,17,50
644,0,16,0,17,33
645,0,34,0,15,49
648,0,17,0,18,35
650,0,18,0,14,32
651,0,32,0,17,49
654,0,15,0,18,33
655,0,34,0,16,50
656,0,16,0,16,32
657,0,34,0,17,51
659,0,33,0,18,51
660,0,16,0,18,34
661,0,34,0,17,51
662,0,16,0,17,33
663,0,33,0,16,49
664,0,16,0,16,32
666,0,18,0,16,34
667,0,32,0,16,48
668,0,16,0,16,32
669,0,34,0,17,51
670,0,18,0,17,35
671,0,34,0,16,50
672,0,17,0,16,33
673,0,32,0,17,49
674,0,16,0,17,33
675,0,38,0,11,49
676,0,21,0,11,32
677,0,30,0,16,46
678,0,19,0,16,35
679,0,33,0,17,50
680,0,17,0,17,34
681,0,32,0,18,50
684,0,16,0,16,32
685,0,33,0,18,51
686,0,17,0,18,35
687,0,34,0,16,50
688,0,16,0,16,32
694,0,16,0,17,33
695,0,34,0,17,51
696,0,17,0,17,34
697,0,33,0,17,50
698,0,16,0,17,33
700,0,16,0,16,32
701,0,34,0,16,50
703,0,33,0,16,49
704,0,17,0,16,33
705,0,33,0,18,51
706,0,17,0,18,35
707,0,33,17,19,69
711,0,28,0,22,50
712,15,37,0,16,68
713,0,37,0,16,53
714,0,15,0,16,31
715,0,33,0,16,49
716,0,17,0,16,33
717,0,34,0,17,51
718,0,18,0,17,35
720,0,16,0,17,33
721,0,33,0,17,50
722,0,16,0,17,33
723,0,35,0,14,49
725,0,31,0,19,50
726,0,17,0,19,36
728,0,16,0,16,32
729,0,33,0,16,49
730,0,17,0,16,33
731,0,35,0,15,50
732,0,19,0,15,34
733,0,31,0,18,49
736,0,15,0,17,32
737,0,33,0,18,51
738,0,16,0,18,34
740,0,17,0,16,33
743,0,35,0,16,51
744,0,18,0,16,34
745,0,33,0,16,49
747,0,33,0,20,53
748,0,17,0,20,37
749,0,32,0,18,50
750,0,12,0,18,30
751,0,35,0,16,51
752,0,17,0,16,33
753,0,32,18,16,66
754,0,16,18,16,50
755,0,34,0,16,50
756,0,16,0,16,32
758,0,17,0,17,34
759,0,33,0,18,51
760,0,16,0,18,34
762,0,16,0,18,34
763,0,33,0,18,51
764,0,15,0,18,33
765,0,34,0,17,51
767,0,33,0,17,50
771,0,34,0,16,50
772,0,18,0,16,34
773,0,33,0,17,50
774,0,17,0,17,34
775,0,34,0,16,50
776,0,17,0,16,33
777,0,33,0,18,51
778,0,17,0,18,35
779,0,34,0,19,53
780,0,16,0,19,35
781,0,32,0,18,50
782,0,13,0,18,31
783,0,34,0,17,51
785,0,33,0,18,51
786,0,16,0,18,34
787,0,34,17,15,66
788,0,16,17,15,48
790,0,15,0,16,31
791,0,33,0,18,51
792,0,17,0,18,35
793,0,36,0,15,51
794,0,18,0,15,33
795,0,31,0,17,48
797,0,34,0,17,51
798,0,17,0,17,34
799,0,34,0,15,49
801,0,33,0,16,49
802,0,18,0,16,34
804,0,17,0,16,33
805,0,33,0,17,50
806,0,17,0,17,34
809,0,34,0,17,51
810,0,16,0,17,33
811,0,32,0,17,49
812,0,15,0,17,32
813,0,35,0,16,51
815,0,32,18,17,67
816,0,16,18,17,51
817,0,35,16,16,67
818,0,17,16,16,49
819,0,32,0,18,50
820,0,16,0,18,34
822,0,17,0,15,32
823,0,32,17,16,65
824,0,17,17,16,50
825,0,33,0,18,51
826,0,16,0,18,34
828,0,17,15,17,49
829,0,32,0,17,49
831,0,33,18,17,68
832,0,16,18,17,51
833,0,35,0,17,52
834,0,17,0,17,34
835,0,32,0,17,49
836,0,15,0,17,32
837,0,33,0,18,51
838,0,16,0,18,34
839,0,34,0,17,51
842,0,17,0,16,33
844,0,16,0,20,36
847,0,36,0,15,51
848,0,17,0,15,32
849,0,33,0,17,50
850,0,18,0,17,35
851,0,32,17,18,67
852,0,15,17,18,50
853,0,35,16,16,67
855,0,32,18,15,65
856,0,16,18,15,49
857,0,33,0,18,51
858,0,15,0,18,33
859,0,34,0,17,51
860,0,16,0,17,33
862,0,17,0,18,35
863,0,32,0,18,50
864,0,14,0,18,32
866,0,17,0,17,34
867,0,33,0,17,50
868,0,16,0,17,33
869,0,33,0,17,50
871,0,33,0,17,50
872,0,16,0,17,33
875,0,34,0,15,49
876,0,17,0,15,32
877,0,33,0,18,51
879,0,33,0,18,51
881,0,33,17,17,67
882,0,15,17,17,49
883,0,34,0,17,51
886,0,17,0,17,34
889,0,32,0,17,49
890,0,17,0,17,34
893,0,33,16,16,65
894,0,16,16,16,48
895,0,32,18,16,66
897,0,34,0,18,52
901,0,33,0,16,49
902,0,18,0,16,34
903,0,33,0,17,50
904,0,17,0,17,34
906,0,16,0,17,33
907,0,35,0,16,51
908,0,18,0,16,34
911,0,35,0,17,52
912,0,18,0,17,35
913,0,33,0,17,50
914,0,16,0,17,33
915,0,35,15,17,67
917,0,32,0,17,49
918,0,17,0,17,34
919,0,34,0,15,49
920,0,17,0,15,32
922,0,17,0,18,35
924,0,15,0,17,32
925,0,34,0,17,51
926,0,17,0,17,34
928,0,16,0,18,34
929,0,35,0,15,50
930,0,17,0,15,32
931,0,33,0,15,48
935,0,35,0,15,50
936,0,16,0,15,31
937,0,33,15,18,66
938,0,18,15,18,51
939,0,33,0,16,49
942,0,17,0,17,34
943,0,35,0,15,50
946,0,17,17,16,50
948,0,16,0,17,33
949,0,33,0,18,51
950,0,16,0,18,34
951,0,34,0,16,50
953,0,33,16,16,65
954,0,17,16,16,49
956,0,16,0,18,34
957,0,34,17,18,69
958,0,16,17,18,51
960,0,18,0,16,34
962,0,16,0,17,33
963,0,34,0,17,51
964,0,17,0,17,34
965,0,32,0,18,50
967,0,34,0,16,50
969,0,33,17,16,66
970,0,17,17,16,50
975,0,35,0,15,50
976,0,18,0,15,33
977,0,32,17,17,66
978,0,17,17,17,51
979,0,34,0,15,49
982,0,18,0,17,35
983,0,33,0,17,50
986,0,16,0,16,32
987,0,33,17,18,68
988,0,17,17,18,52
989,0,35,0,17,52
991,0,32,0,17,49
993,0,33,0,18,51
995,0,35,0,15,50
997,0,31,0,18,49
999,0,35,0,16,51
1000,0,17,0,16,33
1001,0,33,0,17,50
1002,0,17,0,17,34
1003,0,32,0,19,51
1004,0,15,0,19,34
1005,0,34,0,20,54
1006,0,15,0,20,35
1007,0,35,0,15,50
1008,0,15,0,15,30
1009,0,32,0,17,49
1011,0,34,0,16,50
1012,0,17,0,16,33
1013,0,33,16,17,66
1014,0,17,16,17,50
1017,0,33,0,17,50
1018,0,15,0,17,32
1019,0,34,0,17,51
1020,0,17,0,17,34
1021,0,34,0,16,50
1025,0,34,0,18,52
1026,0,15,0,18,33
1030,0,18,0,17,35
1031,0,33,0,17,50
1033,0,33,0,20,53
1034,0,16,0,20,36
1035,0,34,17,16,67
1036,0,14,17,16,47
1038,0,16,0,16,32
1039,0,33,0,18,51
1040,0,17,0,18,35
1042,0,16,0,16,32
1044,0,16,0,18,34
1046,0,17,0,17,34
1047,0,32,0,17,49
1048,0,15,0,17,32
1051,0,32,0,19,51
1052,0,16,0,19,35
1054,0,15,0,17,32
1055,0,34,0,16,50
1056,0,17,0,16,33
1057,0,33,0,18,51
1058,0,17,0,18,35
1059,0,33,0,18,51
1060,0,15,0,18,33
1061,0,35,0,15,50
1062,0,17,0,15,32
1063,0,34,0,15,49
1065,0,33,0,16,49
1066,0,18,0,16,34
1067,0,32,0,16,48
1069,0,33,0,18,51
1070,0,17,0,18,35
1071,0,33,0,18,51
1072,0,15,0,18,33
1073,0,34,0,16,50
1074,0,16,0,16,32
1075,0,32,0,17,49
1076,0,16,0,17,33
1077,0,36,0,16,52
1081,0,32,0,17,49
1082,0,16,0,17,33
1083,0,34,0,17,51
1084,0,17,0,17,34
1086,0,16,0,17,33
1087,0,35,0,16,51
1088,0,18,0,16,34
1089,0,32,0,17,49
1090,0,16,0,17,33
1095,0,34,17,16,67
1096,0,18,17,16,51
1097,0,33,0,17,50
1098,0,16,0,17,33
1100,0,16,17,16,49
1101,0,33,0,17,50
1102,0,16,0,17,33
1103,0,33,0,17,50
1105,0,35,0,15,50
1106,0,18,0,15,33
1109,0,32,0,17,49
1111,0,34,0,17,51
1112,0,17,0,17,34
1113,0,34,0,17,51
1114,0,17,0,17,34
1117,0,33,0,16,49
1118,0,16,0,16,32
1119,0,34,0,17,51
1120,0,18,0,17,35
1121,0,32,0,18,50
1122,0,15,0,18,33
1124,0,15,0,19,34
1125,0,34,0,16,50
1126,0,15,0,16,31
1129,0,33,0,17,50
1131,0,35,0,16,51
1132,0,18,0,16,34
1133,0,31,0,17,48
1134,0,15,0,17,32
1135,0,34,0,17,51
1136,0,17,0,17,34
1137,0,33,0,17,50
1138,0,16,0,17,33
1140,0,18,0,15,33
1141,0,32,0,17,49
1143,0,34,17,17,68
1144,0,17,17,17,51
1147,0,31,19,17,67
1148,0,14,19,17,50
1150,0,17,0,14,31
1151,0,32,0,17,49
1155,0,34,0,16,50
1156,0,16,0,16,32
1159,0,35,0,14,49
1160,0,21,0,14,35
1161,0,31,0,16,47
1162,0,17,0,16,33
1163,0,33,0,21,54
1166,0,9,22,16,47
1167,22,16,0,17,55
1168,0,16,0,17,33
1169,0,33,0,18,51
1170,0,16,0,18,34
1172,0,14,0,17,31
1173,0,33,0,18,51
1175,0,34,0,16,50
1176,0,16,0,16,32
1177,0,34,0,16,50
1178,0,18,0,16,34
1180,0,16,0,18,34
1182,0,15,0,17,32
1183,0,35,0,15,50
1186,0,19,0,16,35
1188,0,16,0,17,33
1189,0,34,0,15,49
1192,0,18,0,15,33
1193,0,33,0,18,51
1194,0,18,0,18,36
1196,0,13,0,18,31
1197,0,36,0,15,51
1198,0,18,0,15,33
1199,0,33,0,16,49
1200,0,18,0,16,34
1202,0,16,0,17,33
1204,0,18,0,17,35
1206,0,16,0,16,32
1207,0,33,0,18,51
1210,0,16,0,16,32
1212,0,18,0,16,34
1213,0,32,0,17,49
1214,0,16,0,17,33
1216,0,16,0,17,33
1218,0,18,0,15,33
1219,0,32,0,16,48
1220,0,17,0,16,33
1221,0,33,0,16,49
1222,0,17,0,16,33
1224,0,17,0,19,36
1225,0,34,0,19,53
1226,0,15,0,19,34
1227,0,33,0,17,50
1228,0,14,0,17,31
1229,0,33,0,19,52
1230,0,16,0,19,35
1233,0,34,0,18,52
1234,0,16,0,18,34
1236,0,17,0,16,33
1237,0,33,0,15,48
1238,0,17,0,15,32
1239,0,32,0,18,50
1241,0,34,0,17,51
1243,0,33,0,17,50
1245,0,33,0,18,51
1246,0,16,0,18,34
1247,0,33,0,17,50
1249,0,35,0,16,51
1250,0,18,0,16,34
1251,0,32,0,18,50
1254,0,17,0,16,33
1255,0,32,0,18,50
1256,0,16,0,18,34
1258,0,15,0,17,32
1260,0,16,17,17,50
1261,0,34,0,16,50
1263,0,34,0,18,52
1264,0,18,0,18,36
1266,0,15,16,17,48
1267,0,33,0,18,51
1269,0,34,17,14,65
1270,0,16,17,14,47
1273,0,36,17,15,68
1274,0,18,17,15,50
1275,0,32,18,15,65
1276,0,15,18,15,48
1277,0,33,0,16,49
1278,0,15,0,16,31
1279,0,33,0,18,51
1280,0,17,0,18,35
1282,0,16,0,17,33
1283,0,35,15,16,66
1284,0,18,15,16,49
1286,0,16,0,18,34
1289,0,33,18,17,68
1293,0,33,0,15,48
1294,0,18,0,15,33
1295,0,34,0,15,49
1296,0,19,0,15,34
1297,0,31,0,17,48
1298,0,16,0,17,33
1299,0,35,0,16,51
1301,0,34,0,16,50
1303,0,33,0,16,49
1305,0,33,0,16,49
1307,0,33,0,17,50
1308,0,17,0,17,34
1310,0,16,0,17,33
1313,0,34,0,16,50
1314,0,16,0,16,32
1315,0,34,0,16,50
1316,0,18,0,16,34
1317,0,33,0,17,50
1321,0,34,0,17,51
1322,0,18,0,17,35
1323,0,33,0,18,51
1324,0,16,0,18,34
1325,0,34,0,16,50
1327,0,33,0,17,50
1328,0,17,0,17,34
1329,0,34,0,16,50
1331,0,34,0,15,49
1332,0,18,0,15,33
1333,0,32,0,16,48
1334,0,17,0,16,33
1335,0,33,0,16,49
1336,0,17,0,16,33
1337,0,33,0,18,51
1338,0,17,0,18,35
1339,0,34,0,16,50
1340,0,16,0,16,32
1343,0,34,0,15,49
1344,0,18,0,15,33
1345,0,33,0,16,49
1346,0,18,0,16,34
1348,0,17,0,17,34
1349,0,32,0,18,50
1350,0,15,0,18,33
1351,0,33,18,16,67
1352,0,15,18,16,49
1353,0,34,0,16,50
1356,0,19,0,15,34
1357,0,32,0,16,48
1358,0,17,0,16,33
1359,0,33,0,18,51
1360,0,17,0,18,35
1361,0,34,0,16,50
1363,0,34,0,17,51
1364,0,18,0,17,35
1365,0,34,0,16,50
1366,0,17,0,16,33
1369,0,33,0,16,49
1370,0,17,0,16,33
1371,0,32,0,16,48
1372,0,16,0,16,32
1373,0,34,0,16,50
1375,0,33,16,17,66
1376,0,17,16,17,50
1379,0,34,0,16,50
1380,0,18,0,16,34
1381,0,35,0,14,49
1382,0,19,0,14,33
1384,0,18,0,16,34
1385,0,33,0,18,51
1386,0,17,0,18,35
1387,0,35,0,16,51
1388,0,17,0,16,33
1389,0,32,0,20,52
1390,0,16,0,20,36
1391,0,33,0,16,49
1392,0,13,0,16,29
1394,0,16,0,18,34
1395,0,35,0,16,51
1396,0,17,0,16,33
1397,0,32,0,17,49
1398,0,16,0,17,33
1400,0,17,0,16,33
1402,0,17,0,18,35
1404,0,16,17,16,49
1405,0,33,0,16,49
1406,0,16,0,16,32
1407,0,33,0,17,50
1409,0,35,0,15,50
1413,0,33,0,17,50
1414,0,17,0,17,34
1416,0,15,0,17,32
1417,0,35,0,16,51
1419,0,33,0,16,49
1420,0,17,0,16,33
1422,0,17,0,19,36
1423,0,34,0,16,50
1425,0,32,18,15,65
1426,0,16,18,15,49
1427,0,33,0,19,52
1430,0,13,0,22,35
1431,0,36,0,17,53
1434,0,16,0,17,33
1435,0,34,0,16,50
1436,0,17,0,16,33
1437,0,32,0,18,50
1438,0,16,0,18,34
1439,0,34,0,16,50
1440,0,16,0,16,32
1441,0,33,0,16,49
1442,0,17,0,16,33
1443,0,33,0,19,52
1446,0,16,0,15,31
1447,0,32,17,17,66
1448,0,17,17,17,51
1449,0,34,0,17,51
1451,0,33,0,16,49
1453,0,32,0,18,50
1456,0,17,0,17,34
1457,0,32,0,18,50
1458,0,15,0,18,33
1459,0,35,15,18,68
1460,0,17,15,18,50
1461,0,33,16,17,66
1462,0,18,16,17,51
1463,0,33,0,18,51
1465,0,33,18,16,67
1466,0,15,18,16,49
1467,0,34,0,17,51
1469,0,33,0,17,50
1471,0,33,18,17,68
1472,0,16,18,17,51
1476,0,17,0,17,34
1477,0,34,17,17,68
1479,0,34,0,16,50
1480,0,17,0,16,33
1481,0,31,0,19,50
1482,0,15,0,19,34
1483,0,34,18,15,67
1484,0,15,18,15,48
1486,0,15,18,17,50
1487,0,35,0,17,52
1488,0,17,0,17,34
1491,0,33,17,16,66
1492,0,17,17,16,50
1494,0,16,16,16,48
1495,0,32,0,17,49
1496,0,16,0,17,33
1498,0,16,19,16,51
1500,0,16,0,17,33
1501,0,34,17,16,67
1502,0,17,17,16,50
1504,0,16,16,17,49
1505,0,33,0,16,49
1508,0,17,18,16,51
1509,0,34,16,19,69
1510,0,16,16,19,51
1511,0,35,0,15,50
1512,0,19,0,15,34
1513,0,32,0,18,50
1514,0,17,0,18,35
1515,0,34,0,16,50
1516,0,16,0,16,32
1518,0,15,19,15,49
1519,0,34,0,17,51
1520,0,15,0,17,32
1521,0,35,17,15,67
1522,0,18,17,15,50
1525,0,34,0,18,52
1526,0,18,0,18,36
1527,0,31,0,19,50
1528,0,13,0,19,32
1529,0,35,16,17,68
1531,0,33,0,17,50
1532,0,17,0,17,34
1533,0,33,18,18,69
1535,0,36,0,16,52
1536,0,18,0,16,34
1538,0,17,16,16,49
1540,0,16,0,16,32
1541,0,33,0,17,50
1542,0,17,0,17,34
1543,0,33,18,16,67
1544,0,16,18,16,50
1545,0,34,0,17,51
1546,0,16,0,17,33
1547,0,34,0,16,50
1548,0,17,0,16,33
1549,0,33,16,16,65
1550,0,17,16,16,49
1552,0,16,0,16,32
1553,0,33,0,18,51
1554,0,17,0,18,35
1556,0,17,0,16,33
1557,0,32,0,19,51
1558,0,16,0,19,35
1559,0,35,0,15,50
1560,0,16,0,15,31
1561,0,36,0,13,49
1562,0,21,0,13,34
1564,0,16,0,19,35
1565,0,34,0,19,53
1567,0,34,0,17,51
1569,0,32,0,18,50
1570,0,15,0,18,33
1573,0,34,0,17,51
1574,0,16,0,17,33
1575,0,32,0,18,50
1576,0,15,0,18,33
1577,0,33,0,17,50
1578,0,15,0,17,32
1580,0,17,0,16,33
1581,0,35,0,16,51
1583,0,31,0,17,48
1586,0,16,0,18,34
1587,0,34,0,19,53
1588,0,16,0,19,35
1589,0,34,0,17,51
1590,0,15,0,17,32
1591,0,34,0,17,51
1592,0,17,0,17,34
1593,0,34,0,16,50
1594,0,17,0,16,33
1595,0,34,0,14,48
1596,0,18,0,14,32
1598,0,18,0,16,34
1599,0,33,0,16,49
1600,0,17,0,16,33
1602,0,18,0,17,35
1604,0,14,0,19,33
1607,0,31,0,18,49
1608,0,16,0,18,34
1609,0,36,0,17,53
1610,0,18,0,17,35
1611,0,32,0,17,49
1614,0,17,0,16,33
1616,0,16,0,18,34
1619,0,34,0,15,49
1621,0,33,0,16,49
1623,0,34,16,15,65
1624,0,18,16,15,49
1625,0,31,0,18,49
1626,0,15,0,18,33
1627,0,35,0,16,51
1629,0,33,0,15,48
1630,0,17,0,15,32
1632,0,18,0,17,35
1633,0,38,0,12,50
1634,0,21,0,12,33
1635,0,28,0,18,46
1636,0,16,0,18,34
1641,0,35,0,15,50
1642,0,18,0,15,33
1643,0,32,17,17,66
1644,0,17,17,17,51
1645,0,34,0,16,50
1646,0,17,0,16,33
1647,0,32,0,18,50
1648,0,16,0,18,34
1651,0,32,0,18,50
1652,0,15,0,18,33
1653,0,35,0,18,53
1654,0,17,0,18,35
1655,0,33,0,16,49
1657,0,33,0,17,50
1658,0,17,0,17,34
1659,0,33,0,17,50
1660,0,16,0,17,33
1661,0,35,0,15,50
1662,0,18,0,15,33
1664,0,18,0,16,34
1665,0,33,0,18,51
1667,0,33,0,16,49
1668,0,15,0,16,31
1670,0,18,0,16,34
1671,0,32,0,17,49
1672,0,16,0,17,33
1674,0,17,0,17,34
1675,0,33,0,16,49
1676,0,16,0,16,32
1677,0,33,0,18,51
1679,0,33,0,17,50
1680,0,15,0,17,32
1681,0,35,0,17,52
1682,0,18,0,17,35
1683,0,32,0,18,50
1684,0,15,0,18,33
1685,0,35,0,16,51
1686,0,17,0,16,33
1689,0,34,0,17,51
1691,0,33,0,16,49
1693,0,33,0,17,50
1694,0,17,0,17,34
1695,0,34,17,18,69
1696,0,17,17,18,52
1697,0,35,0,15,50
1698,0,18,0,15,33
1700,0,18,0,15,33
1701,0,32,0,17,49
1702,0,17,0,17,34
1703,0,33,0,17,50
1705,0,33,0,16,49
1707,0,34,0,16,50
1708,0,18,0,16,34
1709,0,33,0,17,50
1710,0,17,0,17,34
1711,0,32,0,19,51
1712,0,15,0,19,34
1713,0,34,0,19,53
1714,0,15,0,19,34
1715,0,34,0,16,50
1716,0,15,0,16,31
1718,0,17,0,17,34
1721,0,32,0,17,49
1722,0,19,0,17,36
1724,0,16,0,15,31
1727,0,35,0,17,52
1728,0,19,0,17,36
1729,0,32,0,18,50
1731,0,34,0,17,51
1732,0,16,0,17,33
1733,0,34,0,15,49
1734,0,17,0,15,32
1735,15,17,0,17,49
1736,0,17,0,17,34
1737,0,34,0,16,50
1738,0,17,0,16,33
1739,0,33,0,17,50
1740,0,17,0,17,34
1741,0,34,0,15,49
1742,0,17,0,15,32
1743,0,32,0,17,49
1744,0,17,0,17,34
1746,0,16,0,17,33
1748,0,18,0,15,33
1749,0,34,0,15,49
1751,0,31,0,17,48
1752,0,16,0,17,33
1753,0,36,15,18,69
1754,0,19,15,18,52
1756,0,18,0,14,32
1757,0,33,15,19,67
1758,0,19,15,19,53
1759,0,34,0,16,50
1760,0,19,0,16,35
1761,0,32,0,16,48
1764,0,16,0,19,35
1765,0,35,0,15,50
1766,0,16,0,15,31
1767,0,34,0,16,50
1768,0,19,0,16,35
1770,0,16,0,18,34
1771,0,33,0,18,51
1772,0,15,0,18,33
1774,0,17,0,15,32
1776,0,16,0,19,35
1777,0,34,0,18,52
1778,0,15,0,18,33
1779,0,34,0,17,51
1780,0,16,0,17,33
1781,0,34,0,15,49
1782,0,17,0,15,32
1783,0,32,0,17,49
1785,0,33,0,17,50
1788,0,15,0,19,34
1789,0,35,17,17,69
1790,0,16,17,17,50
1791,0,34,0,16,50
1794,0,17,17,16,50
1795,0,33,0,17,50
1796,0,16,0,17,33
1797,0,35,0,16,51
1798,0,18,0,16,34
1799,0,32,0,16,48
1800,0,16,0,16,32
1803,0,34,0,16,50
1804,0,16,0,16,32
1805,0,33,0,17,50
1807,0,34,0,16,50
1808,0,17,0,16,33
1810,0,17,0,17,34
1811,0,33,0,16,49
1812,0,16,0,16,32
1813,0,32,0,17,49
1814,0,16,0,17,33
1817,0,33,0,18,51
1819,0,33,0,15,48
1821,0,34,0,15,49
1822,0,19,0,15,34
1823,0,34,0,14,48
1825,0,34,0,19,53
1826,0,20,0,19,39
1827,0,32,0,16,48
1828,0,13,0,16,29
1829,0,33,0,17,50
1833,0,32,0,16,48
1834,0,17,0,16,33
1835,0,34,0,17,51
1837,0,32,0,18,50
1839,0,35,0,16,51
1840,0,17,0,16,33
1842,0,16,0,17,33
1845,0,35,0,15,50
1846,0,18,0,15,33
1847,0,31,0,17,48
1848,0,16,0,17,33
1849,0,35,0,15,50
1850,0,18,0,15,33
1851,0,33,0,16,49
1852,0,18,0,16,34
1853,0,34,16,20,70
1854,0,18,16,20,54
1857,0,28,0,17,45
1858,0,15,0,17,32
1860,0,19,0,15,34
1861,0,32,0,18,50
1862,0,17,0,18,35
1863,0,33,0,17,50
1864,0,15,0,17,32
1866,0,16,0,17,33
1867,0,35,0,15,50
1868,0,18,0,15,33
1869,0,32,0,17,49
1870,0,17,0,17,34
1873,0,35,0,17,52
1874,0,17,0,17,34
1876,0,15,0,17,32
1877,0,33,0,16,49
1878,0,16,0,16,32
1879,0,35,0,16,51
1880,0,19,0,16,35
1881,0,32,0,18,50
1882,0,16,0,18,34
1883,0,35,0,16,51
1885,0,32,0,17,49
1886,0,16,0,17,33
1887,0,35,0,16,51
1888,0,18,0,16,34
1891,0,33,0,17,50
1893,0,33,16,18,67
1894,0,16,16,18,50
1897,0,33,0,18,51
1898,0,15,0,18,33
1899,0,34,0,17,51
1900,0,16,0,17,33
1901,0,34,0,15,49
1902,0,17,0,15,32
1903,0,31,0,19,50
1904,0,16,0,19,35
1905,0,35,0,16,51
1906,0,16,0,16,32
1907,0,33,0,17,50
1911,0,32,0,17,49
1912,0,16,0,17,33
1913,0,33,0,17,50
1914,0,16,0,17,33
1915,0,35,0,16,51
1916,0,18,0,16,34
1919,0,34,0,15,49
1922,0,18,0,15,33
1923,0,33,0,16,49
1924,0,18,0,16,34
1925,0,34,0,15,49
1926,0,18,0,15,33
1927,0,33,16,17,66
1928,0,18,16,17,51
1929,0,33,0,16,49
1930,0,17,0,16,33
1932,0,17,0,17,34
1935,0,34,0,17,51
1936,0,16,0,17,33
1939,0,31,0,17,48
1940,0,14,0,17,31
1942,0,17,0,17,34
1943,0,35,0,17,52
1944,0,18,0,17,35
1946,0,15,0,16,31
1947,0,33,0,16,49
1948,0,17,0,16,33
1951,0,35,0,15,50
1954,0,17,0,17,34
1955,0,32,0,17,49
1956,0,15,0,17,32
1957,0,35,0,15,50
1958,0,18,0,15,33
1959,0,32,0,17,49
1960,0,17,0,17,34
1961,0,34,0,17,51
1963,0,34,0,15,49
1964,0,17,0,15,32
1966,0,18,17,17,52
1967,0,34,0,15,49
1968,0,17,0,15,32
1969,0,32,0,17,49
1973,0,33,0,18,51
1976,0,15,0,17,32
1978,0,17,17,15,49
1979,0,32,0,18,50
1980,0,15,0,18,33
1982,0,16,0,18,34
1983,0,34,0,16,50
1984,0,16,0,16,32
1985,0,32,0,17,49
1987,0,34,0,18,52
1989,0,33,0,17,50
1991,0,34,0,18,52
1992,0,17,0,18,35
1993,0,33,0,17,50
1994,0,15,0,17,32
1995,0,35,0,15,50
2000,0,18,0,17,35
2001,0,32,0,17,49
2002,0,15,0,17,32
2003,0,35,0,15,50
2005,0,32,0,17,49
2006,0,17,0,17,34
2007,0,34,0,15,49
2008,0,17,0,15,32
2013,0,32,0,17,49
2014,0,15,0,17,32
2015,0,35,16,16,67
2016,0,18,16,16,50
2018,0,16,0,17,33
2019,0,34,0,17,51
2020,0,17,0,17,34
2021,0,34,0,15,49
2022,0,17,0,15,32
2023,0,33,0,15,48
2025,0,32,0,17,49
2026,0,17,0,17,34
2027,0,33,0,19,52
2028,0,16,0,19,35
2029,0,34,0,18,52
2030,0,15,0,18,33
2031,0,33,0,18,51
2032,0,15,0,18,33
2033,0,35,0,16,51
2034,0,17,0,16,33
2035,0,33,0,17,50
2037,0,32,0,17,49
2039,0,33,0,18,51
2041,0,35,0,15,50
2042,0,17,0,15,32
2043,0,33,0,16,49
2044,0,18,0,16,34
2045,0,33,0,20,53
2046,0,17,0,20,37
2047,0,34,0,16,50
2048,0,14,0,16,30
2049,0,33,0,16,49
2050,0,17,0,16,33
2052,0,19,0,14,33
2054,0,16,0,18,34
2055,0,35,0,17,52
2056,0,17,0,17,34
2057,0,33,0,16,49
2058,0,16,0,16,32
2059,0,33,0,17,50
2060,0,17,0,17,34
2061,0,34,0,17,51
2062,0,17,0,17,34
2063,0,34,0,16,50
2065,0,31,0,18,49
2066,0,15,0,18,33
2068,0,16,0,16,32
2069,0,34,0,17,51
2070,0,18,0,17,35
2072,0,17,0,17,34
2074,0,17,15,16,48
2077,0,35,0,15,50
2079,0,33,0,16,49
2080,0,18,0,16,34
2081,0,33,0,18,51
2082,0,17,0,18,35
2083,0,34,0,16,50
2085,0,32,0,17,49
2086,0,16,0,17,33
2087,0,33,0,18,51
2088,0,16,0,18,34
2089,0,34,0,17,51
2091,0,33,0,17,50
2092,0,16,0,17,33
2093,0,33,0,18,51
2095,0,35,0,15,50
2098,0,17,0,18,35
2099,0,34,0,16,50
2100,0,16,0,16,32
2101,0,32,0,19,51
2102,0,16,0,19,35
2103,0,35,0,16,51
2104,0,16,0,16,32
2106,0,17,0,17,34
2108,0,15,0,18,33
2109,0,35,0,16,51
2110,0,17,0,16,33
2111,0,32,0,17,49
2112,0,16,0,17,33
2113,0,34,0,16,50
2114,0,17,0,16,33
2115,0,35,0,15,50
2116,0,19,0,15,34
2119,0,35,0,16,51
2120,0,18,0,16,34
2121,0,33,0,18,51
2122,0,17,0,18,35
2124,0,18,0,16,34
2125,0,29,0,19,48
2126,0,13,0,19,32
2127,0,35,0,15,50
2128,0,16,0,15,31
2129,0,33,0,18,51
2130,0,18,0,18,36
2131,0,33,0,16,49
2132,0,15,0,16,31
2133,0,33,0,17,50
2134,0,17,0,17,34
2136,0,16,0,18,34
2137,0,34,0,18,52
2138,0,16,0,18,34
2139,0,33,0,18,51
2140,0,15,0,18,33
2141,0,34,0,16,50
2142,0,16,0,16,32
2144,0,17,18,16,51
2145,0,34,16,17,67
2146,0,16,16,17,49
2147,0,33,0,16,49
2148,0,17,0,16,33
2150,0,18,15,18,51
2151,0,33,15,17,65
2153,0,32,0,17,49
2155,0,33,0,18,51
2157,0,36,16,16,68
2158,0,18,16,16,50
2159,0,32,0,17,49
2160,0,16,0,17,33
2162,0,16,0,17,33
2165,0,34,0,16,50
2166,0,18,0,16,34
2169,0,35,0,15,50
2171,0,34,0,15,49
2172,0,19,0,15,34
2173,0,33,16,16,65
2174,0,18,16,16,50
2175,0,32,17,17,66
2178,0,17,0,16,33
2179,0,34,0,17,51
2180,0,18,0,17,35
2181,0,33,0,16,49
2182,0,16,0,16,32
2183,0,33,18,16,67
2185,0,34,17,16,67
2186,0,16,17,16,49
2187,0,33,17,15,65
2188,0,16,17,15,48
2189,0,32,17,17,66
2190,0,15,17,17,49
2191,0,34,0,21,55
2192,0,17,0,21,38
2195,0,31,18,16,65
2196,0,17,18,16,51
2198,0,16,0,16,32
2199,0,33,0,17,50
2201,0,32,0,17,49
2203,0,35,0,17,52
2205,0,33,0,17,50
2206,0,16,0,17,33
2207,0,34,0,16,50
2211,0,34,0,17,51
2212,0,17,0,17,34
2213,0,34,0,15,49
2214,0,17,0,15,32
2215,0,33,0,16,49
2216,0,18,0,16,34
2217,0,32,0,18,50
2218,0,16,0,18,34
2219,0,34,0,17,51
2221,0,32,0,17,49
2222,0,15,0,17,32
2223,0,34,0,16,50
2224,0,17,0,16,33
2225,0,35,0,14,49
2228,0,19,0,16,35
2229,0,32,0,17,49
2230,0,16,0,17,33
2233,0,34,0,15,49
2234,0,17,0,15,32
2236,0,19,0,15,34
2237,0,31,0,18,49
2238,0,16,0,18,34
2240,0,16,0,17,33
2241,0,34,0,17,51
2243,0,33,0,16,49
2245,0,33,17,18,68
2246,0,17,17,18,52
2247,0,35,16,15,66
2248,0,18,16,15,49
2249,0,31,17,17,65
2250,0,15,17,17,49
2251,0,34,0,18,52
2252,0,17,0,18,35
2253,0,34,0,16,50
2255,0,33,0,18,51
2256,0,17,0,18,35
2257,0,33,0,17,50
2259,0,34,0,17,51
2261,0,32,0,17,49
2265,0,34,15,17,66
2266,0,18,15,17,50
2268,0,17,0,17,34
2270,0,17,0,15,32
2273,0,32,17,18,67
2274,0,15,17,18,50
2275,0,35,16,16,67
2276,0,18,16,16,50
2277,0,32,0,18,50
2278,0,16,0,18,34
2279,0,34,0,17,51
2280,0,16,0,17,33
2281,0,33,0,17,50
2282,0,16,0,17,33
2283,0,33,0,18,51
2284,0,16,0,18,34
2285,0,34,0,18,52
2286,0,16,0,18,34
2287,0,34,0,16,50
2289,0,33,0,16,49
2290,0,17,0,16,33
2291,0,33,0,16,49
2292,0,17,0,16,33
2293,0,32,0,18,50
2294,0,16,0,18,34
2296,0,17,0,15,32
2298,0,18,16,18,52
2299,0,34,0,17,51
2300,0,18,0,17,35
2302,0,15,0,17,32
2303,0,31,0,20,51
2305,0,37,0,15,52
2306,0,17,0,15,32
2307,0,33,17,15,65
2308,0,18,17,15,50
2309,0,32,18,16,66
2311,0,34,0,16,50
2314,0,18,16,17,51
2315,0,33,0,16,49
2316,0,17,0,16,33
2317,0,33,0,17,50
2318,0,17,0,17,34
2319,0,33,17,17,67
2320,0,16,17,17,50
2321,0,34,0,16,50
2322,0,17,0,16,33
2323,0,33,18,15,66
2324,0,17,18,15,50
2325,0,33,0,18,51
2326,0,15,0,18,33
2327,0,34,0,17,51
2330,0,16,0,17,33
2331,0,34,0,19,53
2333,0,33,0,16,49
2335,0,33,18,15,66
2336,0,17,18,15,50
2337,0,33,0,19,52
2338,0,15,0,19,34
2340,0,15,17,17,49
2341,0,34,0,15,49
2342,0,17,0,15,32
2343,0,41,0,9,50
2344,0,26,0,9,35
2345,0,25,0,16,41
2347,0,34,16,17,67
2348,0,18,16,17,51
2349,0,33,16,17,66
2350,0,17,16,17,50
2353,0,33,0,16,49
2356,0,19,0,16,35
2357,0,33,0,15,48
2358,0,17,0,15,32
2360,0,17,0,16,33
2362,0,18,0,16,34
2364,0,17,0,20,37
2365,0,33,16,18,67
2366,0,13,16,18,47
2367,0,34,0,17,51
2368,0,18,0,17,35
2369,0,34,0,15,49
2371,0,32,17,16,65
2372,0,17,17,16,50
2373,0,33,0,16,49
2374,0,16,0,16,32
2375,0,34,0,18,52
2377,0,33,0,18,51
2378,0,15,0,18,33
2379,0,34,0,16,50
2381,0,34,0,16,50
2382,0,18,0,16,34
2383,0,33,0,16,49
2384,0,17,0,16,33
2385,0,33,0,16,49
2388,0,18,0,16,34
2389,0,31,0,21,52
2390,0,15,0,21,36
2391,0,36,0,16,52
2393,0,33,0,16,49
2394,0,17,0,16,33
2395,0,32,0,18,50
2397,0,34,0,16,50
2398,0,16,0,16,32
2399,0,32,0,18,50
2400,0,16,0,18,34
2401,0,34,0,18,52
2402,0,16,0,18,34
2403,0,34,0,16,50
2404,0,16,0,16,32
2405,0,32,0,18,50
2407,0,35,0,16,51
2408,0,17,0,16,33
2409,0,32,0,17,49
2410,0,16,0,17,33
2412,0,18,0,15,33
2414,0,18,0,15,33
2415,0,33,0,15,48
2416,0,18,0,15,33
2417,0,32,0,18,50
2418,0,17,0,18,35
2419,0,33,0,17,50
2420,0,15,0,17,32
2422,0,18,0,15,33
2425,0,34,0,15,49
2426,0,17,0,15,32
2427,0,33,0,16,49
2428,0,18,0,16,34
2429,0,34,0,17,51
2430,0,18,0,17,35
2431,0,32,0,18,50
2432,0,15,0,18,33
2434,0,15,0,18,33
2435,0,34,0,18,52
2439,0,33,16,19,68
2440,0,17,16,19,52
2441,0,35,16,16,67
2442,0,19,16,16,51
2444,0,16,0,18,34
2445,0,34,0,16,50
2446,0,16,0,16,32
2450,0,18,0,17,35
2451,0,32,0,17,49
2452,0,15,0,17,32
2453,0,35,0,15,50
2454,0,18,0,15,33
2456,0,18,0,17,35
2457,0,32,0,17,49
2458,0,15,0,17,32
2460,0,17,0,17,34
2461,0,33,0,17,50
2462,0,16,0,17,33
2463,0,33,0,16,49
2465,0,34,0,16,50
2469,0,32,18,16,66
2470,0,17,18,16,51
2473,0,33,0,18,51
2474,0,17,0,18,35
2477,0,35,0,16,51
2478,0,18,0,16,34
2479,0,32,0,17,49
2480,0,16,0,17,33
2481,0,33,0,17,50
2482,0,16,0,17,33
2483,0,35,15,18,68
2484,0,18,15,18,51
2485,0,33,0,16,49
2486,0,18,0,16,34
2487,0,32,0,18,50
2488,0,16,0,18,34
2489,0,35,17,16,68
2491,0,33,0,17,50
2492,0,16,0,17,33
2493,0,34,0,14,48
2495,0,32,0,15,47
2496,0,18,0,15,33
2497,0,30,0,19,49
2502,0,17,0,16,33
2503,0,34,0,17,51
2505,0,33,17,18,68
2508,0,18,0,16,34
2510,0,15,19,15,49
2511,19,15,18,16,68
2512,0,15,18,16,49
2514,0,16,0,17,33
2515,0,33,0,18,51
2516,0,16,0,18,34
2518,0,15,0,16,31
2519,0,34,0,16,50
2520,0,18,0,16,34
2523,0,34,15,19,68
2524,0,18,15,19,52
2525,0,34,0,16,50
2526,0,19,0,16,35
2527,0,32,0,17,49
2531,0,36,16,17,69
2532,0,18,16,17,51
2534,0,17,0,16,33
2536,0,17,17,16,50
2537,0,33,0,16,49
2538,0,16,0,16,32
2540,0,16,0,17,33
2541,0,35,0,16,51
2542,0,18,0,16,34
2543,0,32,0,17,49
2544,0,16,0,17,33
2547,0,33,0,17,50
2549,0,35,0,17,52
2550,0,18,0,17,35
2552,0,14,0,19,33
2553,0,35,0,17,52
2554,0,16,0,17,33
2555,0,31,0,19,50
2556,0,14,0,19,33
2557,0,35,0,16,51
2559,0,33,0,17,50
2560,0,17,0,17,34
2561,0,34,16,18,68
2562,0,17,16,18,51
2563,16,18,0,16,50
2564,0,18,0,16,34
2566,0,17,0,17,34
2567,0,30,19,17,66
2572,0,17,0,17,34
2573,0,35,0,15,50
2574,0,18,0,15,33
2575,0,32,0,16,48
2577,0,34,0,15,49
2578,0,18,0,15,33
2579,0,32,0,17,49
2581,0,35,0,17,52
2583,0,33,0,15,48
2584,0,16,0,15,31
2586,0,18,0,17,35
2587,0,33,0,17,50
2588,0,16,0,17,33
2590,0,17,0,17,34
2591,0,32,0,17,49
2592,0,15,0,17,32
2593,0,34,0,16,50
2594,0,17,0,16,33
2595,0,34,0,15,49
2596,0,18,0,15,33
2597,0,33,17,19,69
2600,0,19,0,14,33
2602,0,17,17,15,49
2603,0,32,0,17,49
2605,0,35,0,15,50
2606,0,18,0,15,33
2607,0,33,15,19,67
2608,0,18,15,19,52
2609,0,34,0,16,50
2611,0,32,0,17,49
2612,0,16,0,17,33
2614,0,17,16,16,49
2615,0,32,0,18,50
2617,0,34,0,18,52
2618,0,16,0,18,34
2620,0,15,0,17,32
2621,0,34,17,17,68
2624,0,17,0,18,35
2625,0,34,16,16,66
2626,0,16,16,16,48
2627,0,32,0,16,48
2629,0,33,0,18,51
2630,0,17,0,18,35
2631,0,34,0,17,51
2633,0,32,0,17,49
2634,0,15,0,17,32
2635,0,35,0,16,51
2636,0,18,0,16,34
2637,0,32,0,18,50
2638,0,16,0,18,34
2639,0,34,0,16,50
2642,0,19,0,15,34
2644,0,17,0,17,34
2645,0,33,0,17,50
2646,0,16,0,17,33
2648,0,17,0,16,33
2649,0,32,0,17,49
2650,0,16,0,17,33
2652,0,17,0,17,34
2653,0,32,0,18,50
2654,0,15,0,18,33
2655,0,34,0,16,50
2656,0,16,0,16,32
2657,0,34,0,17,51
2658,0,18,0,17,35
2660,0,16,0,17,33
2661,0,35,0,16,51
2662,0,18,0,16,34
2663,0,32,17,16,65
2664,0,16,17,16,49
2666,0,16,0,16,32
2667,0,32,0,19,51
2669,0,35,0,17,52
2670,0,16,0,17,33
2673,0,32,0,17,49
2674,0,15,0,17,32
2675,0,35,0,15,50
2676,0,18,0,15,33
2677,0,32,0,18,50
2680,0,16,0,16,32
2681,0,32,0,18,50
2682,0,16,0,18,34
2683,0,35,17,15,67
2685,0,32,0,20,52
2686,0,15,0,20,35
2687,0,34,0,16,50
2688,0,14,0,16,30
2691,0,32,0,18,50
2692,0,16,0,18,34
2693,0,35,0,15,50
2694,0,17,0,15,32
2696,0,18,16,16,50
2697,0,32,0,18,50
2698,0,16,0,18,34
2699,0,33,0,20,53
2700,0,15,0,20,35
2701,0,33,0,17,50
2702,0,13,0,17,30
2703,0,35,17,17,69
2704,0,18,17,17,52
2705,0,34,0,17,51
2706,0,17,0,17,34
2709,0,35,0,15,50
2710,0,18,0,15,33
2712,0,18,0,16,34
2713,0,33,0,15,48
2714,0,17,0,15,32
2715,0,34,0,16,50
2717,0,32,0,16,48
2718,0,16,0,16,32
2719,0,34,0,17,51
2720,0,18,0,17,35
2722,0,16,0,17,33
2724,0,17,0,16,33
2725,0,33,17,15,65
2727,0,32,0,17,49
2728,0,15,0,17,32
2730,0,18,0,14,32
2735,0,38,0,12,50
2737,0,29,0,16,45
2738,0,17,0,16,33
2739,0,33,0,17,50
2740,0,17,0,17,34
2742,0,18,0,15,33
2743,0,32,0,17,49
2744,0,17,0,17,34
2745,0,34,0,16,50
2747,0,34,0,16,50
2748,0,18,0,16,34
2750,0,17,0,17,34
2752,0,17,0,15,32
2753,0,33,0,16,49
2754,0,18,0,16,34
2755,0,32,0,18,50
2757,0,33,0,18,51
2758,0,15,0,18,33
2759,0,34,0,17,51
2760,0,16,0,17,33
2761,0,35,0,16,51
2763,0,32,0,17,49
2764,0,16,0,17,33
2766,0,16,0,18,34
2767,0,33,0,16,49
2771,0,33,0,18,51
2774,0,17,15,17,49
2775,0,32,20,14,66
2776,0,17,20,14,51
2777,0,34,0,17,51
2778,0,14,0,17,31
2779,0,32,19,16,67
2780,0,15,19,16,50
2781,0,35,0,18,53
2782,0,16,0,18,34
2783,0,34,17,15,66
2784,0,16,17,15,48
2785,0,32,0,18,50
2786,0,15,0,18,33
2787,0,33,0,16,49
2788,0,15,0,16,31
2789,0,34,0,18,52
2793,0,34,0,18,52
2794,0,16,0,18,34
2795,0,33,0,18,51
2797,0,34,0,15,49
2798,0,16,0,15,31
2799,0,32,0,19,51
2800,0,17,0,19,36
2802,0,15,15,19,49
2803,0,34,0,18,52
2804,0,19,0,18,37
2805,0,32,17,19,68
2806,0,14,17,19,50
2809,0,33,0,16,49
2810,0,15,0,16,31
2811,0,31,0,18,49
2812,0,15,0,18,33
2814,0,18,0,16,34
2815,0,33,0,16,49
2816,0,17,0,16,33
2817,0,32,17,17,66
2818,0,16,17,17,50
2821,0,32,0,18,50
2822,0,15,0,18,33
2823,0,33,0,18,51
2825,0,35,0,16,51
2827,0,33,0,17,50
2828,0,17,0,17,34
2831,0,33,0,18,51
2832,0,17,0,18,35
2833,0,34,0,16,50
2834,0,16,0,16,32
2836,0,19,15,18,52
2837,0,33,0,16,49
2838,0,18,0,16,34
2839,0,33,0,15,48
2841,0,32,0,19,51
2842,0,17,0,19,36
2843,0,34,0,17,51
2844,0,15,0,17,32
2845,0,38,12,16,66
2846,0,21,12,16,49
2847,0,28,0,18,46
2848,0,16,0,18,34
2849,0,34,17,15,66
2850,0,16,17,15,48
2851,0,32,17,19,68
2852,0,15,17,19,51
2853,0,36,15,19,70
2855,0,34,0,15,49
2856,0,19,0,15,34
2857,0,31,0,16,47
2859,0,33,20,13,66
2860,0,17,20,13,50
2862,0,13,20,14,47
2863,0,34,0,19,53
2865,0,35,16,15,66
2866,0,16,16,15,47
2867,0,31,0,18,49
2869,0,35,0,16,51
2870,0,17,0,16,33
2871,0,34,0,16,50
2873,0,33,0,15,48
2874,0,17,0,15,32
2876,0,18,0,15,33
2877,0,34,0,15,49
2878,0,19,0,15,34
2879,0,32,0,17,49
2880,0,17,0,17,34
2882,0,16,15,20,51
2883,0,35,0,15,50
2886,0,16,18,16,50
2887,0,34,0,16,50
2888,0,16,0,16,32
2890,0,19,0,16,35
2892,0,16,0,17,33
2896,0,17,0,17,34
2900,0,16,0,15,31
2901,0,34,0,15,49
2903,0,31,0,17,48
2904,0,16,0,17,33
2906,0,18,0,17,35
2907,0,33,0,17,50
2909,0,34,0,15,49
2910,0,17,0,15,32
2911,0,32,0,17,49
2912,0,17,0,17,34
2913,0,34,0,17,51
2914,0,17,0,17,34
2915,0,33,0,17,50
2917,0,32,0,18,50
2918,0,15,0,18,33
2920,0,17,0,16,33
2922,0,17,0,17,34
2923,0,33,0,17,50
2924,0,16,0,17,33
2925,0,34,0,17,51
2927,0,32,0,18,50
2928,0,15,0,18,33
2929,0,35,0,16,51
2930,0,17,0,16,33
2931,0,33,0,18,51
2932,0,17,0,18,35
2933,0,33,0,16,49
2934,0,15,0,16,31
2935,0,33,0,17,50
2936,0,17,0,17,34
2938,0,16,0,18,34
2941,0,35,0,16,51
2942,0,16,0,16,32
2943,0,33,0,16,49
2944,0,17,0,16,33
2946,0,18,0,16,34
2947,0,34,0,14,48
2948,0,18,0,14,32
2949,0,31,0,17,48
2952,0,16,0,17,33
2955,0,32,0,16,48
2957,0,33,0,17,50
2958,0,17,0,17,34
2959,0,33,0,16,49
2960,0,16,0,16,32
2961,0,34,0,16,50
2962,0,18,0,16,34
2963,0,34,0,16,50
2964,0,18,0,16,34
2965,0,33,0,17,50
2966,0,17,0,17,34
2968,0,16,0,17,33
2969,0,33,0,16,49
2972,0,18,0,16,34
2974,0,17,0,17,34
2975,0,32,0,17,49
2976,0,15,0,17,32
2977,0,35,0,15,50
2978,0,18,0,15,33
2980,0,16,0,18,34
2981,0,34,0,18,52
2982,0,16,0,18,34
2983,0,35,0,15,50
2984,0,17,0,15,32
2985,0,33,0,17,50
2987,0,33,0,18,51
2989,0,35,0,14,49
2990,0,17,0,14,31
2991,0,35,0,13,48
2994,0,18,0,16,34
2995,0,32,0,17,49
2996,0,16,0,17,33
2997,0,35,0,15,50
2998,0,18,0,15,33
3000,0,18,0,17,35
3001,0,32,0,17,49
3003,0,33,0,17,50
3006,0,17,0,17,34
3007,0,33,0,17,50
3009,0,34,0,16,50
3010,0,17,0,16,33
3011,0,33,0,16,49
3012,0,17,0,16,33
3014,0,17,0,18,35
3015,0,34,0,16,50
3016,0,16,0,16,32
3019,0,33,16,17,66
3020,0,17,16,17,50
3022,0,17,0,16,33
3023,0,32,18,16,66
3024,0,16,18,16,50
3026,0,16,0,17,33
3027,0,34,0,16,50
3028,0,17,0,16,33
3029,0,34,0,16,50
3031,0,32,0,16,48
3032,0,16,0,16,32
3033,0,34,0,17,51
3035,0,32,0,17,49
3036,0,15,0,17,32
3037,0,34,0,18,52
3038,0,17,0,18,35
3040,0,17,0,15,32
3041,0,32,0,16,48
3043,0,34,0,16,50
3044,0,18,0,16,34
3045,0,32,0,16,48
3047,0,35,0,16,51
3048,0,19,0,16,35
3050,0,16,0,17,33
3051,0,33,0,17,50
3052,0,16,0,17,33
3053,0,33,0,15,48
3054,0,16,0,15,31
3056,0,19,0,17,36
3058,0,16,0,17,33
3061,0,33,0,16,49
3062,0,16,0,16,32
3063,0,35,0,15,50
3064,0,19,0,15,34
3065,0,32,0,16,48
3066,0,17,0,16,33
3068,0,18,0,18,36
3071,0,32,0,18,50
3072,0,15,0,18,33
3073,0,35,0,16,51
3074,0,17,0,16,33
3075,0,32,0,18,50
3076,0,16,0,18,34
3078,0,15,0,17,32
3079,0,35,0,16,51
3082,0,16,0,17,33
3083,0,35,0,15,50
3084,0,18,0,15,33
3085,0,32,0,18,50
3086,0,17,0,18,35
3088,0,16,0,16,32
3089,0,32,0,18,50
3090,0,16,0,18,34
3093,0,34,0,16,50
3094,0,17,0,16,33
3095,0,33,0,16,49
3097,0,33,0,17,50
3098,0,17,0,17,34
3099,0,34,0,18,52
3100,0,17,0,18,35
3101,0,33,0,18,51
3103,0,34,0,16,50
3104,0,16,0,16,32
3105,0,34,0,16,50
3106,0,18,0,16,34
3107,0,32,0,20,52
3108,0,16,0,20,36
3109,0,33,0,18,51
3110,0,13,0,18,31
3111,0,35,0,17,52
3112,0,17,0,17,34
3113,0,34,0,16,50
3114,0,17,0,16,33
3116,0,15,0,17,32
3117,0,34,0,17,51
3118,0,17,0,17,34
3119,0,34,0,17,51
3121,0,37,0,13,50
3122,0,20,0,13,33
3123,0,30,16,17,63
3125,0,33,0,16,49
3126,0,17,0,16,33
3127,0,34,0,15,49
3128,0,18,0,15,33
3129,0,41,0,7,48
3130,0,26,0,7,33
3132,19,34,0,17,70
3133,0,34,0,17,51
3134,0,18,0,17,35
3136,0,15,0,18,33
3138,0,18,0,15,33
3139,0,31,0,16,47
3140,0,16,0,16,32
3142,0,18,0,17,35
3146,0,16,0,18,34
3147,0,35,0,15,50
3149,0,33,0,16,49
3150,0,18,0,16,34
3151,0,32,0,19,51
3152,0,16,0,19,35
3153,0,34,0,16,50
3155,0,34,0,18,52
3157,0,30,0,19,49
3158,0,12,0,19,31
3159,0,36,0,17,53
3161,0,33,0,18,51
3164,0,17,0,16,33
3165,0,33,0,14,47
3167,0,34,0,15,49
3168,0,20,0,15,35
3169,0,30,0,18,48
3170,0,15,0,18,33
3172,0,17,0,16,33
3175,0,33,0,18,51
3176,0,15,0,18,33
3177,0,33,0,18,51
3178,0,15,0,18,33
3180,0,16,0,18,34
3182,0,16,0,17,33
3183,0,32,0,18,50
3184,0,15,0,18,33
3185,0,34,0,18,52
3187,0,34,0,17,51
3188,0,16,0,17,33
3189,0,34,0,15,49
3192,0,18,0,16,34
3193,0,34,0,14,48
3196,0,19,0,15,34
3199,0,32,0,18,50
3201,0,34,0,17,51
3202,0,16,0,17,33
3203,0,33,0,17,50
3204,0,16,0,17,33
3206,0,16,0,18,34
3207,0,35,0,15,50
3208,0,17,0,15,32
3211,0,33,0,17,50
3212,0,17,0,17,34
3214,0,17,0,17,34
3216,0,16,0,16,32
3217,0,33,0,18,51
3218,0,17,0,18,35
3219,0,35,16,16,67
3220,0,17,16,16,49
3221,0,32,0,17,49
3222,0,16,0,17,33
3224,0,17,16,17,50
3225,0,33,0,17,50
3226,0,17,0,17,34
3227,0,34,0,15,49
3228,0,17,0,15,32
3229,0,33,0,17,50
3231,0,33,0,17,50
3232,0,16,0,17,33
3233,0,33,0,18,51
3234,0,16,0,18,34
3235,0,34,0,16,50
3236,0,16,0,16,32
3238,0,17,0,16,33
3239,0,33,0,17,50
3241,0,34,0,16,50
3242,0,17,0,16,33
3243,0,32,0,17,49
3244,0,16,0,17,33
3245,0,34,0,17,51
3247,0,33,0,17,50
3249,0,35,15,16,66
3250,0,18,15,16,49
3252,0,16,0,17,33
3256,0,18,0,16,34
3258,0,15,0,17,32
3259,0,35,0,16,51
3262,0,15,0,16,31
3263,0,33,0,19,52
3265,0,34,0,16,50
3267,0,33,0,16,49
3269,0,34,0,16,50
3270,0,18,0,16,34
3271,0,32,0,16,48
3272,0,16,0,16,32
3273,0,34,0,16,50
3274,0,18,0,16,34
3275,0,32,0,18,50
3277,0,35,0,16,51
3278,0,17,0,16,33
3279,0,32,0,19,51
3280,0,16,0,19,35
3281,0,34,0,17,51
3282,0,15,0,17,32
3283,17,16,0,17,50
3284,0,16,0,17,33
3286,0,17,0,17,34
3287,0,33,0,16,49
3288,0,16,0,16,32
3289,0,33,0,16,49
3290,0,17,0,16,33
3291,0,34,0,16,50
3293,0,33,16,18,67
3294,0,17,16,18,51
3295,0,34,0,16,50
3296,0,18,0,16,34
3297,0,33,0,17,50
3298,0,17,0,17,34
3299,0,33,0,17,50
3300,0,16,0,17,33
3301,0,32,0,16,48
3304,0,19,0,17,36
3306,0,17,0,15,32
3307,0,33,0,16,49
3309,0,33,0,16,49
3310,0,17,0,16,33
3311,0,34,0,16,50
3312,0,18,0,16,34
3314,0,16,0,18,34
3315,0,34,0,16,50
3316,0,16,0,16,32
3317,0,33,0,18,51
3318,0,17,0,18,35
3319,0,33,0,17,50
3321,0,34,0,16,50
3322,0,17,0,16,33
3324,0,17,0,17,34
3326,0,16,0,16,32
3327,0,33,0,17,50
3328,0,17,0,17,34
3330,0,17,0,18,35
3331,0,35,0,15,50
3332,0,17,0,15,32
3333,0,32,0,17,49
3334,0,17,0,17,34
3335,0,34,0,15,49
3336,0,17,0,15,32
3342,0,17,0,17,34
3343,0,33,0,17,50
3344,0,16,0,17,33
3345,0,34,0,17,51
3346,0,17,0,17,34
3348,0,17,0,15,32
3349,0,34,0,16,50
3350,0,19,0,16,35
3352,0,18,0,14,32
3353,0,33,13,17,63
3354,0,19,13,17,49
3355,0,30,0,18,48
3356,0,17,0,18,35
3357,0,36,0,16,52
3358,0,18,0,16,34
3360,0,16,0,16,32
3362,0,19,0,16,35
3364,0,16,17,16,49
3366,0,16,0,17,33
3367,0,34,0,16,50
3368,0,17,0,16,33
3369,0,33,0,16,49
3370,0,17,0,16,33
3371,0,34,0,16,50
3372,0,18,0,16,34
3373,0,34,0,16,50
3374,0,18,0,16,34
3376,0,15,17,17,49
3377,0,34,0,17,51
3378,0,17,0,17,34
3379,0,33,0,17,50
3381,0,33,0,18,51
3383,0,35,0,15,50
3384,0,17,0,15,32
3385,0,33,15,18,66
3386,0,18,15,18,51
3387,0,33,0,16,49
3388,0,18,0,16,34
3393,0,32,0,18,50
3396,0,14,0,17,31
3397,0,34,0,17,51
3398,0,17,0,17,34
3399,0,34,0,19,53
3400,0,17,0,19,36
3401,0,35,0,16,51
3402,0,16,0,16,32
3403,0,32,0,16,48
3404,0,16,0,16,32
3406,0,17,0,16,33
3407,0,34,0,17,51
3408,0,18,0,17,35
3409,0,32,0,18,50
3410,0,15,0,18,33
3411,0,34,0,16,50
3413,0,34,0,15,49
3415,0,32,0,17,49
3417,0,34,0,16,50
3419,0,33,0,16,49
3420,0,17,0,16,33
3421,0,33,0,18,51
3422,0,17,0,18,35
3423,0,32,0,19,51
3424,0,14,0,19,33
3425,0,35,0,18,53
3427,0,35,0,16,51
3428,0,17,0,16,33
3430,0,17,0,15,32
3431,0,32,0,18,50
3432,0,17,0,18,35
3434,0,15,0,17,32
3435,0,34,0,15,49
3436,0,17,0,15,32
3438,0,18,0,17,35
3439,17,17,0,17,51
3441,0,34,0,16,50
3442,0,17,0,16,33
3443,0,33,0,15,48
3444,0,17,0,15,32
3445,0,33,0,16,49
3447,0,33,0,17,50
3448,0,17,0,17,34
3450,0,17,0,13,30
3451,0,34,0,15,49
3452,0,21,0,15,36
3453,0,31,0,18,49
3454,0,16,0,18,34
3455,0,34,0,17,51
3456,0,16,0,17,33
3458,0,17,0,17,34
3459,0,32,0,18,50
3460,0,15,0,18,33
3461,0,34,0,18,52
3462,0,16,0,18,34
3463,0,34,0,16,50
3464,0,16,0,16,32
3465,0,33,0,17,50
3466,0,17,0,17,34
3467,0,33,0,16,49
3468,0,16,0,16,32
3469,0,33,0,18,51
3470,0,17,0,18,35
3473,0,33,0,16,49
3474,0,17,0,16,33
3475,0,35,0,16,51
3477,0,33,0,16,49
3478,0,17,0,16,33
3479,0,32,0,17,49
3480,0,16,0,17,33
3484,0,16,0,17,33
3485,0,33,0,18,51
3489,0,30,16,16,62
3490,0,17,16,16,49
3491,0,32,0,18,50
3492,0,16,0,18,34
3493,0,34,0,17,51
3494,0,16,0,17,33
3495,0,33,0,18,51
3496,0,16,0,18,34
3498,0,16,17,17,50
3500,0,17,0,17,34
3502,0,16,0,17,33
3505,0,33,0,16,49
3506,0,17,0,16,33
3508,0,17,0,17,34
3509,0,35,0,16,51
3510,0,18,0,16,34
3511,0,33,0,17,50
3513,0,32,0,18,50
3515,0,33,0,19,52
3520,0,17,16,18,51
3524,0,16,0,15,31
3527,0,34,0,18,52
3529,0,33,0,16,49
3530,0,15,0,16,31
3532,0,19,16,17,52
3533,0,33,0,16,49
3534,0,17,0,16,33
3537,0,34,0,17,51
3538,0,17,0,17,34
3541,0,33,0,16,49
3542,0,17,0,16,33
3543,0,33,0,18,51
3545,0,33,0,17,50
3546,0,15,0,17,32
3547,0,34,0,17,51
3550,0,15,0,18,33
3551,0,33,0,17,50
3553,0,35,0,16,51
3554,0,18,0,16,34
3555,0,32,0,17,49
3556,0,16,0,17,33
3557,0,35,0,17,52
3558,0,18,0,17,35
3559,0,32,0,19,51
3560,0,15,0,19,34
3561,0,35,0,14,49
3563,0,37,0,12,49
3564,0,23,0,12,35
3565,0,29,0,17,46
3566,0,17,0,17,34
3567,0,32,0,17,49
3568,0,15,0,17,32
3569,0,34,0,15,49
3570,0,17,0,15,32
3571,0,35,0,15,50
3572,0,20,0,15,35
3573,0,33,0,17,50
3574,0,18,0,17,35
3575,0,31,0,17,48
3576,0,14,0,17,31
3577,0,34,0,16,50
3578,0,17,0,16,33
3579,0,30,0,19,49
3582,0,19,0,16,35
3583,0,34,0,14,48
3584,0,18,0,14,32
3586,0,19,0,15,34
3587,0,35,0,13,48
3588,0,20,0,13,33
3589,0,31,0,17,48
3590,0,18,0,17,35
3594,0,16,0,18,34
3595,0,35,0,17,52
3596,0,17,0,17,34
3597,0,32,0,19,51
3598,0,15,0,19,34
3599,0,34,0,18,52
3600,0,15,0,18,33
3601,0,32,0,18,50
3602,0,14,0,18,32
3603,0,34,18,16,68
3607,0,35,0,16,51
3608,0,18,0,16,34
3609,0,31,0,15,46
3610,0,15,0,15,30
3612,0,20,0,16,36
3613,0,33,0,15,48
3615,0,33,0,16,49
3619,0,33,0,17,50
3620,0,15,0,17,32
3621,0,35,0,15,50
3622,0,18,0,15,33
3624,0,20,0,13,33
3625,0,30,0,18,48
3627,0,35,0,17,52
3629,0,32,0,19,51
3630,0,15,0,19,34
3632,0,16,0,16,32
3633,0,30,0,20,50
3635,0,37,15,17,69
3636,0,17,15,17,49
3637,0,32,0,16,48
3638,0,17,0,16,33
3640,0,17,0,16,33
3641,16,16,30,21,83
3643,0,30,0,21,51
3644,0,35,19,17,71
3645,17,14,19,17,67
3647,0,36,0,16,52
3649,0,33,0,16,49
3650,0,17,0,16,33
3651,16,17,0,17,50
3652,0,17,0,17,34
3655,0,33,0,17,50
3657,0,34,0,17,51
3658,0,17,0,17,34
3660,0,19,0,13,32
3661,0,30,0,17,47
3663,0,33,0,16,49
3664,0,16,0,16,32
3665,0,33,0,17,50
3666,0,17,0,17,34
3667,0,34,0,16,50
3668,0,17,0,16,33
3669,0,32,0,18,50
3670,0,16,0,18,34
3671,0,33,19,15,67
3672,0,15,19,15,49
3676,0,19,16,16,51
3678,0,16,0,16,32
3679,0,33,0,18,51
3680,0,17,0,18,35
3681,0,34,0,17,51
3682,0,16,0,17,33
3683,0,32,0,18,50
3684,0,15,0,18,33
3686,0,17,0,17,34
3688,0,17,0,15,32
3689,0,33,0,15,48
3690,0,18,0,15,33
3691,0,32,0,16,48
3692,0,17,0,16,33
3693,0,34,0,18,52
3696,0,15,0,17,32
3701,0,34,0,17,51
3702,0,17,0,17,34
3703,0,34,0,15,49
3704,0,17,0,15,32
3705,0,34,0,15,49
3707,0,32,0,16,48
3708,0,17,0,16,33
3713,0,32,0,17,49
3714,0,17,0,17,34
3715,0,33,0,18,51
3716,0,16,0,18,34
3717,0,34,0,16,50
3718,0,16,0,16,32
3722,0,17,0,16,33
3723,0,32,17,18,67
3724,0,16,17,18,51
3726,0,18,0,17,35
3727,0,32,0,18,50
3729,0,35,0,16,51
3731,0,32,0,17,49
3733,0,33,0,16,49
3735,0,34,0,18,52
3737,0,33,0,18,51
3739,0,34,0,16,50
3740,0,16,0,16,32
3742,0,18,0,16,34
3743,0,32,0,16,48
3744,0,16,0,16,32
3745,0,34,0,17,51
3746,0,18,0,17,35
3749,0,35,0,15,50
3752,0,17,0,17,34
3756,0,17,0,16,33
3758,0,17,18,16,51
3759,0,34,17,15,66
3760,0,16,17,15,48
3761,0,32,0,17,49
3762,0,15,0,17,32
3763,0,36,0,15,51
3764,0,19,0,15,34
3765,0,31,0,17,48
3766,0,16,0,17,33
3767,0,33,0,17,50
3768,0,16,0,17,33
3769,0,34,0,18,52
3773,0,33,0,15,48
3774,0,17,0,15,32
3778,0,18,0,18,36
3780,0,16,0,15,31
3782,0,16,0,18,34
3783,0,35,0,16,51
3784,0,17,0,16,33
3786,0,16,0,17,33
3788,0,17,0,16,33
3789,0,34,0,16,50
3790,0,18,0,16,34
3792,0,17,0,16,33
3793,0,34,0,15,49
3794,0,18,0,15,33
3795,0,32,0,17,49
3796,0,17,0,17,34
3798,0,16,0,17,33
3799,0,33,0,18,51
3800,0,16,0,18,34
3801,0,35,17,16,68
3802,0,17,17,16,50
3803,0,33,0,17,50
3804,0,16,0,17,33
3805,0,32,18,16,66
3806,0,15,18,16,49
3807,0,34,0,16,50
3808,0,16,0,16,32
3809,0,32,0,18,50
3810,0,16,0,18,34
3812,0,16,0,17,33
3813,0,34,0,15,49
3814,0,17,0,15,32
3815,0,33,0,18,51
3816,0,18,0,18,36
3817,0,34,0,15,49
3821,0,32,0,19,51
3822,0,16,0,19,35
3823,0,34,0,17,51
3825,0,34,0,18,52
3827,0,32,0,18,50
3828,0,14,0,18,32
3830,0,16,0,17,33
3832,0,17,0,16,33
3833,0,32,19,16,67
3834,0,16,19,16,51
3836,0,16,0,16,32
3837,0,34,0,15,49
3838,0,18,0,15,33
3839,0,33,0,15,48
3841,0,32,0,18,50
3843,0,33,0,16,49
3844,0,15,0,16,31
3846,0,19,0,17,36
3847,0,33,0,14,47
3849,0,32,0,18,50
3853,0,35,0,15,50
3854,0,18,0,15,33
3855,0,32,0,16,48
3856,0,17,0,16,33
3857,0,32,0,18,50
3859,0,34,0,16,50
3860,0,16,0,16,32
3861,0,35,0,15,50
3865,0,32,0,17,49
3867,0,33,0,16,49
3868,0,16,0,16,32
3869,0,34,0,19,53
3870,0,18,0,19,37
3871,0,34,15,17,66
3873,0,32,0,18,50
3875,0,34,0,17,51
3876,0,16,0,17,33
3877,0,33,0,17,50
3879,0,34,0,17,51
3880,0,17,0,17,34
3881,0,34,0,17,51
3882,0,17,0,17,34
3884,0,17,0,15,32
3885,0,32,0,16,48
3887,0,33,17,17,67
3888,0,17,17,17,51
3889,0,34,0,16,50
3890,0,17,0,16,33
3891,0,35,0,15,50
3892,0,19,0,15,34
3894,0,17,0,17,34
3895,0,31,0,18,49
3897,0,35,0,16,51
3898,0,17,0,16,33
3899,0,34,0,15,49
3900,0,18,0,15,33
3901,0,32,0,17,49
3902,0,17,0,17,34
3903,0,33,0,18,51
3904,0,16,0,18,34
3905,0,34,0,16,50
3907,0,34,0,15,49
3911,0,33,0,16,49
3912,0,19,0,16,35
3913,0,31,0,17,48
3914,0,15,0,17,32
3915,0,34,0,16,50
3916,0,17,0,16,33
3918,0,17,0,17,34
3919,0,34,0,17,51
3921,0,34,0,16,50
3924,0,18,0,15,33
3925,0,32,0,18,50
3927,0,33,0,19,52
3928,0,15,0,19,34
3929,0,35,0,16,51
3930,0,16,0,16,32
3931,0,31,0,19,50
3932,0,15,0,19,34
3933,0,35,0,17,52
3934,0,16,0,17,33
3935,0,33,0,17,50
3936,0,16,0,17,33
3937,0,33,0,17,50
3939,0,33,0,18,51
3940,0,16,0,18,34
3941,0,34,0,18,52
3942,0,16,0,18,34
3943,0,34,0,17,51
3945,0,33,0,17,50
3946,0,16,0,17,33
3947,0,34,16,16,66
3949,0,32,0,17,49
3950,0,16,0,17,33
3951,0,33,0,20,53
3952,0,16,0,20,36
3953,0,33,17,18,68
3955,0,35,0,16,51
3956,0,18,0,16,34
3957,0,32,0,18,50
3959,0,36,0,15,51
3961,0,31,0,17,48
3962,0,16,0,17,33
3963,0,33,0,18,51
3964,0,16,0,18,34
3965,0,34,0,17,51
3966,0,16,0,17,33
3967,0,34,0,16,50
3969,0,34,0,15,49
3972,0,18,0,15,33
3974,0,19,0,16,35
3976,0,16,0,18,34
3977,0,34,0,16,50
3978,0,16,0,16,32
3979,0,33,0,16,49
3980,0,17,0,16,33
3981,0,33,0,18,51
3982,0,17,0,18,35
3984,0,16,0,17,33
3986,0,17,0,15,32
3987,0,33,0,17,50
3990,0,15,0,17,32
3991,0,35,0,15,50
3994,0,17,0,17,34
3995,0,34,0,17,51
3997,0,32,0,18,50
3999,0,33,0,18,51
4000,0,15,0,18,33
4001,0,36,0,14,50
4002,0,18,0,14,32
4003,0,31,0,18,49
4004,0,17,0,18,35
4005,0,33,0,17,50
4006,0,15,0,17,32
4008,0,17,0,18,35
4009,0,35,0,16,51
4010,0,17,0,16,33
4011,0,32,0,18,50
4013,0,33,0,18,51
4015,0,34,0,17,51
4020,0,18,0,16,34
4021,0,35,0,18,53
4022,0,19,0,18,37
4024,0,14,0,14,28
4026,0,18,0,16,34
4027,0,34,0,17,51
4029,0,33,0,17,50
4031,0,34,0,15,49
4032,0,17,0,15,32
4033,0,33,0,17,50
4035,0,34,0,16,50
4036,0,17,0,16,33
4038,0,16,0,18,34
4040,0,17,0,16,33
4041,0,33,0,17,50
4042,0,17,0,17,34
4043,0,31,0,17,48
4045,0,35,0,15,50
4046,0,18,0,15,33
4047,0,32,0,18,50
4048,0,17,0,18,35
4049,0,35,0,15,50
4050,0,17,0,15,32
4051,0,34,0,21,55
4052,0,19,0,21,40
4053,21,11,17,17,66
4054,0,11,17,17,45
4055,17,17,0,16,50
4056,0,17,0,16,33
4058,0,18,0,15,33
4060,0,17,0,17,34
4061,0,34,0,16,50
4062,0,17,0,16,33
4063,0,32,0,17,49
4064,0,16,0,17,33
4065,0,35,0,16,51
4066,0,18,0,16,34
4068,0,17,0,16,33
4071,0,33,0,19,52
4072,0,15,0,19,34
4076,0,18,0,14,32
4077,0,31,0,17,48
4079,0,34,0,16,50
4081,0,34,0,16,50
4083,0,32,0,17,49
4085,0,34,0,17,51
4086,0,17,0,17,34
4087,0,33,0,17,50
4089,0,34,0,16,50
4093,0,33,0,17,50
4095,0,34,0,18,52
4096,0,17,0,18,35
4097,0,33,0,17,50
4099,0,33,0,18,51
4100,0,16,0,18,34
4101,0,34,0,15,49
4103,0,34,0,15,49
4104,0,19,0,15,34
4105,0,33,0,17,50
4106,0,18,0,17,35
4107,0,32,0,17,49
4108,0,15,0,17,32
4109,0,35,0,15,50
4110,0,18,0,15,33
4111,0,33,0,17,50
4112,0,18,0,17,35
4113,0,33,0,18,51
4115,0,33,0,18,51
4116,0,15,0,18,33
4117,0,34,0,16,50
4118,0,16,0,16,32
4120,0,17,0,17,34
4122,0,16,0,18,34
4123,0,33,0,17,50
4124,0,15,0,17,32
4126,0,18,0,15,33
4127,0,33,0,17,50
4128,0,18,0,17,35
4129,0,34,0,16,50
4130,0,17,0,16,33
4131,0,31,0,17,48
4132,0,15,0,17,32
4133,0,34,17,17,68
4134,0,17,17,17,51
4135,0,34,0,15,49
4136,0,17,0,15,32
4137,0,34,0,16,50
4138,0,19,0,16,35
4141,0,32,0,19,51
4143,0,35,0,16,51
4145,0,33,0,15,48
4147,0,34,0,15,49
4148,0,19,0,15,34
4149,0,33,0,17,50
4150,0,18,0,17,35
4151,0,32,0,17,49
4154,0,16,0,18,34
4155,0,33,0,16,49
4157,0,34,0,16,50
4159,0,33,0,18,51
4160,0,17,0,18,35
4162,0,15,0,16,31
4163,0,34,17,18,69
4164,0,18,17,18,53
4165,0,35,0,16,51
4166,0,18,0,16,34
4167,0,33,0,15,48
4168,0,17,0,15,32
4169,0,33,15,19,67
4170,0,18,15,19,52
4171,0,34,0,17,51
4174,0,16,15,18,49
4175,0,33,0,15,48
4177,0,34,0,16,50
4179,0,32,0,17,49
4180,0,16,0,17,33
4181,0,34,0,15,49
4183,0,33,17,18,68
4184,0,18,17,18,53
4185,0,35,0,15,50
4187,0,31,0,20,51
4190,0,12,0,18,30
4191,0,36,0,16,52
4192,0,18,0,16,34
4194,0,16,0,16,32
4195,0,32,0,17,49
4196,0,16,0,17,33
4197,0,34,0,19,53
4199,0,36,0,15,51
4200,0,17,0,15,32
4203,0,32,0,17,49
4204,0,16,0,17,33
4205,0,34,0,18,52
4206,0,17,0,18,35
4208,0,15,0,17,32
4209,0,35,0,16,51
4210,0,18,0,16,34
4211,0,32,0,18,50
4213,0,34,0,16,50
4214,0,16,0,16,32
4215,0,34,0,15,49
4217,0,32,18,15,65
4218,0,17,18,15,50
4219,0,33,0,17,50
4221,0,35,0,16,51
4222,0,18,0,16,34
4223,0,31,0,19,50
4225,0,34,0,16,50
4226,0,15,0,16,31
4227,0,34,0,18,52
4228,0,18,0,18,36
4229,0,33,0,16,49
4230,0,15,0,16,31
4231,0,35,0,15,50
4232,0,19,0,15,34
4236,0,17,0,19,36
4237,0,32,0,17,49
4239,0,35,0,15,50
4240,0,18,0,15,33
4243,0,32,0,17,49
4244,0,16,0,17,33
4245,0,34,17,16,67
4246,0,17,17,16,50
4247,0,33,0,16,49
4249,0,34,0,17,51
4250,0,18,0,17,35
4251,17,15,0,17,49
4252,0,15,0,17,32
4253,0,34,0,16,50
4254,0,17,0,16,33
4255,0,33,0,17,50
4256,0,17,0,17,34
4257,0,35,0,15,50
4259,0,31,17,18,66
4260,0,16,17,18,51
4262,0,18,0,16,34
4265,15,17,0,17,49
4267,0,33,0,18,51
4268,0,16,0,18,34
4269,0,35,0,15,50
4270,0,17,0,15,32
4271,0,33,0,16,49
4272,0,18,0,16,34
4274,0,15,18,16,49
4276,0,16,0,18,34
4278,0,15,0,18,33
4280,0,17,17,15,49
4281,0,32,18,16,66
4283,0,34,0,17,51
4284,0,16,0,17,33
4286,0,17,0,17,34
4287,0,33,0,17,50
4288,0,16,0,17,33
4289,0,33,0,18,51
4290,0,16,0,18,34
4293,0,34,0,15,49
4295,0,34,0,16,50
4296,0,19,0,16,35
4297,0,34,0,15,49
4298,0,18,0,15,33
4300,0,17,0,17,34
4301,0,33,0,17,50
4303,0,34,0,16,50
4308,0,16,17,16,49
4309,0,33,0,16,49
4311,0,33,0,19,52
4312,0,17,0,19,36
4315,0,37,0,19,56
4316,0,18,0,19,37
4317,0,31,0,16,47
4318,0,12,0,16,28
4320,0,18,0,16,34
4321,0,33,0,15,48
4323,0,32,0,17,49
4324,0,17,0,17,34
4326,0,17,0,18,35
4327,0,33,0,18,51
4328,0,15,0,18,33
4329,0,33,0,18,51
4331,0,34,0,16,50
4332,0,16,0,16,32
4336,0,18,0,16,34
4337,0,34,0,16,50
4338,0,18,0,16,34
4339,0,32,0,17,49
4340,0,16,0,17,33
4342,0,17,0,17,34
4343,0,34,0,16,50
4345,0,32,0,17,49
4347,0,34,0,18,52
4348,0,17,0,18,35
4349,0,33,0,17,50
4350,0,15,0,17,32
4351,0,34,0,17,51
4354,0,15,0,17,32
4357,0,33,0,16,49
4358,0,18,0,16,34
4360,0,17,0,17,34
4361,0,33,0,17,50
4362,0,16,0,17,33
4363,0,34,0,16,50
4364,0,17,0,16,33
4365,0,34,17,15,66
4366,0,18,17,15,50
4367,0,32,0,17,49
4368,0,15,0,17,32
4370,0,16,0,18,34
4371,0,35,0,16,51
4374,0,16,18,16,50
4376,0,16,0,16,32
4379,0,35,16,17,68
4380,0,17,16,17,50
4381,0,33,0,16,49
4382,0,17,0,16,33
4383,0,34,0,16,50
4385,0,32,16,17,65
4386,0,16,16,17,49
4387,0,33,0,16,49
4389,0,34,0,18,52
4390,0,18,0,18,36
4391,0,34,0,15,49
4392,0,16,0,15,31
4394,0,18,0,16,34
4397,0,34,0,17,51
4398,0,18,0,17,35
4400,0,16,0,17,33
4401,0,33,0,16,49
4404,0,18,0,15,33
4405,0,33,0,16,49
4406,0,18,0,16,34
4407,0,32,0,18,50
4408,0,16,0,18,34
4411,0,33,0,16,49
4412,0,18,0,16,34
4413,0,32,0,19,51
4414,0,16,0,19,35
4415,0,34,0,18,52
4417,0,35,0,16,51
4419,0,32,0,18,50
4420,0,16,0,18,34
4421,0,33,0,16,49
4422,0,15,0,16,31
4424,0,18,0,16,34
4425,0,33,0,16,49
4427,0,33,0,18,51
4428,0,17,0,18,35
4429,0,33,0,17,50
4430,0,15,0,17,32
4431,0,35,0,16,51
4432,0,18,0,16,34
4434,0,16,0,17,33
4435,0,31,0,18,49
4437,0,37,0,16,53
4438,0,19,0,16,35
4439,0,32,0,18,50
4442,0,16,0,16,32
4443,0,33,0,17,50
4444,0,17,0,17,34
4445,0,33,0,17,50
4446,0,16,0,17,33
4448,0,17,0,16,33
4449,0,32,0,18,50
4450,0,16,0,18,34
4451,0,36,0,14,50
4452,0,18,0,14,32
4453,0,33,0,16,49
4454,0,19,0,16,35
4455,0,32,0,16,48
4457,0,34,0,16,50
4458,0,18,0,16,34
4460,0,17,0,17,34
4461,0,33,0,16,49
4465,0,33,0,15,48
4467,0,34,0,16,50
4468,0,19,0,16,35
4469,0,32,0,18,50
4470,0,16,0,18,34
4471,0,33,0,18,51
4472,0,15,0,18,33
4473,0,34,0,15,49
4474,0,16,0,15,31
4475,0,33,0,17,50
4477,0,34,0,17,51
4480,0,16,0,17,33
4481,0,32,0,18,50
4482,0,15,0,18,33
4483,0,34,17,17,68
4484,0,16,17,17,50
4485,0,34,16,18,68
4486,0,17,16,18,51
4487,0,34,0,17,51
4488,0,18,0,17,35
4489,0,32,0,17,49
4490,0,15,0,17,32
4491,0,34,0,16,50
4492,0,17,0,16,33
4493,0,33,17,16,66
4495,0,33,0,18,51
4497,0,33,18,16,67
4498,0,15,18,16,49
4499,0,34,0,16,50
4500,0,16,0,16,32
4501,0,34,0,16,50
4502,0,18,0,16,34
4503,0,33,17,16,66
4504,0,17,17,16,50
4505,0,33,18,16,67
4506,0,16,18,16,50
4507,0,34,0,20,54
4508,0,16,0,20,36
4509,0,32,17,17,66
4510,0,12,17,17,46
4512,0,17,0,18,35
4513,0,33,0,18,51
4517,0,34,16,17,67
4518,0,18,16,17,51
4520,0,17,0,17,34
4521,0,33,16,17,66
4522,0,16,16,17,49
4523,0,33,17,16,66
4524,0,17,17,16,50
4525,0,33,18,17,68
4526,0,16,18,17,51
4527,18,17,0,16,51
4528,0,17,0,16,33
4530,0,17,0,15,32
4533,0,34,0,15,49
4536,0,17,17,17,51
4538,0,17,0,15,32
4540,0,20,0,14,34
4542,0,18,0,18,36
4543,0,32,0,19,51
4545,0,33,0,17,50
4546,0,14,0,17,31
4547,0,35,0,17,52
4548,0,18,0,17,35
4549,0,32,0,18,50
4550,0,15,0,18,33
4551,0,35,0,16,51
4552,0,17,0,16,33
4553,0,31,0,19,50
4554,0,15,0,19,34
4555,0,34,0,17,51
4556,0,15,0,17,32
4557,0,34,0,17,51
4559,0,32,0,18,50
4560,0,15,0,18,33
4561,0,34,0,17,51
4562,0,16,0,17,33
4565,0,32,0,17,49
4566,0,15,0,17,32
4567,0,34,0,17,51
4568,0,17,0,17,34
4569,0,33,0,18,51
4571,0,35,0,16,51
4572,0,17,0,16,33
4573,0,33,0,16,49
4574,0,17,0,16,33
4575,0,33,0,15,48
4576,0,17,0,15,32
4577,0,34,17,17,68
4578,0,19,17,17,53
4581,0,32,0,16,48
4582,0,17,0,16,33
4583,0,34,0,15,49
4584,0,18,0,15,33
4585,0,33,0,16,49
4587,0,33,0,16,49
4588,0,17,0,16,33
4589,0,34,16,16,66
4590,0,18,16,16,50
4591,0,32,0,18,50
4593,0,35,0,16,51
4594,0,17,0,16,33
4595,0,33,16,17,66
4596,0,17,16,17,50
4597,0,33,0,17,50
4599,0,33,0,17,50
4601,0,34,0,16,50
4603,0,33,0,16,49
4605,0,32,0,18,50
4606,0,16,0,18,34
4607,0,35,0,15,50
4608,0,17,0,15,32
4609,0,33,0,17,50
4610,0,18,0,17,35
4611,0,34,0,15,49
4612,0,17,0,15,32
4613,0,33,0,16,49
4614,0,18,0,16,34
4615,0,32,0,17,49
4616,0,16,0,17,33
4621,0,34,0,18,52
4623,0,33,0,17,50
4624,0,15,0,17,32
4625,0,33,0,16,49
4628,0,18,0,16,34
4629,0,34,0,15,49
4630,0,18,0,15,33
4631,0,32,0,18,50
4632,0,17,0,18,35
4633,0,34,0,16,50
4634,0,16,0,16,32
4635,0,32,0,18,50
4636,0,16,0,18,34
4638,0,15,0,18,33
4641,0,34,0,16,50
4642,0,17,0,16,33
4644,0,16,17,18,51
4645,0,35,0,14,49
4646,0,18,0,14,32
4647,0,33,16,18,67
4648,0,19,16,18,53
4649,0,34,0,17,51
4650,0,18,0,17,35
4652,0,16,0,17,33
4653,0,32,0,19,51
4654,0,15,0,19,34
4656,0,16,17,16,49
4657,0,33,0,16,49
4658,0,16,0,16,32
4659,0,32,0,17,49
4660,0,16,0,17,33
4662,0,18,0,16,34
4663,0,34,0,16,50
4664,0,18,0,16,34
4666,0,16,0,17,33
4667,0,32,0,19,51
4668,0,15,0,19,34
4669,0,35,0,17,52
4670,0,16,0,17,33
4671,0,32,0,18,50
4673,0,36,14,17,67
4674,0,18,14,17,49
4675,0,31,18,16,65
4676,0,17,18,16,51
4677,0,34,0,16,50
4678,0,16,0,16,32
4679,0,35,16,14,65
4680,0,19,16,14,49
4682,0,14,0,19,33
4683,0,34,0,17,51
4684,0,15,0,17,32
4686,0,18,16,17,51
4687,0,33,0,16,49
4688,0,17,0,16,33
4689,0,34,0,15,49
4690,0,18,0,15,33
4691,0,33,0,17,50
4692,0,18,0,17,35
4694,0,15,0,16,31
4695,0,35,0,16,51
4696,0,19,0,16,35
4697,0,32,0,16,48
4698,0,16,0,16,32
4701,0,34,0,17,51
4702,0,18,0,17,35
4703,0,34,0,16,50
4704,0,17,0,16,33
4705,0,32,0,17,49
4708,0,17,0,16,33
4710,0,17,0,16,33
4711,0,33,0,17,50
4714,0,17,0,16,33
4716,0,16,0,18,34
4718,0,14,0,19,33
4719,0,35,0,17,52
4721,0,35,0,17,52
4723,0,33,0,17,50
4724,0,16,0,17,33
4725,0,33,0,17,50
4726,0,16,0,17,33
4727,0,34,0,15,49
4728,0,17,0,15,32
4729,0,33,0,16,49
4731,0,33,0,16,49
4732,0,17,0,16,33
4733,0,32,0,18,50
4735,0,37,0,15,52
4737,0,34,0,13,47
4741,0,35,0,17,52
4742,0,18,0,17,35
4743,0,33,0,17,50
4745,0,34,0,15,49
4750,0,18,0,17,35
4753,0,34,0,17,51
4754,0,17,0,17,34
4759,0,32,0,17,49
4760,0,15,0,17,32
4761,0,33,0,18,51
4762,0,16,0,18,34
4763,0,34,0,18,52
4766,0,16,0,16,32
4768,0,17,0,17,34
4770,0,17,0,15,32
4771,0,33,0,16,49
4772,0,18,0,16,34
4773,0,34,0,17,51
4774,0,18,0,17,35
4775,0,33,0,15,48
4776,0,16,0,15,31
4777,0,33,0,17,50
4778,0,18,0,17,35
4779,0,33,0,17,50
4780,0,16,0,17,33
4783,0,32,0,17,49
4784,0,16,0,17,33
4785,0,33,0,18,51
4787,0,34,20,13,67
4788,0,16,20,13,49
4789,0,33,0,18,51
4791,0,33,18,16,67
4792,0,15,18,16,49
4793,0,34,17,16,67
4794,0,16,17,16,49
4795,0,33,18,16,67
4796,0,16,18,16,50
4797,0,34,0,16,50
4799,0,35,16,15,66
4804,0,15,0,17,32
4805,0,35,16,17,68
4806,0,18,16,17,51
4808,0,17,16,16,49
4810,0,16,0,18,34
4811,0,33,18,17,68
4814,0,17,0,16,33
4815,0,33,17,16,66
4816,0,17,17,16,50
4818,0,16,16,18,50
4820,0,18,17,16,51
4821,0,33,0,17,50
4823,0,33,0,17,50
4825,0,35,0,15,50
4826,0,18,0,15,33
4827,0,32,0,16,48
4828,0,17,0,16,33
4829,0,34,0,16,50
4831,0,31,0,19,50
4833,0,34,0,18,52
4834,0,15,0,18,33
4835,0,34,0,18,52
4836,0,16,0,18,34
4837,0,34,0,17,51
4838,0,16,0,17,33
4840,0,15,0,17,32
4841,17,17,0,17,51
4842,0,17,0,17,34
4845,0,33,0,16,49
4847,0,33,0,17,50
4849,0,32,0,19,51
4850,0,15,0,19,34
4853,0,35,0,16,51
4855,0,32,0,17,49
4856,0,16,0,17,33
4857,0,34,0,16,50
4859,0,33,0,17,50
4861,0,34,0,15,49
4862,0,17,0,15,32
4864,0,18,0,17,35
4867,0,33,0,19,52
4868,0,16,0,19,35
4870,0,14,0,17,31
4871,0,35,0,15,50
4872,0,18,0,15,33
4873,0,33,0,16,49
4874,0,18,0,16,34
4877,0,34,0,18,52
4881,0,34,0,16,50
4882,0,17,0,16,33
4883,0,33,0,18,51
4884,0,17,0,18,35
4885,0,33,0,17,50
4887,0,34,0,17,51
4888,0,17,0,17,34
4889,0,33,0,17,50
4890,0,16,0,17,33
4892,0,17,17,17,51
4893,0,34,15,17,66
4894,0,17,15,17,49
4895,0,32,0,17,49
4896,0,17,0,17,34
4898,0,17,0,17,34
4899,0,31,19,16,66
4900,0,14,19,16,49
4902,0,16,0,16,32
4903,0,33,17,17,67
4904,0,17,17,17,51
4906,0,17,17,16,50
4907,0,33,0,17,50
4909,0,35,0,17,52
4911,0,33,0,14,47
4912,0,16,0,14,30
4913,0,33,17,16,66
4914,0,19,17,16,52
4915,0,33,0,16,49
4917,0,34,0,16,50
4918,0,18,0,16,34
4919,0,32,18,16,66
4920,0,16,18,16,50
4921,0,34,0,16,50
4922,0,16,0,16,32
4923,0,32,0,17,49
4924,0,16,0,17,33
4925,0,35,0,16,51
4927,0,32,17,17,66
4930,0,17,16,18,51
4931,0,34,16,17,67
4932,0,18,16,17,51
4933,0,33,0,17,50
4934,0,17,0,17,34
4935,0,33,0,17,50
4937,0,33,0,19,52
4939,0,33,0,16,49
4940,0,14,0,16,30
4942,0,18,0,17,35
4943,0,33,16,18,67
4945,0,34,0,16,50
4946,0,18,0,16,34
4949,0,34,0,17,51
4951,0,33,0,18,51
4952,0,16,0,18,34
4954,0,17,0,15,32
4955,0,31,0,17,48
4956,0,16,0,17,33
4957,0,34,0,18,52
4958,0,17,0,18,35
4960,0,17,0,16,33
4962,0,16,0,17,33
4964,0,16,0,18,34
4965,0,35,15,18,68
4966,0,17,15,18,50
4967,0,33,0,16,49
4968,0,18,0,16,34
4969,0,32,0,19,51
4970,0,16,0,19,35
4972,0,15,17,16,48
4973,0,33,0,16,49
4974,0,16,0,16,32
4976,0,17,17,18,52
4977,0,35,0,15,50
4978,0,18,0,15,33
4980,0,18,0,16,34
4981,0,34,14,18,66
4982,0,18,14,18,50
4985,0,34,0,17,51
4987,0,33,17,15,65
4988,0,16,17,15,48
4989,0,32,0,17,49
4992,0,16,0,18,34
4996,0,16,0,18,34
4997,0,33,0,19,52
4998,0,15,0,19,34
4999,0,34,0,17,51
5000,0,15,0,17,32
5001,0,33,0,16,49
5002,0,16,0,16,32
5004,0,17,0,17,34
5006,0,17,0,17,34
5007,0,34,0,15,49
5010,0,17,0,16,33
5011,0,33,0,17,50
5013,0,33,0,17,50
5014,0,16,0,17,33
5018,0,14,0,17,31
5019,0,34,0,18,52
5020,0,17,0,18,35
5021,0,35,0,15,50
5022,0,17,0,15,32
5024,0,17,0,16,33
5025,0,35,15,17,67
5026,0,19,15,17,51
5027,0,32,0,16,48
5029,0,33,0,18,51
5032,0,16,0,16,32
5034,0,17,0,17,34
5035,0,34,0,16,50
5036,0,17,0,16,33
5038,0,17,0,16,33
5039,0,34,17,16,67
5040,0,18,17,16,51
5041,0,33,0,17,50
5042,0,16,0,17,33
5043,0,32,0,18,50
5044,0,15,0,18,33
5045,0,35,0,15,50
5048,0,18,17,16,51
5049,0,33,0,17,50
5050,0,16,0,17,33
5053,0,34,0,16,50
5054,0,16,0,16,32
5055,0,33,0,18,51
5056,0,17,0,18,35
5060,0,16,0,18,34
5061,0,33,0,19,52
5062,0,15,0,19,34
5064,0,14,0,17,31
5065,0,35,0,16,51
5066,0,18,0,16,34
5067,0,33,0,16,49
5068,0,17,0,16,33
5070,0,18,15,17,50
5073,0,34,0,17,51
5076,0,16,0,16,32
5077,0,34,0,17,51
5078,0,18,0,17,35
5079,0,33,0,17,50
5082,0,16,0,16,32
5083,0,34,0,17,51
5084,0,18,0,17,35
5085,0,32,0,19,51
5086,0,15,0,19,34
5087,0,34,0,17,51
5088,0,15,0,17,32
5095,0,34,0,16,50
5096,0,19,0,16,35
5098,0,16,0,16,32
5099,0,34,0,17,51
5102,0,16,0,16,32
5103,0,32,0,17,49
5104,0,16,0,17,33
5105,0,34,0,18,52
5108,0,16,0,17,33
5109,0,32,0,18,50
5110,0,15,0,18,33
5112,0,17,15,17,49
5114,0,17,0,18,35
5115,0,35,15,17,67
5116,0,17,15,17,49
5119,0,34,17,16,67
5120,0,17,17,16,50
5121,0,33,0,16,49
5122,0,16,0,16,32
5123,0,33,0,16,49
5124,0,17,0,16,33
5125,0,34,17,19,70
5126,0,18,17,19,54
5127,0,36,0,12,48
5128,0,19,0,12,31
5129,0,30,0,16,46
5131,0,34,0,15,49
5132,0,18,0,15,33
5137,0,33,16,18,67
5138,0,15,16,18,49
5139,0,34,0,17,51
5140,0,18,0,17,35
5141,0,33,0,16,49
5144,0,18,0,17,35
5145,0,34,15,18,67
5146,0,17,15,18,50
5148,0,18,0,15,33
5149,0,32,0,18,50
5150,0,17,0,18,35
5151,0,34,0,16,50
5152,0,16,0,16,32
5153,0,34,0,16,50
5154,0,18,0,16,34
5157,0,35,0,17,52
5158,0,18,0,17,35
5159,0,33,0,16,49
5160,0,16,0,16,32
5161,0,34,0,16,50
5162,0,18,0,16,34
5163,0,33,0,15,48
5164,0,17,0,15,32
5165,0,33,0,16,49
5167,0,33,0,15,48
5168,0,17,0,15,32
5169,0,33,0,16,49
5172,0,19,0,14,33
5176,0,16,0,15,31
5177,0,33,0,16,49
5178,0,18,0,16,34
5179,0,34,0,15,49
5181,0,32,0,16,48
5182,0,17,0,16,33
5183,0,33,0,17,50
5184,0,17,0,17,34
5185,0,34,15,18,67
5187,0,33,17,15,65
5188,0,18,17,15,50
5190,0,15,0,18,33
5191,0,36,0,14,50
5192,0,18,0,14,32
5193,0,33,0,17,50
5196,0,16,0,16,32
5197,0,32,0,17,49
5198,0,16,0,17,33
5199,0,34,0,17,51
5201,0,33,0,17,50
5202,0,16,0,17,33
5203,0,33,0,18,51
5205,0,34,0,16,50
5206,0,16,0,16,32
5207,0,32,0,18,50
5208,0,16,0,18,34
5209,0,34,0,19,53
5210,0,16,0,19,35
5211,0,33,0,17,50
5212,0,14,0,17,31
5215,0,33,15,18,66
5218,0,18,0,16,34
5219,0,33,0,17,50
5220,0,17,0,17,34
5221,0,33,0,18,51
5222,0,16,0,18,34
5223,0,35,15,18,68
5224,0,17,15,18,50
5225,0,33,0,16,49
5227,0,32,0,16,48
5230,0,19,0,15,34
5232,0,18,0,16,34
5233,0,33,0,18,51
5237,0,35,0,17,52
5239,0,32,0,18,50
5240,0,15,0,18,33
5241,0,34,0,16,50
5242,0,16,0,16,32
5244,0,18,15,18,51
5245,0,33,0,18,51
5246,0,18,0,18,36
5247,0,35,0,16,51
5248,0,17,0,16,33
5249,0,32,0,17,49
5251,0,33,0,17,50
5252,0,16,0,17,33
5253,0,35,0,14,49
5254,0,18,0,14,32
5256,0,18,0,18,36
5257,0,34,0,15,49
5258,0,16,0,15,31
5259,0,33,0,15,48
5260,0,18,0,15,33
5261,0,31,0,19,50
5262,0,16,0,19,35
5263,0,35,0,16,51
5266,0,17,0,26,43
5267,0,26,0,26,52
5268,0,44,0,17,61
5269,17,18,0,17,52
5271,0,34,0,16,50
5272,0,17,0,16,33
5273,0,30,0,18,48
5274,0,14,0,18,32
5275,0,36,0,17,53
5279,0,28,0,17,45
5280,0,17,0,17,34
5281,0,34,0,14,48
5285,0,35,0,15,50
5286,0,16,0,15,31
5287,0,34,0,15,49
5288,0,19,0,15,34
5289,0,31,0,18,49
5291,0,35,0,17,52
5292,0,17,0,17,34
5293,0,32,0,18,50
5295,0,34,0,16,50
5297,0,33,0,19,52
5298,0,17,0,19,36
5299,0,36,0,14,50
5302,0,17,0,17,34
5303,0,33,0,19,52
5304,0,16,0,19,35
5305,0,33,0,17,50
5306,0,14,0,17,31
5307,0,35,0,17,52
5308,0,18,0,17,35
5314,0,16,0,19,35
5315,0,35,0,16,51
5316,0,16,0,16,32
5317,0,32,0,19,51
5318,0,16,0,19,35
5319,0,35,0,16,51
5321,0,32,0,19,51
5322,0,16,0,19,35
5323,0,34,0,16,50
5324,0,15,0,16,31
5325,0,33,0,18,51
5327,0,34,0,17,51
5329,0,34,0,17,51
5331,0,31,18,16,65
5332,0,14,18,16,48
5333,0,34,0,17,51
5334,0,16,0,17,33
5338,0,16,0,16,32
5339,0,33,0,16,49
5340,0,17,0,16,33
5342,0,16,0,17,33
5343,0,35,0,17,52
5345,0,32,18,16,66
5346,0,15,18,16,49
5347,0,34,0,17,51
5349,0,34,15,16,65
5350,0,17,15,16,48
5351,0,31,0,17,48
5353,0,36,16,17,69
5354,0,19,16,17,52
5355,0,33,0,17,50
5356,0,17,0,17,34
5357,0,33,0,16,49
5358,0,16,0,16,32
5359,0,36,0,12,48
5360,0,20,0,12,32
5361,0,31,15,18,64
5362,0,19,15,18,52
5363,0,33,0,17,50
5365,0,32,0,18,50
5367,0,34,18,17,69
5368,0,16,18,17,51
5369,0,35,0,17,52
5370,0,17,0,17,34
5371,0,33,0,17,50
5373,0,32,0,18,50
5374,0,15,0,18,33
5375,0,34,0,16,50
5376,0,16,0,16,32
5378,0,16,0,17,33
5380,0,16,0,19,35
5381,0,36,0,16,52
5383,0,33,0,16,49
5384,0,17,0,16,33
5385,0,33,0,17,50
5387,0,34,0,16,50
5388,0,17,0,16,33
5390,0,16,0,16,32
5391,0,34,0,16,50
5394,0,16,19,17,52
5395,0,36,0,18,54
5397,0,32,0,16,48
5399,0,33,0,15,48
5401,0,32,0,18,50
5403,0,36,0,16,52
5406,0,16,0,17,33
5407,0,34,0,17,51
5408,0,17,0,17,34
5409,0,33,0,17,50
5412,0,18,0,15,33
5413,0,31,0,18,49
5414,0,16,0,18,34
5415,0,34,16,16,66
5416,0,16,16,16,48
5417,0,32,0,17,49
5418,0,16,0,17,33
5421,0,35,16,17,68
5422,0,18,16,17,51
5423,0,33,0,15,48
5424,0,17,0,15,32
5427,0,35,17,17,69
5428,0,17,17,17,51
5429,0,34,0,16,50
5432,0,18,14,18,50
5433,0,32,0,17,49
5434,0,18,0,17,35
5435,0,31,0,19,50
5437,0,35,0,17,52
5438,0,16,0,17,33
5439,0,34,0,16,50
5440,0,17,0,16,33
5441,0,33,0,17,50
5443,0,34,0,15,49
5444,0,17,0,15,32
5446,0,19,0,14,33
5447,0,32,0,15,47
5448,0,18,0,15,33
5449,0,34,0,15,49
5450,0,19,0,15,34
5451,0,31,0,18,49
5452,0,16,0,18,34
5453,0,34,0,18,52
5454,0,16,0,18,34
5455,0,34,0,19,53
5456,0,16,0,19,35
5457,0,33,0,16,49
5458,0,14,0,16,30
5459,0,33,0,16,49
5460,0,17,0,16,33
5461,0,36,0,15,51
5462,0,20,0,15,35
5463,0,30,0,19,49
5464,0,15,0,19,34
5465,0,35,0,18,53
5466,0,16,0,18,34
5468,0,17,0,16,33
5469,0,31,0,16,47
5470,0,15,0,16,31
5471,0,33,0,18,51
5472,0,17,0,18,35
5475,0,34,0,12,46
5476,0,19,0,12,31
5477,0,33,0,15,48
5478,0,21,0,15,36
5479,0,33,0,17,50
5480,0,18,0,17,35
5482,0,15,0,17,32
5483,0,35,0,15,50
5484,0,18,0,15,33
5485,0,33,0,14,47
5487,0,32,0,16,48
5489,0,34,0,18,52
5490,0,18,0,18,36
5491,0,34,15,17,66
5492,0,16,15,17,48
5493,0,32,0,16,48
5494,0,17,0,16,33
5495,0,33,0,16,49
5497,0,31,0,19,50
5498,0,15,0,19,34
5500,0,19,0,16,35
5502,0,16,0,17,33
5503,0,34,0,16,50
5504,0,17,0,16,33
5505,0,32,0,16,48
5506,0,16,0,16,32
5507,0,33,0,16,49
5508,0,17,0,16,33
5511,0,33,0,15,48
5512,0,17,0,15,32
5513,0,32,0,16,48
5514,0,17,0,16,33
5518,0,14,0,16,30
5519,0,32,0,18,50
5520,0,16,0,18,34
5522,0,15,0,17,32
5523,0,34,0,18,52
5524,0,17,0,18,35
5526,0,16,0,15,31
5531,0,31,0,17,48
5533,0,35,0,16,51
5534,0,18,0,16,34
5535,0,32,0,18,50
5536,0,16,0,18,34
5537,0,34,0,16,50
5538,0,16,0,16,32
5539,0,35,0,15,50
5540,0,19,0,15,34
5541,0,30,0,18,48
5543,0,35,0,16,51
5544,0,17,0,16,33
5547,0,34,0,18,52
5548,0,17,0,18,35
5551,0,34,0,15,49
5553,0,37,0,12,49
5555,0,29,0,16,45
5556,0,17,0,16,33
5557,0,35,0,15,50
5558,0,19,0,15,34
5559,0,32,0,16,48
5560,0,17,0,16,33
5561,0,34,0,17,51
5562,0,18,0,17,35
5563,0,33,0,17,50
5564,0,16,0,17,33
5567,0,35,0,17,52
5568,0,16,0,17,33
5570,0,16,0,16,32
5572,0,18,0,16,34
5573,0,33,0,17,50
5575,0,33,0,17,50
5576,0,16,0,17,33
5579,0,34,0,17,51
5580,0,16,0,17,33
5581,0,34,0,16,50
5582,0,17,0,16,33
5583,0,33,16,17,66
5584,0,17,16,17,50
5592,0,14,0,18,32
5594,0,17,0,17,34
5595,0,34,0,16,50
5596,0,17,0,16,33
5598,0,17,0,18,35
5599,0,33,0,17,50
5600,0,15,0,17,32
5601,0,33,0,16,49
5602,0,16,0,16,32
5603,0,34,0,17,51
5604,0,18,0,17,35
5605,0,33,0,17,50
5609,0,33,0,16,49
5610,0,17,0,16,33
5611,0,34,0,14,48
5613,0,32,0,16,48
5614,0,18,0,16,34
5615,0,33,0,16,49
5616,0,17,0,16,33
5617,0,34,0,16,50
5618,0,18,0,16,34
5619,0,32,0,17,49
5620,0,16,0,17,33
5621,0,34,0,18,52
5622,0,17,0,18,35
5623,0,34,0,17,51
5625,0,32,0,17,49
5626,0,15,0,17,32
5627,0,34,0,18,52
5628,0,17,0,18,35
5629,0,34,0,17,51
5630,0,16,0,17,33
5631,0,33,0,17,50
5632,0,16,0,17,33
5633,0,34,0,17,51
5634,0,17,0,17,34
5635,0,32,0,18,50
5637,0,35,16,17,68
5638,0,17,16,17,50
5639,0,33,0,16,49
5640,0,17,0,16,33
5641,0,33,0,17,50
5642,0,17,0,17,34
5643,0,33,17,16,66
5644,0,16,17,16,49
5645,0,33,0,17,50
5646,0,16,0,17,33
5647,0,35,0,16,51
5648,0,18,0,16,34
5650,0,16,0,16,32
5651,0,32,0,19,51
5652,0,16,0,19,35
5653,0,36,0,15,51
5654,0,17,0,15,32
5655,0,32,0,17,49
5656,0,17,0,17,34
5659,0,33,0,17,50
5661,0,34,0,15,49
5663,0,32,0,18,50
5664,0,17,0,18,35
5666,0,16,0,16,32
5667,0,37,0,12,49
5668,0,21,0,12,33
5669,0,30,0,15,45
5671,0,33,0,15,48
5673,0,33,0,18,51
5674,0,18,0,18,36
5675,0,33,0,17,50
5677,0,34,0,16,50
5678,0,17,0,16,33
5679,0,34,0,17,51
5680,0,18,0,17,35
5682,0,15,0,17,32
5684,0,17,0,16,33
5686,0,16,0,19,35
5687,0,34,0,18,52
5689,0,35,0,15,50
5690,0,17,0,15,32
5691,0,32,16,18,66
5692,0,17,16,18,51
5693,0,34,0,15,49
5695,0,34,0,16,50
5697,0,31,0,18,49
5698,0,15,0,18,33
5700,0,17,0,16,33
5701,0,34,0,16,50
5702,0,18,0,16,34
5703,0,33,0,15,48
5706,0,17,0,19,36
5707,0,33,0,18,51
5708,0,14,0,18,32
5710,0,15,0,18,33
5711,0,34,17,17,68
5712,0,16,17,17,50
5715,0,34,16,18,68
5716,0,18,16,18,52
5717,0,34,0,15,49
5718,0,18,0,15,33
5721,0,34,0,15,49
5723,0,32,0,18,50
5724,0,17,0,18,35
5726,0,16,0,18,34
5727,0,34,0,15,49
5728,0,16,0,15,31
5730,0,19,0,15,34
5731,0,32,0,17,49
5733,0,34,0,16,50
5734,0,17,0,16,33
5736,0,16,0,17,33
5737,0,34,0,16,50
5739,0,32,0,18,50
5741,0,36,0,16,52
5742,0,18,0,16,34
5743,0,31,0,17,48
5744,0,15,0,17,32
5745,0,34,0,15,49
5747,0,34,0,16,50
5748,0,19,0,16,35
5749,0,34,0,16,50
5750,0,18,0,16,34
5751,0,32,0,17,49
5752,0,16,0,17,33
5753,0,33,0,18,51
5754,0,16,0,18,34
5755,0,34,0,16,50
5758,0,16,0,18,34
5759,0,34,0,18,52
5760,0,16,0,18,34
5761,0,34,0,17,51
5762,0,16,0,17,33
5763,0,33,0,17,50
5765,0,34,0,16,50
5766,0,17,0,16,33
5767,0,34,0,15,49
5769,0,33,0,17,50
5770,0,18,0,17,35
5771,0,33,0,17,50
5772,0,16,0,17,33
5773,0,32,0,18,50
5774,0,15,0,18,33
5775,0,33,0,18,51
5776,0,15,0,18,33
5777,0,34,0,18,52
5778,0,16,0,18,34
5779,0,34,0,16,50
5781,0,34,0,16,50
5782,0,18,0,16,34
5783,0,33,0,16,49
5784,0,17,0,16,33
5785,0,34,0,17,51
5786,0,18,0,17,35
5788,0,14,0,19,33
5789,0,33,0,18,51
5790,0,14,0,18,32
5791,0,34,0,18,52
5793,0,34,0,17,51
5794,0,16,0,17,33
5795,0,33,0,16,49
5796,0,16,0,16,32
5797,0,33,0,17,50
5798,0,17,0,17,34
5799,0,33,0,18,51
5803,0,34,0,16,50
5804,0,15,0,16,31
5805,0,32,0,17,49
5806,0,16,0,17,33
5807,0,36,0,14,50
5809,0,32,0,16,48
5813,0,34,0,17,51
5814,0,16,0,17,33
5815,0,34,17,16,67
5816,0,17,17,16,50
5817,0,33,0,17,50
5819,0,32,0,18,50
5820,0,15,0,18,33
5821,0,33,0,17,50
5825,0,34,0,15,49
5826,0,18,0,15,33
5827,0,35,0,14,49
5828,0,20,0,14,34
5832,0,17,20,14,51
5833,0,34,0,17,51
5834,0,14,0,17,31
5835,0,33,0,18,51
5836,0,16,0,18,34
5838,0,16,17,16,49
5840,0,16,0,17,33
5841,0,34,0,17,51
5842,0,17,0,17,34
5844,0,16,0,18,34
5847,0,32,0,17,49
5848,0,14,0,17,31
5849,0,35,0,17,52
5850,0,18,0,17,35
5852,0,16,0,16,32
5853,0,32,0,18,50
5854,0,16,0,18,34
5855,0,34,0,18,52
5856,0,16,0,18,34
5857,0,35,0,16,51
5859,0,32,0,18,50
5860,0,16,0,18,34
5862,0,15,0,17,32
5863,0,33,0,18,51
5864,0,16,0,18,34
5865,0,35,0,17,52
5866,0,17,0,17,34
5867,0,32,0,18,50
5868,0,15,0,18,33
5869,0,34,0,18,52
5870,0,16,0,18,34
5871,0,33,0,17,50
5872,0,15,0,17,32
5873,0,35,0,16,51
5874,0,18,0,16,34
5875,0,32,0,17,49
5876,0,16,0,17,33
5877,0,34,0,15,49
5880,0,18,0,15,33
5881,0,32,0,17,49
5882,0,17,0,17,34
5884,0,17,0,18,35
5885,0,34,0,17,51
5887,0,33,0,15,48
5888,0,16,0,15,31
5890,0,18,0,16,34
5892,0,18,0,16,34
5895,0,33,0,17,50
5896,0,16,0,17,33
5897,0,33,0,16,49
5898,0,16,0,16,32
5899,0,35,0,15,50
5900,0,19,0,15,34
5901,0,32,0,17,49
5902,0,17,0,17,34
5903,0,33,0,17,50
5904,0,16,0,17,33
5906,0,16,0,18,34
5908,0,16,0,17,33
5909,0,34,0,16,50
5910,0,17,0,16,33
5911,0,33,0,16,49
5915,0,36,0,13,49
5916,0,16,0,13,29
5917,0,29,0,18,47
5918,0,16,0,18,34
5919,0,34,0,17,51
5920,0,16,0,17,33
5921,0,33,0,18,51
5922,0,16,0,18,34
5923,0,33,0,18,51
5924,0,15,0,18,33
5925,0,36,14,17,67
5927,0,31,0,18,49
5928,0,17,0,18,35
5930,0,19,0,14,33
5931,0,30,0,16,46
5932,0,16,0,16,32
5934,0,18,0,16,34
5935,0,33,0,17,50
5937,0,32,0,17,49
5939,0,36,0,15,51
5941,0,32,0,16,48
5942,0,17,0,16,33
5943,0,33,0,17,50
5944,0,17,0,17,34
5945,0,33,0,18,51
5946,0,16,0,18,34
5947,0,33,0,18,51
5948,0,15,0,18,33
5949,0,34,0,16,50
5950,0,16,0,16,32
5951,0,33,0,17,50
5953,0,35,0,15,50
5954,0,18,0,15,33
5955,0,33,0,16,49
5956,0,18,0,16,34
5958,0,16,0,17,33
5960,0,16,0,17,33
5962,0,18,0,15,33
5963,0,32,0,17,49
5965,0,33,0,18,51
5966,0,16,0,18,34
5967,0,34,17,17,68
5970,0,17,17,17,51
5971,0,34,0,16,50
5972,0,17,0,16,33
5973,0,33,0,16,49
5974,0,17,0,16,33
5975,0,32,0,16,48
5977,0,34,0,18,52
5978,0,18,0,18,36
5979,0,33,0,17,50
5980,0,15,0,17,32
5981,0,33,0,17,50
5982,0,16,0,17,33
5983,0,35,0,16,51
5984,0,18,0,16,34
5988,0,17,0,16,33
5990,0,16,0,17,33
5991,0,34,0,17,51
5992,0,17,0,17,34
5995,0,33,0,17,50
5998,0,16,0,16,32
