序号,发送->接收,接收->转发,转发->接收,接收->处理,总计
1,0,36,0,23,59
2,0,39,0,17,56
3,16,16,0,17,49
5,0,32,0,19,51
6,0,15,0,19,34
7,0,34,0,16,50
9,0,32,0,21,53
11,0,21,0,19,40
12,0,35,0,30,65
13,0,16,0,30,46
14,0,48,0,33,81
15,0,34,0,33,67
16,0,18,0,33,51
17,0,33,0,16,49
18,0,17,0,16,33
19,0,34,0,32,66
22,0,16,0,17,33
23,0,35,0,32,67
24,0,18,0,32,50
25,0,32,0,16,48
26,16,33,0,17,66
27,0,33,0,17,50
30,0,16,0,18,34
33,0,33,0,18,51
34,0,17,0,18,35
35,0,18,0,17,35
37,0,30,20,16,66
39,0,20,0,16,36
40,0,48,0,19,67
43,0,19,0,31,50
44,0,48,0,16,64
45,0,33,0,16,49
46,0,17,0,16,33
47,0,33,0,16,49
49,0,35,0,33,68
51,0,33,0,16,49
52,0,17,0,16,33
53,0,33,0,16,49
54,0,17,0,16,33
56,0,17,17,17,51
58,0,17,0,16,33
60,0,17,0,18,35
61,0,18,0,16,34
62,0,47,0,19,66
63,0,31,0,19,50
64,0,16,0,19,35
65,0,35,0,18,53
67,0,18,0,32,50
68,0,48,0,17,65
69,16,16,0,17,49
70,0,16,0,17,33
71,0,33,19,16,68
72,0,16,19,16,51
73,0,19,0,16,35
75,0,34,0,31,65
76,18,31,0,19,68
77,0,31,0,19,50
79,0,19,0,31,50
81,16,17,0,18,51
82,0,17,0,18,35
83,0,18,0,17,35
84,0,49,0,17,66
88,0,16,17,17,50
89,0,34,0,16,50
90,0,17,0,16,33
92,0,16,19,32,67
93,0,19,16,16,51
94,0,49,17,16,82
96,0,17,17,16,50
97,0,33,18,17,68
98,0,16,18,17,51
100,0,49,18,16,83
101,0,32,18,16,66
102,0,16,18,16,50
103,0,18,16,32,66
104,0,48,17,16,81
105,0,32,17,16,65
106,0,16,17,16,49
108,0,16,0,19,35
109,0,19,16,33,68
111,0,33,16,18,67
112,0,17,16,18,51
113,0,34,16,16,66
114,0,18,16,16,50
115,0,32,16,17,65
116,0,16,16,17,49
117,0,33,18,33,84
118,0,17,18,33,68
120,0,50,16,18,84
122,0,17,16,18,51
124,0,18,16,34,68
125,0,16,15,19,50
126,0,34,0,16,50
128,0,48,17,17,82
129,0,32,17,17,66
130,0,16,17,17,50
131,0,34,16,16,66
132,0,17,16,16,49
134,0,16,19,16,51
135,0,19,16,32,67
136,0,48,18,15,81
138,0,16,18,15,49
140,0,15,18,17,50
142,0,17,0,16,33
143,0,34,0,32,66
144,0,18,0,32,50
146,16,33,0,18,67
148,0,17,0,18,35
149,0,18,0,33,51
151,18,16,18,32,84
152,0,16,18,32,66
153,0,18,0,32,50
154,0,48,0,17,65
157,0,35,16,17,68
158,0,18,16,17,51
159,0,33,16,16,65
160,0,17,16,16,49
161,0,32,18,33,83
162,0,16,18,33,67
163,0,18,16,17,51
164,0,45,20,20,85
165,0,29,20,20,69
166,0,12,20,20,52
168,0,20,0,32,52
169,0,32,15,17,64
170,0,17,15,17,49
171,0,32,0,16,48
172,0,17,0,16,33
173,0,34,0,17,51
174,0,18,0,17,35
175,0,33,0,16,49
177,0,33,17,18,68
178,0,17,17,18,52
180,0,18,17,32,67
181,0,17,0,32,49
182,0,48,17,18,83
183,17,16,17,18,68
184,0,16,17,18,51
185,0,35,15,17,67
188,0,17,15,20,52
189,0,35,0,31,66
192,0,16,17,18,51
193,0,35,0,33,68
195,0,33,0,17,50
196,0,17,0,17,34
197,0,33,16,19,68
198,0,16,16,19,51
199,0,35,0,31,66
200,0,19,0,31,50
203,0,18,0,17,35
204,0,49,0,17,66
205,0,32,0,17,49
206,16,33,0,18,67
207,0,33,0,18,51
208,0,16,0,18,34
209,0,18,0,17,35
210,0,49,0,18,67
212,0,16,0,18,34
213,0,18,0,31,49
215,0,33,0,16,49
216,0,18,0,16,34
217,0,34,0,35,69
218,0,18,0,35,53
220,19,30,0,19,68
221,0,30,0,19,49
225,0,33,0,31,64
226,19,31,0,18,68
228,0,16,0,18,34
229,0,35,15,19,69
230,0,17,15,19,51
231,0,34,0,16,50
232,0,19,0,16,35
233,0,16,0,32,48
234,0,50,0,33,83
236,0,18,0,33,51
237,0,33,0,16,49
238,17,34,16,16,83
239,0,34,16,16,66
240,0,18,16,16,50
242,0,16,0,18,34
243,0,18,15,18,51
245,18,40,0,26,84
246,0,40,0,26,66
248,0,46,0,17,63
249,18,20,0,17,55
250,0,20,0,17,37
252,0,37,0,25,62
253,0,24,0,25,49
258,0,19,0,32,51
259,0,32,16,17,65
260,0,18,16,17,51
261,0,33,0,32,65
262,0,17,0,32,49
265,0,33,0,18,51
266,0,16,0,18,34
267,0,36,0,16,52
268,0,18,0,16,34
269,0,16,0,32,48
270,0,51,0,17,68
271,0,35,0,17,52
272,0,19,0,17,36
274,0,32,0,32,64
275,0,16,0,32,48
276,0,49,17,18,84
277,0,33,17,18,68
279,0,35,16,16,67
281,0,32,18,16,66
283,0,18,16,32,66
284,0,48,17,18,83
287,0,35,15,19,69
288,0,18,15,19,52
289,0,34,0,16,50
290,0,19,0,16,35
292,0,34,15,17,66
293,0,19,15,17,51
294,0,32,0,18,50
297,0,16,0,32,48
298,0,49,0,16,65
299,0,34,0,16,50
300,0,17,0,16,33
301,0,34,0,32,66
302,0,18,0,32,50
304,0,16,0,18,34
307,0,33,0,16,49
309,0,33,0,17,50
311,0,17,0,17,34
312,0,50,0,33,83
313,0,33,0,33,66
314,0,17,0,33,50
315,0,33,0,17,50
316,0,17,0,17,34
317,0,33,0,18,51
318,0,16,0,18,34
319,0,18,0,19,37
321,0,29,0,18,47
322,0,16,0,18,34
324,0,33,18,32,83
325,0,15,18,32,65
327,0,32,0,16,48
329,0,32,0,18,50
330,0,16,0,18,34
332,0,49,0,18,67
334,0,16,0,18,34
335,0,18,0,33,51
336,0,50,0,15,65
337,0,34,0,15,49
338,0,17,0,15,32
339,0,32,0,18,50
341,0,18,0,32,50
342,0,49,0,17,66
343,0,33,0,17,50
345,0,34,0,34,68
346,0,17,0,34,51
347,0,34,0,33,67
348,0,18,0,33,51
350,0,17,0,31,48
351,0,31,0,17,48
353,0,36,0,33,69
354,0,19,0,33,52
355,0,33,0,32,65
356,0,18,0,32,50
357,0,32,0,17,49
360,0,16,0,19,35
361,0,19,0,22,41
362,0,33,0,32,65
365,0,34,0,34,68
367,0,34,0,17,51
369,0,17,0,30,47
370,0,49,0,32,81
371,0,35,0,32,67
373,0,32,0,16,48
375,0,33,0,17,50
377,0,34,0,17,51
378,0,17,0,17,34
379,0,35,0,31,66
380,0,18,0,31,49
381,0,31,0,18,49
384,0,49,0,15,64
386,0,16,0,15,31
389,0,17,0,33,50
390,0,48,0,18,66
391,0,32,0,18,50
392,0,15,0,18,33
393,0,35,0,17,52
394,0,17,0,17,34
395,0,17,0,33,50
396,0,33,0,33,66
397,0,18,0,33,51
399,17,18,0,31,66
400,0,18,0,31,49
401,0,31,18,17,66
402,0,15,18,17,50
403,0,18,0,17,35
404,0,34,0,31,65
406,0,50,0,34,84
407,0,35,0,34,69
408,0,19,0,34,53
409,0,34,0,16,50
410,0,19,0,16,35
413,0,35,0,33,68
414,0,18,0,33,51
415,0,33,16,16,65
416,0,18,16,16,50
417,0,32,16,16,64
419,0,32,18,18,68
420,0,16,18,18,52
421,0,36,16,16,68
424,0,16,16,19,51
425,0,35,16,32,83
426,0,19,16,32,67
427,0,16,0,32,48
428,0,49,0,16,65
429,0,32,0,16,48
430,0,17,0,16,33
431,0,34,0,17,51
432,0,18,0,17,35
434,0,17,0,17,34
435,0,17,0,17,34
436,0,33,0,33,66
437,0,16,0,33,49
438,0,33,0,33,66
439,0,18,0,33,51
440,0,50,0,16,66
442,0,17,0,16,33
443,0,33,0,18,51
444,0,17,0,18,35
445,0,18,0,32,50
447,18,17,0,16,51
448,0,17,0,16,33
449,0,33,0,16,49
450,0,17,0,16,33
451,0,34,0,31,65
452,0,18,0,31,49
453,0,31,0,19,50
454,0,15,0,19,34
458,0,33,0,31,64
459,18,49,16,18,101
460,0,49,16,18,83
461,0,33,16,18,67
463,0,34,0,34,68
464,0,18,0,34,52
465,0,34,15,16,65
466,18,31,0,17,66
467,0,31,0,17,48
468,0,16,0,17,33
469,0,35,0,15,50
472,0,18,16,17,51
473,0,33,17,17,67
474,0,17,17,17,51
475,0,34,16,16,66
476,0,17,16,16,49
478,0,16,18,32,66
481,0,35,0,17,52
483,0,17,0,32,49
485,0,18,16,16,50
486,0,48,0,18,66
487,0,32,0,18,50
488,0,16,0,18,34
489,0,35,0,16,51
490,0,17,0,16,33
491,0,33,0,17,50
492,0,17,0,17,34
493,0,17,0,32,49
494,0,50,0,34,84
495,0,35,0,34,69
496,0,18,0,34,52
498,19,32,0,16,67
499,0,32,0,16,48
500,0,16,0,16,32
501,0,33,0,19,52
502,0,17,0,19,36
503,0,19,0,32,51
504,0,48,0,16,64
505,17,16,0,16,49
507,0,32,0,18,50
508,0,16,0,18,34
509,0,36,0,16,52
511,0,16,0,34,50
514,0,49,0,17,66
515,0,35,0,17,52
517,0,17,0,33,50
518,0,51,0,16,67
524,0,17,18,17,52
525,0,18,17,31,66
526,0,48,17,16,81
527,0,31,17,16,64
529,0,33,17,19,69
530,0,16,17,19,52
531,0,36,0,33,69
533,0,33,15,18,66
534,0,17,15,18,50
535,0,33,0,33,66
536,0,18,0,33,51
537,0,33,18,32,83
538,0,17,18,32,67
540,0,32,16,18,66
541,0,17,16,18,51
542,0,34,0,33,67
544,0,33,16,17,66
545,0,17,16,17,50
546,0,49,0,18,67
547,0,33,0,18,51
549,0,18,0,33,51
551,0,33,0,17,50
552,0,15,0,17,32
554,0,16,0,18,34
556,0,17,0,16,33
557,0,34,0,32,66
559,0,32,18,17,67
560,0,17,18,17,52
561,0,18,0,17,35
562,0,49,0,18,67
563,0,32,0,18,50
566,0,34,0,17,51
567,0,18,0,17,35
568,0,33,0,34,67
570,0,34,15,17,66
571,0,20,15,17,52
572,0,32,0,32,64
573,0,17,0,32,49
575,0,33,0,19,52
576,0,16,0,19,35
577,0,19,0,16,35
578,0,48,0,18,66
579,0,32,0,18,50
580,0,17,0,18,35
581,0,33,0,19,52
583,0,19,0,19,38
584,0,33,0,34,67
586,0,34,0,33,67
588,0,33,0,32,65
589,19,48,0,18,85
592,0,16,0,18,34
593,0,34,16,17,67
594,0,16,16,17,49
595,0,33,0,16,49
597,0,33,0,18,51
598,0,17,0,18,35
599,0,18,0,33,51
600,0,33,18,34,85
601,0,17,18,34,69
602,0,52,0,16,68
603,0,34,0,16,50
604,0,19,0,16,35
606,0,49,15,18,82
607,0,34,15,18,67
608,0,18,15,18,51
609,0,33,0,19,52
613,20,46,0,18,84
615,0,33,0,18,51
616,0,17,0,18,35
617,0,18,0,18,36
618,0,51,0,31,82
621,0,31,18,17,66
624,0,17,0,32,49
625,0,32,19,31,82
626,19,19,0,31,69
627,0,19,0,31,50
628,0,50,0,32,82
629,0,35,0,32,67
630,0,19,0,32,51
631,0,32,17,17,66
633,0,17,0,17,34
634,0,50,0,32,82
637,0,32,18,16,66
638,16,18,0,16,50
640,0,33,17,31,81
641,0,17,17,31,65
643,0,31,0,17,48
644,0,15,0,17,32
645,0,36,17,16,69
648,0,33,0,16,49
650,0,50,0,32,82
651,0,34,0,32,66
654,0,17,0,17,34
655,0,36,0,32,68
656,0,19,0,32,51
657,0,32,0,33,65
659,0,33,0,16,49
660,18,16,0,17,51
661,0,16,0,17,33
662,0,52,0,16,68
663,0,35,0,16,51
664,0,19,0,16,35
666,0,48,0,17,65
667,0,32,0,17,49
668,0,16,0,17,33
669,0,34,0,17,51
670,0,17,0,17,34
671,0,17,17,16,50
672,0,33,0,32,65
673,0,16,0,32,48
674,0,49,19,17,85
675,0,33,19,17,69
676,0,17,19,17,53
677,0,19,0,17,36
678,0,33,0,31,64
679,0,16,0,31,47
680,0,48,0,19,67
681,0,34,0,19,53
684,0,49,17,17,83
685,0,34,17,17,68
686,0,17,17,17,51
687,0,17,0,17,34
688,0,49,0,17,66
694,0,18,16,18,52
695,0,16,0,18,34
696,0,34,15,19,68
697,0,16,15,19,50
698,0,34,0,31,65
700,0,49,15,16,80
701,0,35,15,16,66
703,0,31,0,20,51
704,0,16,0,20,36
705,0,20,0,31,51
706,0,48,0,17,65
707,0,34,0,17,51
711,0,36,14,17,67
712,0,19,14,17,50
713,0,31,16,18,65
714,0,17,16,18,51
715,0,34,17,34,85
716,0,18,17,34,69
717,0,17,15,19,51
718,0,34,15,16,65
720,0,49,15,18,82
721,16,18,15,18,67
722,0,18,15,18,51
723,0,33,0,17,50
725,0,17,0,17,34
726,0,51,0,17,68
728,19,17,0,32,68
729,0,17,0,32,49
730,0,32,0,33,65
731,0,18,0,33,51
732,0,33,0,20,53
733,0,18,0,20,38
736,0,48,0,18,66
737,0,33,0,18,51
738,0,16,0,18,34
740,0,18,0,16,34
743,0,16,0,33,49
744,0,49,0,16,65
745,0,33,0,16,49
747,0,33,0,17,50
748,0,17,0,17,34
749,0,34,0,16,50
750,0,17,0,16,33
751,0,33,0,18,51
752,0,17,0,18,35
753,0,18,0,32,50
754,0,48,0,19,67
755,17,16,0,19,52
756,0,16,0,19,35
758,0,48,0,17,65
759,0,32,0,17,49
760,0,17,0,17,34
762,0,17,0,16,33
763,0,33,0,17,50
764,0,17,0,17,34
765,0,34,0,16,50
767,0,33,0,17,50
771,0,32,0,15,47
772,0,17,0,15,32
773,0,32,0,17,49
774,0,17,0,17,34
775,0,34,0,24,58
776,0,17,0,24,41
777,0,24,0,11,35
778,0,43,0,16,59
779,0,32,0,16,48
780,18,34,0,17,69
781,0,34,0,17,51
782,0,18,0,17,35
783,0,17,0,32,49
785,0,32,0,17,49
786,0,16,0,17,33
787,0,34,0,17,51
788,0,17,0,17,34
790,0,17,0,34,51
791,0,34,0,32,66
792,0,19,0,32,51
793,0,32,18,32,82
794,0,16,18,32,66
795,0,18,0,32,50
797,17,17,0,16,50
798,0,17,0,16,33
799,0,32,0,19,51
801,0,19,0,32,51
802,0,48,0,17,65
804,0,16,0,17,33
805,0,34,0,17,51
806,0,17,0,17,34
809,0,33,0,17,50
810,0,17,0,17,34
811,0,17,0,17,34
812,0,49,0,18,67
813,0,32,0,18,50
815,0,37,0,33,70
816,0,19,0,33,52
817,0,33,0,29,62
818,0,20,0,29,49
819,0,29,19,32,80
820,0,15,19,32,66
822,0,49,17,17,83
823,0,34,17,17,68
824,0,17,17,17,51
825,0,34,16,18,68
826,0,17,16,18,51
828,0,18,15,17,50
829,0,32,0,16,48
831,0,33,0,17,50
832,0,17,0,17,34
833,0,36,0,32,68
834,0,19,0,32,51
835,0,32,0,34,66
836,0,17,0,34,51
837,0,34,0,32,66
838,0,19,0,32,51
839,0,32,0,16,48
842,0,18,16,17,51
844,0,17,0,18,35
847,17,16,0,16,49
848,0,16,0,16,32
849,0,33,0,18,51
850,0,17,0,18,35
851,0,33,0,18,51
852,0,15,0,18,33
853,0,35,0,17,52
855,0,17,0,17,34
856,0,33,0,33,66
857,0,16,0,33,49
858,0,50,17,33,100
859,0,35,17,33,85
860,0,17,17,33,67
862,0,33,0,32,65
863,0,18,0,32,50
864,0,49,16,17,82
866,0,17,16,17,50
867,0,33,17,17,67
868,0,17,17,17,51
869,0,34,16,18,68
871,0,34,17,17,68
872,0,18,17,17,52
875,0,31,20,17,68
876,0,17,20,17,54
877,0,20,0,17,37
879,0,32,14,19,65
881,0,33,16,17,66
882,0,19,16,17,52
883,0,33,15,19,67
886,0,19,15,18,52
889,0,16,0,18,34
890,0,49,0,18,67
893,0,18,15,17,50
894,0,49,0,17,66
895,0,34,0,17,51
897,0,35,15,16,66
901,0,33,19,32,84
902,0,15,19,32,66
903,0,19,0,32,51
904,0,49,0,16,65
906,0,17,0,16,33
907,0,34,16,17,67
908,0,18,16,17,51
911,0,34,0,17,51
912,0,19,0,17,36
913,0,17,0,33,50
914,0,33,0,18,51
915,17,48,0,17,82
917,0,30,0,17,47
918,16,34,16,18,84
919,0,34,16,18,68
920,0,17,16,18,51
922,0,18,0,16,34
924,0,16,18,17,51
925,0,18,17,33,68
926,0,50,16,18,84
928,0,18,16,18,52
929,0,34,15,18,67
930,0,18,15,18,51
931,0,33,0,17,50
935,0,31,18,16,65
936,17,34,17,18,86
937,0,34,17,18,69
938,0,16,17,18,51
939,0,35,15,17,67
942,17,34,15,18,84
943,0,34,15,18,67
946,0,18,15,18,51
948,0,18,17,17,52
949,0,34,0,17,51
950,0,17,0,17,34
951,0,17,15,20,52
953,0,20,0,30,50
954,0,47,16,18,81
956,0,17,16,18,51
957,0,34,0,17,51
958,0,18,0,17,35
960,0,50,16,16,82
962,0,17,16,16,49
963,0,32,18,33,83
964,0,16,18,33,67
965,0,18,15,18,51
967,0,18,0,17,35
969,0,33,17,17,67
970,0,17,17,17,51
975,0,33,17,17,67
976,0,18,17,17,52
977,0,34,17,16,67
978,0,17,17,16,50
979,0,17,16,33,66
982,17,34,0,17,68
983,0,34,0,17,51
986,0,49,17,17,83
987,0,34,17,17,68
988,0,18,17,17,52
989,0,17,0,17,34
991,0,32,0,17,49
993,0,34,0,17,51
995,0,33,0,17,50
997,0,17,0,18,35
999,0,16,0,16,32
1000,0,49,0,16,65
1001,0,33,0,16,49
1002,0,16,0,16,32
1003,0,33,0,17,50
1004,0,17,0,17,34
1005,0,33,0,18,51
1006,0,16,0,18,34
1007,0,34,0,16,50
1008,0,16,0,16,32
1009,0,33,0,16,49
1011,0,33,18,31,82
1012,0,17,18,31,66
1013,0,18,0,31,49
1014,0,50,0,33,83
1017,0,33,16,18,67
1018,17,34,0,32,83
1019,0,34,0,32,66
1020,0,18,0,32,50
1021,0,32,0,18,50
1025,16,18,16,16,66
1026,0,18,16,16,50
1030,0,17,0,17,34
1031,0,34,18,33,85
1033,0,18,14,19,51
1034,0,33,16,16,65
1035,0,19,16,16,51
1036,0,50,15,17,82
1038,0,18,15,17,50
1039,0,32,0,18,50
1040,0,17,0,18,35
1042,0,49,17,34,100
1044,0,17,17,34,68
1046,0,34,16,16,66
1047,20,49,17,18,104
1048,0,49,17,18,84
1051,0,35,0,16,51
1052,0,18,0,16,34
1054,0,48,17,18,83
1055,0,31,17,18,66
1056,16,35,0,33,84
1057,0,35,0,33,68
1058,0,18,0,33,51
1059,0,33,16,16,65
1060,0,18,16,16,50
1061,0,32,0,16,48
1062,0,16,0,16,32
1063,0,35,0,17,52
1065,0,17,0,16,33
1066,0,47,20,33,100
1067,0,31,20,33,84
1069,0,20,16,17,53
1070,0,33,0,33,66
1071,0,17,0,33,50
1072,0,48,0,18,66
1073,0,32,0,18,50
1074,0,15,0,18,33
1075,0,18,0,34,52
1076,0,34,16,16,66
1077,0,18,16,16,50
1081,0,34,18,32,84
1082,0,19,18,32,69
1083,0,18,0,32,50
1084,0,48,0,17,65
1086,0,16,0,17,33
1087,0,34,18,32,84
1088,0,17,18,32,67
1089,0,18,0,32,50
1090,0,49,0,17,66
1095,0,18,0,16,34
1096,0,49,0,16,65
1097,0,33,0,16,49
1098,0,17,0,16,33
1100,0,17,0,16,33
1101,0,34,0,32,66
1102,0,18,0,32,50
1103,0,32,0,17,49
1105,0,35,0,32,67
1106,0,18,0,32,50
1109,0,35,0,31,66
1111,0,31,0,18,49
1112,0,16,0,18,34
1113,0,35,15,17,67
1114,0,17,15,17,49
1117,0,34,18,31,83
1118,0,17,18,31,66
1119,0,18,0,31,49
1120,0,50,17,16,83
1121,0,34,17,16,67
1122,0,19,17,16,52
1124,0,50,0,32,82
1125,0,34,0,32,66
1126,0,19,0,32,51
1129,0,33,0,16,49
1131,0,34,0,16,50
1132,0,18,0,16,34
1133,0,33,0,17,50
1134,0,17,0,17,34
1135,0,34,0,17,51
1136,0,17,0,17,34
1137,0,17,0,33,50
1138,0,33,0,17,50
1140,0,34,0,32,66
1141,0,17,0,32,49
1143,0,33,0,19,52
1144,0,16,0,19,35
1147,0,33,0,16,49
1148,0,16,0,16,32
1150,0,17,0,17,34
1151,0,33,0,18,51
1155,0,34,0,16,50
1156,0,17,0,16,33
1159,0,16,0,33,49
1160,0,49,0,18,67
1161,0,32,0,18,50
1162,0,16,0,18,34
1163,0,18,0,32,50
1166,0,17,0,16,33
1167,0,33,0,16,49
1168,0,17,0,16,33
1169,0,34,16,17,67
1170,0,18,16,17,51
1172,0,17,0,18,35
1173,0,18,0,17,35
1175,0,32,17,16,65
1176,0,17,17,16,50
1177,0,33,0,17,50
1178,0,16,0,17,33
1180,0,16,17,17,50
1182,0,17,0,20,37
1183,0,20,12,18,50
1186,0,17,16,18,51
1188,0,18,0,34,52
1189,0,34,0,16,50
1192,0,33,0,33,66
1193,0,18,0,33,51
1194,0,33,0,33,66
1196,0,49,0,17,66
1197,16,16,0,17,49
1198,0,16,0,17,33
1199,0,35,0,32,67
1200,0,18,0,32,50
1202,16,33,18,32,99
1204,0,17,18,32,67
1206,0,51,16,31,98
1207,17,19,16,31,83
1210,0,48,18,33,99
1212,0,17,18,33,68
1213,0,18,0,33,51
1214,0,51,0,31,82
1216,0,18,0,31,49
1218,15,34,17,16,82
1219,0,34,17,16,67
1220,0,16,17,16,49
1221,0,33,0,17,50
1222,0,16,0,17,33
1224,0,17,17,17,51
1225,0,34,0,16,50
1226,0,17,0,16,33
1227,0,32,0,17,49
1228,0,16,0,17,33
1229,0,34,0,17,51
1230,0,17,0,17,34
1233,0,17,0,34,51
1234,0,34,16,18,68
1236,0,34,0,31,65
1237,0,18,0,31,49
1238,0,49,0,32,81
1239,0,36,0,32,68
1241,0,32,0,17,49
1243,0,34,0,17,51
1245,0,17,0,34,51
1246,0,34,0,31,65
1247,0,18,0,31,49
1249,0,33,0,17,50
1250,0,17,0,17,34
1251,0,33,0,17,50
1254,0,16,17,16,49
1255,0,33,0,17,50
1256,0,16,0,17,33
1258,0,17,18,17,52
1260,0,33,0,17,50
1261,0,16,0,17,33
1263,0,33,0,32,65
1264,0,18,0,32,50
1266,16,39,0,29,84
1267,0,39,0,29,68
1269,0,29,0,19,48
1270,17,19,0,15,51
1273,0,17,15,19,51
1274,0,34,0,16,50
1275,0,19,0,16,35
1276,0,33,16,34,83
1277,0,17,16,34,67
1278,0,50,0,33,83
1279,0,34,0,33,67
1280,0,18,0,33,51
1282,0,19,0,17,36
1283,0,17,0,17,34
1284,0,33,0,16,49
1286,0,33,0,17,50
1289,0,16,0,17,33
1293,0,17,0,16,33
1294,0,34,0,17,51
1295,0,18,0,17,35
1296,0,33,0,34,67
1297,0,16,0,34,50
1298,0,34,0,33,67
1299,0,18,0,33,51
1301,0,18,0,16,34
1303,0,17,0,17,34
1305,0,16,0,16,32
1307,0,18,0,16,34
1308,0,34,15,17,66
1310,0,32,17,34,83
1313,0,34,0,33,67
1314,0,18,0,33,51
1315,0,33,0,31,64
1316,0,18,0,31,49
1317,0,31,0,19,50
1321,0,34,0,33,67
1322,0,18,0,33,51
1323,0,33,0,17,50
1324,0,18,0,17,35
1325,0,17,0,16,33
1327,0,32,0,19,51
1328,0,17,0,19,36
1329,0,19,0,16,35
1331,0,18,0,15,33
1332,0,33,0,16,49
1333,0,18,0,16,34
1334,0,32,16,17,65
1335,0,16,16,17,49
1336,0,33,0,18,51
1337,0,17,0,18,35
1338,0,51,0,17,68
1339,0,33,0,17,50
1340,0,18,0,17,35
1343,0,18,17,16,51
1344,0,33,16,18,67
1345,0,16,16,18,50
1346,0,34,0,17,51
1348,0,33,15,17,65
1349,0,16,15,17,48
1350,0,48,19,17,84
1351,0,33,19,17,69
1352,0,16,19,17,52
1353,0,19,17,16,52
1356,0,33,17,17,67
1357,0,17,17,17,51
1358,0,34,0,16,50
1359,0,17,0,16,33
1360,0,33,0,16,49
1361,0,17,0,16,33
1363,0,18,0,16,34
1364,0,33,0,15,48
1365,0,17,0,15,32
1366,0,33,0,16,49
1369,0,34,16,17,67
1370,18,16,0,17,51
1371,0,16,0,17,33
1372,0,34,0,17,51
1373,0,17,0,17,34
1375,0,17,0,17,34
1376,0,32,0,17,49
1379,0,17,0,16,33
1380,0,33,0,16,49
1381,0,17,0,16,33
1382,0,33,0,17,50
1384,0,34,0,16,50
1385,0,17,0,16,33
1386,0,33,0,16,49
1387,0,17,0,16,33
1388,0,34,0,33,67
1389,0,18,0,33,51
1390,0,33,0,17,50
1391,0,18,0,17,35
1392,0,33,0,16,49
1394,0,34,0,31,65
1395,0,18,0,31,49
1396,0,49,0,17,66
1397,0,35,0,17,52
1398,0,18,0,17,35
1400,0,50,0,32,82
1402,0,18,0,32,50
1404,0,16,19,16,51
1405,0,19,0,16,35
1406,0,32,17,17,66
1407,0,16,17,17,50
1409,0,17,0,17,34
1413,18,32,0,17,67
1414,0,32,0,17,49
1416,0,34,0,16,50
1417,0,17,0,16,33
1419,0,17,16,18,51
1420,0,34,15,18,67
1422,0,33,17,33,83
1423,0,18,17,33,68
1425,0,33,0,16,49
1426,0,18,0,16,34
1427,0,16,0,32,48
1430,0,20,0,15,35
1431,0,15,0,34,49
1434,0,49,0,16,65
1435,0,32,0,16,48
1436,0,17,0,16,33
1437,0,33,0,17,50
1438,0,17,0,17,34
1439,0,17,0,35,52
1440,0,35,0,32,67
1441,0,20,0,32,52
1442,0,32,0,17,49
1443,0,18,0,17,35
1446,0,33,0,32,65
1447,0,17,0,32,49
1448,0,49,0,17,66
1449,0,33,0,17,50
1451,0,17,0,17,34
1453,0,34,0,16,50
1456,0,34,0,17,51
1457,0,17,0,17,34
1458,0,33,17,20,70
1459,0,16,17,20,53
1460,0,37,13,16,66
1461,0,20,13,16,49
1462,0,29,0,17,46
1463,0,16,0,17,33
1465,0,16,18,16,50
1466,0,34,0,17,51
1467,0,16,0,17,33
1469,0,16,18,16,50
1471,0,16,0,17,33
1472,0,33,0,18,51
1476,0,34,16,33,83
1477,0,16,16,33,65
1479,0,33,0,17,50
1480,0,17,0,17,34
1481,0,34,0,18,52
1482,0,17,0,18,35
1483,0,18,0,16,34
1484,0,32,0,33,65
1486,0,33,0,33,66
1487,0,17,0,33,50
1488,0,33,0,35,68
1491,19,33,0,17,69
1492,0,33,0,17,50
1494,0,33,0,16,49
1495,0,16,0,16,32
1496,0,34,16,16,66
1498,0,32,17,17,66
1500,0,34,0,17,51
1501,0,17,0,17,34
1502,0,33,0,17,50
1504,0,34,15,17,66
1505,0,17,15,17,49
1508,0,17,17,34,68
1509,0,17,0,34,51
1510,0,34,15,19,68
1511,18,34,14,19,85
1512,0,34,14,19,67
1513,0,19,14,19,52
1514,0,33,15,17,65
1515,0,19,15,17,51
1516,0,32,18,16,66
1518,0,34,17,17,68
1519,0,16,17,17,50
1520,0,34,15,18,67
1521,0,17,15,18,50
1522,0,33,16,34,83
1525,0,34,17,16,67
1526,18,17,16,17,68
1527,0,17,16,17,50
1528,0,33,17,16,66
1529,0,17,17,16,50
1531,0,16,17,32,65
1532,0,49,0,16,65
1533,0,32,0,16,48
1535,0,34,0,18,52
1536,0,18,0,18,36
1538,0,32,0,17,49
1540,0,49,17,18,84
1541,0,32,17,18,67
1542,0,16,17,18,51
1543,0,35,15,19,69
1544,0,18,15,19,52
1545,0,34,15,18,67
1546,0,19,15,18,52
1547,0,33,0,33,66
1548,0,18,0,33,51
1549,0,33,16,17,66
1550,0,18,16,17,51
1552,0,33,0,17,50
1553,0,16,0,17,33
1554,0,50,0,17,67
1556,17,17,0,17,51
1557,0,17,0,17,34
1558,0,34,17,17,68
1559,0,17,17,17,51
1560,0,34,0,15,49
1561,0,17,0,15,32
1562,0,50,15,16,81
1564,19,31,17,18,85
1565,0,31,17,18,66
1567,0,35,32,18,85
1569,0,32,18,33,83
1570,19,18,0,33,70
1573,0,18,0,17,35
1574,0,49,0,17,66
1575,0,32,0,17,49
1576,17,17,0,18,52
1577,0,17,0,18,35
1578,0,51,0,17,68
1580,18,17,15,35,85
1581,0,17,15,35,67
1583,0,35,0,32,67
1586,17,17,0,33,67
1587,0,17,0,33,50
1588,0,50,0,34,84
1589,17,17,0,34,68
1590,0,17,0,34,51
1591,0,34,0,17,51
1592,0,18,0,17,35
1593,0,17,0,16,33
1594,0,33,0,17,50
1595,0,17,0,17,34
1596,0,48,19,32,99
1598,0,16,19,32,67
1599,0,19,0,32,51
1600,0,32,16,17,65
1602,0,33,17,17,67
1604,0,34,0,21,55
1607,0,13,15,17,45
1608,0,32,0,17,49
1609,0,17,0,17,34
1610,0,35,0,15,50
1611,0,18,0,15,33
1614,0,19,0,15,34
1616,0,34,0,16,50
1619,0,35,0,16,51
1621,0,16,0,17,33
1623,0,32,0,18,50
1624,0,18,0,18,36
1625,0,18,0,17,35
1626,0,32,0,17,49
1627,0,15,0,17,32
1629,0,17,0,18,35
1630,0,34,0,16,50
1632,0,33,17,32,82
1633,0,17,17,32,66
1634,0,49,18,33,100
1635,0,32,18,33,83
1636,0,17,18,33,68
1641,0,33,0,17,50
1642,0,19,0,17,36
1643,0,17,0,33,50
1644,0,33,0,16,49
1645,0,19,0,16,35
1646,0,50,0,17,67
1647,0,34,0,17,51
1648,0,19,0,17,36
1651,0,18,0,32,50
1652,0,32,0,33,65
1653,0,18,0,33,51
1654,0,51,0,16,67
1655,0,35,0,16,51
1657,0,16,0,33,49
1658,0,33,0,32,65
1659,0,18,0,32,50
1660,0,49,0,18,67
1661,0,33,0,18,51
1662,0,17,0,18,35
1664,0,34,0,16,50
1665,0,17,0,16,33
1667,0,17,0,17,34
1668,0,50,0,16,66
1670,0,19,0,16,35
1671,0,16,0,19,35
1672,0,34,0,17,51
1674,0,33,0,34,67
1675,0,16,0,34,50
1676,0,34,0,16,50
1677,0,18,0,16,34
1679,0,17,0,16,33
1680,0,33,0,32,65
1681,0,17,0,32,49
1682,0,51,0,32,83
1683,0,35,0,32,67
1684,0,19,0,32,51
1685,0,32,0,32,64
1686,0,18,0,32,50
1689,0,35,0,17,52
1691,0,17,0,17,34
1693,0,16,0,17,33
1694,0,33,0,16,49
1695,0,16,0,16,32
1696,0,51,0,15,66
1697,0,35,0,15,50
1698,0,19,0,15,34
1700,0,35,0,16,51
1701,0,17,0,16,33
1702,0,33,16,16,65
1703,0,17,16,16,49
1705,0,16,17,18,51
1707,18,33,16,33,100
1708,0,33,16,33,82
1709,0,17,16,33,66
1710,0,49,0,17,66
1711,0,33,0,17,50
1712,17,17,0,16,50
1713,0,17,0,16,33
1714,0,33,0,36,69
1715,0,17,0,36,53
1716,0,36,0,14,50
1718,0,31,0,16,47
1721,0,17,0,18,35
1722,0,34,0,16,50
1724,0,33,0,17,50
1727,0,33,0,17,50
1728,0,17,0,17,34
1729,0,17,0,17,34
1731,0,33,0,33,66
1732,18,33,0,18,69
1733,0,33,0,18,51
1734,0,18,0,18,36
1735,0,18,0,15,33
1736,0,49,0,17,66
1737,0,34,0,17,51
1738,0,18,0,17,35
1739,0,17,0,32,49
1740,0,50,0,17,67
1741,0,35,0,17,52
1742,0,18,0,17,35
1743,0,17,0,17,34
1744,0,33,0,17,50
1746,0,34,0,31,65
1748,0,47,0,20,67
1749,0,33,0,20,53
1751,0,20,0,15,35
1752,0,51,0,14,65
1753,0,36,0,14,50
1754,0,21,0,14,35
1756,0,34,0,16,50
1757,0,18,0,16,34
1758,0,34,0,16,50
1759,0,18,0,16,34
1760,0,33,17,31,81
1761,0,17,17,31,65
1764,17,35,0,33,85
1765,0,35,0,33,68
1766,0,18,0,33,51
1767,0,33,0,17,50
1768,0,18,0,17,35
1770,0,32,0,33,65
1771,17,50,17,16,100
1772,0,50,17,16,83
1774,0,17,17,16,50
1776,0,16,0,17,33
1777,0,17,17,17,51
1778,0,34,16,17,67
1779,0,17,16,17,50
1780,0,50,0,17,67
1781,0,34,0,17,51
1782,0,17,0,17,34
1783,0,17,17,16,50
1785,0,16,0,33,49
1788,0,18,16,18,52
1789,0,16,0,18,34
1790,0,34,15,17,66
1791,0,16,15,17,48
1794,0,34,17,17,68
1795,0,17,17,17,51
1796,0,34,15,18,67
1797,0,17,15,18,50
1798,0,33,23,10,66
1799,0,18,23,10,51
1800,0,33,16,19,68
1803,0,19,0,15,34
1804,0,31,16,19,66
1805,0,16,16,19,51
1807,0,19,0,15,34
1808,0,33,16,17,66
1810,0,33,0,16,49
1811,0,17,0,16,33
1812,0,33,0,16,49
1813,0,17,0,16,33
1814,0,34,0,16,50
1817,0,17,0,18,35
1819,0,16,0,32,48
1821,18,34,0,17,69
1822,0,34,0,17,51
1823,0,18,0,17,35
1825,0,16,0,17,33
1826,0,34,0,16,50
1827,0,17,0,16,33
1828,0,32,0,17,49
1829,0,16,0,17,33
1833,0,17,0,16,33
1834,0,33,16,33,82
1835,0,17,16,33,66
1837,0,33,0,16,49
1839,0,35,0,16,51
1840,0,19,0,16,35
1842,0,34,16,17,67
1845,0,17,0,16,33
1846,0,33,17,16,66
1847,0,17,17,16,50
1848,0,33,0,17,50
1849,0,16,0,17,33
1850,0,34,0,16,50
1851,0,17,0,16,33
1852,0,33,0,16,49
1853,0,17,0,16,33
1854,0,33,0,17,50
1857,0,17,0,16,33
1858,0,32,0,17,49
1860,0,33,0,17,50
1861,0,16,0,17,33
1862,0,36,0,16,52
1863,0,19,0,16,35
1864,0,33,0,16,49
1866,0,33,0,15,48
1867,0,17,0,15,32
1868,0,32,0,18,50
1869,0,17,0,18,35
1870,0,35,0,16,51
1873,0,15,0,19,34
1874,0,36,0,17,53
1876,0,32,0,16,48
1877,0,15,0,16,31
1878,0,33,0,16,49
1879,0,17,0,16,33
1880,0,35,0,16,51
1881,0,19,0,16,35
1882,0,33,0,15,48
1883,0,17,0,15,32
1885,0,18,16,16,50
1886,0,32,17,16,65
1887,0,16,17,16,49
1888,0,33,16,19,68
1891,0,19,0,16,35
1893,0,17,0,15,32
1894,0,35,0,15,50
1897,0,18,0,16,34
1898,0,47,0,19,66
1899,0,31,0,19,50
1900,0,17,0,19,36
1901,0,19,0,16,35
1902,0,32,0,18,50
1903,0,16,0,18,34
1904,0,34,0,18,52
1905,0,16,0,18,34
1906,0,34,0,15,49
1907,0,16,0,15,31
1911,0,15,0,18,33
1912,0,34,18,15,67
1913,0,16,18,15,49
1914,0,33,17,17,67
1915,0,15,17,17,49
1916,0,34,0,18,52
1919,0,33,17,14,64
1922,0,31,0,18,49
1923,0,17,0,18,35
1924,0,35,15,19,69
1925,0,17,15,19,51
1926,0,34,0,15,49
1927,0,19,0,15,34
1928,0,32,0,32,64
1929,0,17,0,32,49
1930,0,32,0,19,51
1932,0,34,0,19,53
1935,0,15,0,16,31
1936,0,34,0,15,49
1939,0,19,0,16,35
1940,0,32,0,16,48
1942,0,34,0,15,49
1943,0,18,0,15,33
1944,0,32,0,18,50
1946,0,35,0,16,51
1947,0,17,0,16,33
1948,0,33,0,15,48
1951,0,18,0,16,34
1954,0,20,0,14,34
1955,0,14,0,19,33
1956,0,35,16,16,67
1957,0,16,16,16,48
1958,0,32,0,36,68
1959,0,16,0,36,52
1960,0,36,0,15,51
1961,0,21,0,15,36
1963,0,19,0,17,36
1964,0,34,0,14,48
1966,0,30,0,19,49
1967,0,16,0,19,35
1968,0,34,0,17,51
1969,0,15,0,17,32
1973,0,17,16,19,52
1976,0,31,0,16,47
1978,0,34,0,16,50
1979,0,18,0,16,34
1980,0,33,0,17,50
1982,0,33,0,18,51
1983,0,16,0,18,34
1984,0,32,0,19,51
1985,0,14,0,19,33
1987,0,16,15,18,49
1989,0,18,0,17,35
1991,0,17,0,19,36
1992,0,34,0,16,50
1993,0,15,0,16,31
1994,0,32,0,18,50
1995,0,16,0,18,34
2000,0,32,0,17,49
2001,0,17,0,17,34
2002,0,34,0,16,50
2003,0,17,0,16,33
2005,0,18,15,17,50
2006,0,32,0,19,51
2007,0,17,0,19,36
2008,0,34,0,19,53
2013,0,15,0,17,32
2014,0,34,17,17,68
2015,0,17,17,17,51
2016,0,34,0,15,49
2018,0,33,0,18,51
2019,0,18,0,18,36
2020,0,33,0,17,50
2021,0,15,0,17,32
2022,0,35,0,14,49
2023,0,18,0,14,32
2025,0,18,0,16,34
2026,0,32,20,15,67
2027,0,16,20,15,51
2028,0,35,17,16,68
2029,0,15,17,16,48
2030,0,33,17,17,67
2031,0,16,17,17,50
2032,0,34,0,16,50
2033,0,17,0,16,33
2034,0,34,0,16,50
2035,0,18,0,16,34
2037,0,15,0,19,34
2039,0,16,0,15,31
2041,0,17,0,20,37
2042,0,34,0,17,51
2043,0,14,0,17,31
2044,0,33,0,17,50
2045,0,16,0,17,33
2046,0,33,0,18,51
2047,0,16,0,18,34
2048,0,33,0,17,50
2049,0,15,0,17,32
2050,0,33,0,17,50
2052,0,35,0,15,50
2054,0,32,0,18,50
2055,0,17,0,18,35
2056,0,35,0,16,51
2057,0,17,0,16,33
2058,0,33,0,32,65
2059,0,17,0,32,49
2060,0,32,0,16,48
2061,0,17,0,16,33
2062,0,34,0,16,50
2063,0,18,0,16,34
2065,0,17,0,20,37
2066,0,33,0,18,51
2068,0,52,0,16,68
2069,0,34,0,16,50
2070,0,19,0,16,35
2072,0,33,0,16,49
2074,0,34,0,16,50
2077,0,17,0,16,33
2079,0,16,0,18,34
2080,0,35,0,16,51
2081,0,17,0,16,33
2082,0,32,0,17,49
2083,0,16,0,17,33
2085,0,16,0,16,32
2086,0,35,0,16,51
2087,0,19,0,16,35
2088,0,33,0,16,49
2089,0,17,0,16,33
2091,0,17,0,16,33
2092,0,34,0,17,51
2093,0,18,0,17,35
2095,0,15,0,18,33
2098,0,36,0,15,51
2099,0,16,0,15,31
2100,0,31,0,16,47
2101,0,16,0,16,32
2102,0,34,17,16,67
2103,0,18,17,16,51
2104,0,33,0,16,49
2106,0,34,0,17,51
2108,0,33,0,16,49
2109,0,16,0,16,32
2110,0,34,0,15,49
2111,0,18,0,15,33
2112,0,33,0,17,50
2113,0,18,0,17,35
2114,0,32,0,16,48
2115,0,15,0,16,31
2116,0,33,0,17,50
2119,0,17,18,15,50
2120,0,33,0,17,50
2121,0,15,0,17,32
2122,0,34,0,32,66
2124,0,49,0,17,66
2125,0,34,0,17,51
2126,0,17,0,17,34
2127,0,17,17,17,51
2128,0,34,0,16,50
2129,0,17,0,16,33
2130,0,32,18,18,68
2131,0,16,18,18,52
2132,0,36,0,16,52
2133,0,18,0,16,34
2134,0,33,0,15,48
2136,0,33,0,15,48
2137,0,18,0,15,33
2138,0,33,0,17,50
2139,0,18,0,17,35
2140,0,33,0,18,51
2141,0,16,0,18,34
2142,0,33,0,17,50
2144,0,33,0,16,49
2145,0,16,0,16,32
2146,0,52,0,16,68
2147,0,36,0,16,52
2148,0,19,0,16,35
2150,0,33,16,18,67
2151,0,16,16,18,50
2153,0,18,0,15,33
2155,0,17,16,18,51
2157,0,18,0,18,36
2158,0,34,0,16,50
2159,0,16,0,16,32
2160,0,34,0,15,49
2162,0,32,0,17,49
2165,0,16,16,16,48
2166,0,32,19,15,66
2169,0,15,16,19,50
2171,0,19,0,16,35
2172,0,32,17,16,65
2173,0,16,17,16,49
2174,0,33,0,18,51
2175,0,16,0,18,34
2178,0,32,0,17,49
2179,0,16,0,17,33
2180,0,34,0,15,49
2181,0,17,0,15,32
2182,0,34,0,16,50
2183,0,19,0,16,35
2185,0,16,0,17,33
2186,0,35,0,33,68
2187,0,18,0,33,51
2188,0,33,0,15,48
2189,0,19,0,15,34
2190,0,31,0,19,50
2191,0,16,0,19,35
2192,0,34,0,16,50
2195,0,19,0,15,34
2196,0,32,0,18,50
2198,0,33,0,18,51
2199,0,15,0,18,33
2201,0,15,0,18,33
2203,0,18,0,14,32
2205,0,17,0,16,33
2206,0,34,0,16,50
2207,0,18,0,16,34
2211,0,16,0,16,32
2212,0,33,0,16,49
2213,0,17,0,16,33
2214,0,34,15,19,68
2215,0,18,15,19,52
2216,0,34,0,16,50
2217,0,19,0,16,35
2218,0,33,0,17,50
2219,0,17,0,17,34
2221,0,16,16,17,49
2222,0,33,0,16,49
2223,0,17,0,16,33
2224,0,33,0,16,49
2225,0,17,0,16,33
2228,0,32,0,18,50
2229,0,16,0,18,34
2230,0,34,18,15,67
2233,0,15,0,16,31
2234,0,35,0,14,49
2236,0,33,0,15,48
2237,0,19,0,15,34
2238,0,33,0,15,48
2240,0,32,0,17,49
2241,0,17,0,17,34
2243,0,17,0,17,34
2245,0,17,0,16,33
2246,0,33,0,16,49
2247,0,17,0,16,33
2248,0,33,0,33,66
2249,0,17,0,33,50
2250,0,33,0,16,49
2251,0,18,0,16,34
2252,0,33,0,18,51
2253,0,17,0,18,35
2255,0,16,0,18,34
2256,0,33,0,17,50
2257,0,15,0,17,32
2259,0,17,0,16,33
2261,0,17,0,16,33
2265,0,32,0,18,50
2266,0,17,0,18,35
2268,0,32,0,17,49
2270,0,34,0,17,51
2273,0,16,0,17,33
2274,0,36,0,16,52
2275,0,19,0,16,35
2276,0,31,0,17,48
2277,0,15,0,17,32
2278,0,34,0,17,51
2279,0,17,0,17,34
2280,0,33,0,16,49
2281,0,16,0,16,32
2282,0,33,0,19,52
2283,0,17,0,19,36
2284,0,35,0,17,52
2285,0,16,0,17,33
2286,0,33,0,17,50
2287,0,16,0,17,33
2289,0,15,0,17,32
2290,0,35,0,15,50
2291,0,18,0,15,33
2292,0,33,0,16,49
2293,0,18,0,16,34
2294,0,33,0,17,50
2296,0,33,0,17,50
2298,0,33,0,17,50
2299,0,16,0,17,33
2300,0,34,0,17,51
2302,0,34,0,16,50
2303,0,17,0,16,33
2305,0,21,0,29,50
2306,0,29,0,16,45
2307,20,33,0,16,69
2308,0,33,0,16,49
2309,0,17,0,16,33
2311,0,17,0,16,33
2314,0,33,0,16,49
2315,0,17,0,16,33
2316,0,34,0,16,50
2317,0,18,0,16,34
2318,0,33,16,17,66
2319,0,17,16,17,50
2320,0,33,0,18,51
2321,0,17,0,18,35
2322,0,34,14,19,67
2323,0,16,14,19,49
2324,0,33,0,16,49
2325,0,19,0,16,35
2326,0,33,17,15,65
2327,0,17,17,15,49
2330,0,35,17,16,68
2331,0,17,17,16,50
2333,0,16,0,17,33
2335,0,17,15,17,49
2336,0,32,0,17,49
2337,0,17,0,17,34
2338,0,33,0,18,51
2340,0,35,16,16,67
2341,0,17,16,16,49
2342,0,32,18,15,65
2343,0,16,18,15,49
2344,0,33,18,19,70
2345,0,15,18,19,52
2347,0,19,14,16,49
2348,0,30,0,17,47
2349,0,16,0,17,33
2350,0,35,0,15,50
2353,0,17,16,17,50
2356,0,35,15,18,68
2357,0,17,15,18,50
2358,0,33,0,16,49
2360,0,32,0,18,50
2362,0,33,18,16,67
2364,0,34,0,17,51
2365,0,16,0,17,33
2366,0,34,16,16,66
2367,0,17,16,16,49
2368,0,32,0,17,49
2369,0,16,0,17,33
2371,0,18,0,16,34
2372,0,33,0,17,50
2373,0,17,0,17,34
2374,0,49,0,17,66
2375,0,32,0,17,49
2377,0,17,0,17,34
2378,0,33,0,17,50
2379,0,16,0,17,33
2381,0,17,0,16,33
2382,0,34,0,33,67
2383,0,18,0,33,51
2384,0,33,0,17,50
2385,0,18,0,17,35
2388,0,33,0,17,50
2389,0,15,0,17,32
2390,0,33,0,17,50
2391,0,16,0,17,33
2393,0,17,16,18,51
2394,0,34,0,15,49
2395,0,18,0,15,33
2397,0,17,0,18,35
2398,0,34,0,16,50
2399,0,16,0,16,32
2400,0,41,10,15,66
2401,0,25,10,15,50
2402,0,25,0,17,42
2403,0,15,0,17,32
2404,0,35,17,16,68
2405,0,18,17,16,51
2407,0,16,18,16,50
2408,0,34,0,17,51
2409,0,16,0,17,33
2410,0,34,0,16,50
2412,0,33,0,16,49
2414,0,32,17,16,65
2415,0,16,17,16,49
2416,0,33,0,17,50
2417,0,16,0,17,33
2418,0,33,19,16,68
2419,0,16,19,16,51
2420,0,35,0,16,51
2422,0,31,0,19,50
2425,0,17,0,17,34
2426,0,31,17,18,66
2427,0,14,17,18,49
2428,0,35,0,16,51
2429,0,18,0,16,34
2430,0,32,18,16,66
2431,0,16,18,16,50
2432,0,34,0,18,52
2434,0,33,18,15,66
2435,0,15,18,15,48
2439,0,16,0,16,32
2440,0,32,18,16,66
2441,0,16,18,16,50
2442,0,34,0,18,52
2444,0,33,16,17,66
2445,0,15,16,17,48
2446,0,33,17,16,66
2450,0,35,16,17,68
2451,0,17,16,17,50
2452,0,33,0,17,50
2453,0,17,0,17,34
2454,0,32,0,18,50
2456,0,37,14,17,68
2457,0,19,14,17,50
2458,0,31,15,20,66
2460,0,35,0,15,50
2461,0,20,0,15,35
2462,0,32,0,17,49
2463,0,17,0,17,34
2465,0,15,17,17,49
2469,0,17,16,17,50
2470,0,33,0,18,51
2473,0,16,0,16,32
2474,0,33,0,16,49
2477,0,17,0,18,35
2478,0,34,0,16,50
2479,0,16,0,16,32
2480,0,34,0,16,50
2481,0,18,0,16,34
2482,0,34,0,16,50
2483,0,18,0,16,34
2484,0,32,0,16,48
2485,0,16,0,16,32
2486,0,33,0,17,50
2487,0,17,0,17,34
2488,0,33,0,18,51
2489,0,16,0,18,34
2491,0,17,0,15,32
2492,0,32,0,16,48
2493,0,17,0,16,33
2495,0,18,0,16,34
2496,0,34,0,17,51
2497,0,18,0,17,35
2502,0,34,0,15,49
2503,0,18,0,15,33
2505,0,17,0,18,35
2508,0,33,0,17,50
2510,0,34,0,16,50
2511,0,17,0,16,33
2512,0,33,0,16,49
2514,0,33,16,17,66
2515,0,17,16,17,50
2516,0,33,0,17,50
2518,0,33,18,16,67
2519,0,16,18,16,50
2520,0,34,0,16,50
2523,0,17,17,16,50
2524,0,33,0,19,52
2525,0,16,0,19,35
2526,0,36,14,17,67
2527,0,17,14,17,48
2531,0,18,0,15,33
2532,0,34,0,16,50
2534,0,31,0,17,48
2536,0,36,0,17,53
2537,0,19,0,17,36
2538,0,33,0,16,49
2540,0,32,0,19,51
2541,0,16,0,19,35
2542,0,33,0,16,49
2543,0,14,0,16,30
2544,0,34,0,17,51
2547,0,17,0,16,33
2549,0,17,0,17,34
2550,0,33,0,16,49
2552,0,33,0,18,51
2553,0,17,0,18,35
2554,0,33,0,16,49
2555,0,15,0,16,31
2556,0,35,0,17,52
2557,0,19,0,17,36
2559,0,15,0,18,33
2560,0,34,0,16,50
2561,0,16,0,16,32
2562,0,34,0,16,50
2563,0,18,0,16,34
2564,0,32,0,18,50
2566,0,35,17,16,68
2567,0,17,17,16,50
2572,0,36,0,16,52
2573,0,18,0,16,34
2574,0,32,16,18,66
2575,0,16,16,18,50
2577,0,18,0,17,35
2578,0,32,17,17,66
2579,0,15,17,17,49
2581,0,17,0,17,34
2583,0,17,0,16,33
2584,0,32,0,17,49
2586,0,33,0,18,51
2587,0,16,0,18,34
2588,0,35,0,17,52
2590,0,33,0,16,49
2591,0,16,0,16,32
2592,0,32,0,19,51
2593,0,16,0,19,35
2594,0,34,19,14,67
2595,0,15,19,14,48
2596,0,33,0,18,51
2597,0,14,0,18,32
2600,0,33,0,16,49
2602,0,33,0,17,50
2603,0,17,0,17,34
2605,0,17,0,16,33
2606,0,34,0,16,50
2607,0,18,0,16,34
2608,0,32,0,17,49
2609,0,16,0,17,33
2611,0,18,0,15,33
2612,0,31,0,17,48
2614,0,35,0,17,52
2615,18,34,16,17,85
2617,0,17,16,17,50
2618,0,33,0,15,48
2620,0,32,17,17,66
2621,0,17,17,17,51
2624,0,33,0,18,51
2625,0,17,0,18,35
2626,0,35,0,16,51
2627,0,17,0,16,33
2629,0,17,0,16,33
2630,0,32,0,16,48
2631,0,16,0,16,32
2633,0,17,0,18,35
2634,0,34,0,16,50
2635,0,16,0,16,32
2636,0,33,0,34,67
2637,0,17,0,34,51
2638,0,34,15,18,67
2639,0,20,15,18,53
2642,0,33,0,17,50
2644,0,33,0,17,50
2645,0,16,0,17,33
2646,0,33,0,19,52
2648,0,35,0,16,51
2649,0,16,0,16,32
2650,0,32,0,17,49
2652,0,34,0,16,50
2653,0,17,0,16,33
2654,0,33,0,17,50
2655,0,17,0,17,34
2656,0,35,0,16,51
2657,0,18,0,16,34
2658,0,30,0,19,49
2660,0,35,18,16,69
2661,0,16,18,16,50
2662,0,34,0,18,52
2663,0,16,0,18,34
2664,0,33,17,16,66
2666,0,33,17,18,68
2667,0,16,17,18,51
2669,0,18,0,15,33
2670,0,32,17,15,64
2673,0,15,0,19,34
2674,0,34,18,16,68
2675,0,15,18,16,49
2676,0,34,0,16,50
2677,0,16,0,16,32
2680,0,32,0,17,49
2681,0,15,0,17,32
2682,0,34,0,18,52
2683,0,17,0,18,35
2685,0,15,0,17,32
2686,0,34,0,15,49
2687,0,17,0,15,32
2688,0,33,0,16,49
2691,0,18,0,15,33
2692,0,34,0,17,51
2693,0,19,0,17,36
2694,0,33,0,17,50
2696,0,33,0,16,49
2697,0,16,0,16,32
2698,0,31,0,19,50
2699,0,15,0,19,34
2700,0,36,0,14,50
2701,0,17,0,14,31
2702,0,33,0,16,49
2703,0,19,0,16,35
2704,0,33,0,16,49
2705,0,17,0,16,33
2706,0,32,0,18,50
2709,0,17,0,16,33
2710,0,33,0,17,50
2712,0,32,0,19,51
2713,0,15,0,19,34
2714,0,34,0,17,51
2715,0,15,0,17,32
2717,0,18,0,16,34
2718,0,32,0,16,48
2719,0,16,0,16,32
2720,0,33,0,17,50
2722,0,33,0,17,50
2724,0,34,0,16,50
2725,0,17,0,16,33
2727,0,18,0,36,54
2728,0,36,21,18,75
2730,14,18,0,13,45
2735,0,17,0,16,33
2737,0,16,0,18,34
2738,0,34,0,17,51
2739,0,16,0,17,33
2740,0,34,0,16,50
2742,0,33,0,17,50
2743,0,17,0,17,34
2744,0,33,0,17,50
2745,0,16,0,17,33
2747,0,17,0,16,33
2748,0,33,0,17,50
2750,0,33,0,16,49
2752,0,34,0,17,51
2753,0,18,0,17,35
2754,0,33,0,16,49
2755,0,16,0,16,32
2757,0,17,17,17,51
2758,0,34,17,16,67
2759,0,17,17,16,50
2760,0,33,0,17,50
2761,0,16,0,17,33
2763,0,17,0,17,34
2764,0,33,0,16,49
2766,0,34,0,15,49
2767,0,18,0,15,33
2771,0,15,17,17,49
2774,0,33,17,17,67
2775,0,16,17,17,50
2776,0,34,16,17,67
2777,0,17,16,17,50
2778,0,33,17,16,66
2779,0,17,17,16,50
2780,0,33,17,16,66
2781,0,16,17,16,49
2782,0,33,16,17,66
2783,0,16,16,17,49
2784,0,33,0,18,51
2785,0,17,0,18,35
2786,0,33,17,18,68
2787,0,15,17,18,50
2788,0,35,0,14,49
2789,0,18,0,14,32
2793,0,16,0,18,34
2794,0,34,0,16,50
2795,0,16,0,16,32
2797,0,17,0,17,34
2798,0,33,0,18,51
2799,0,16,0,18,34
2800,0,33,0,18,51
2802,0,34,0,16,50
2803,0,16,0,16,32
2804,0,33,17,17,67
2805,0,17,17,17,51
2806,0,34,16,17,67
2809,0,17,0,16,33
2810,0,33,16,19,68
2811,0,17,16,19,52
2812,0,35,0,15,50
2814,0,31,18,16,65
2815,0,16,18,16,50
2816,0,34,0,18,52
2817,0,16,0,18,34
2818,0,34,0,16,50
2821,0,17,15,19,51
2822,0,34,0,15,49
2823,0,19,0,15,34
2825,0,18,15,16,49
2827,0,16,0,19,35
2828,0,34,0,17,51
2831,0,18,0,17,35
2832,0,32,0,17,49
2833,0,15,0,17,32
2834,0,34,0,17,51
2836,0,34,0,16,50
2837,0,17,0,16,33
2838,0,33,0,17,50
2839,0,17,0,17,34
2841,0,16,0,16,32
2842,0,34,0,15,49
2843,0,18,0,15,33
2844,0,32,0,18,50
2845,0,17,0,18,35
2846,0,34,0,18,52
2847,0,16,0,18,34
2848,0,33,0,17,50
2849,0,15,0,17,32
2850,0,34,0,16,50
2851,0,17,0,16,33
2852,0,32,0,18,50
2853,0,16,0,18,34
2855,0,16,0,17,33
2856,0,34,0,17,51
2857,0,17,0,17,34
2859,0,17,16,16,49
2860,0,32,16,17,65
2862,0,33,18,15,66
2863,0,17,18,15,50
2865,0,15,17,18,50
2866,0,35,16,17,68
2867,0,18,16,17,51
2869,0,17,16,17,50
2870,0,33,17,16,66
2871,0,17,17,16,50
2873,0,16,0,16,32
2874,0,35,17,14,66
2876,0,31,0,17,48
2877,0,14,0,17,31
2878,0,35,16,18,69
2879,0,18,16,18,52
2880,0,34,0,15,49
2882,0,33,17,17,67
2883,0,18,17,17,52
2886,0,32,0,16,48
2887,0,17,0,16,33
2888,0,33,0,17,50
2890,0,33,0,18,51
2892,0,33,0,17,50
2896,0,32,0,18,50
2900,0,34,0,16,50
2901,0,19,0,16,35
2903,0,16,0,17,33
2904,0,33,0,18,51
2906,0,35,16,17,68
2907,0,17,16,17,50
2909,0,17,0,16,33
2910,0,34,15,17,66
2911,0,18,15,17,50
2912,0,32,0,17,49
2913,0,17,0,17,34
2914,0,34,18,15,67
2915,0,17,18,15,50
2917,0,15,0,17,32
2918,0,33,0,18,51
2920,0,33,0,18,51
2922,0,34,16,18,68
2923,0,16,16,18,50
2924,0,34,0,15,49
2925,0,18,0,15,33
2927,0,17,0,18,35
2928,0,33,0,18,51
2929,0,15,0,18,33
2930,0,35,0,17,52
2931,0,17,0,17,34
2932,0,32,0,17,49
2933,0,15,0,17,32
2934,0,34,0,17,51
2935,0,17,0,17,34
2936,0,35,0,15,50
2938,0,31,0,17,48
2941,0,18,15,18,51
2942,0,33,0,17,50
2943,0,18,0,17,35
2944,0,32,0,17,49
2946,0,33,0,18,51
2947,0,16,0,18,34
2948,0,35,0,16,51
2949,0,17,0,16,33
2952,0,33,0,17,50
2955,0,16,17,16,49
2957,0,16,0,16,32
2958,0,35,0,16,51
2959,0,19,0,16,35
2960,0,32,0,16,48
2961,0,16,0,16,32
2962,0,33,0,18,51
2963,0,17,0,18,35
2964,0,35,14,17,66
2965,0,17,14,17,48
2966,0,31,0,18,49
2968,0,34,17,18,69
2969,0,16,17,18,51
2972,0,31,17,17,65
2974,0,34,18,16,68
2975,0,17,18,16,51
2976,0,34,16,19,69
2977,0,16,16,19,51
2978,0,35,0,16,51
2980,0,31,0,18,49
2981,0,15,0,18,33
2982,0,35,0,16,51
2983,0,17,0,16,33
2984,0,33,0,17,50
2985,0,17,0,17,34
2987,0,15,0,17,32
2989,0,17,0,16,33
2990,0,33,0,16,49
2991,0,17,0,16,33
2994,0,34,14,19,67
2995,0,18,14,19,51
2996,0,33,0,16,49
2997,0,19,0,16,35
2998,0,32,0,16,48
3000,0,34,16,17,67
3001,0,18,16,17,51
3003,0,17,0,16,33
3006,0,31,0,17,48
3007,0,15,0,17,32
3009,0,16,17,16,49
3010,0,33,0,19,52
3011,0,16,0,19,35
3012,0,35,17,17,69
3014,0,34,0,16,50
3015,0,17,0,16,33
3016,0,33,0,16,49
3019,0,17,0,17,34
3020,0,34,0,15,49
3022,0,32,0,18,50
3023,0,17,0,18,35
3024,0,34,0,16,50
3026,0,32,0,17,49
3027,0,16,0,17,33
3028,0,35,0,16,51
3029,0,18,0,16,34
3031,0,16,0,17,33
3032,0,33,0,17,50
3033,0,16,0,17,33
3035,0,17,0,16,33
3036,0,35,0,16,51
3037,0,19,0,16,35
3038,0,35,0,14,49
3040,0,30,0,18,48
3041,0,16,0,18,34
3043,0,16,0,16,32
3044,0,32,18,17,67
3045,0,16,18,17,51
3047,0,17,17,17,51
3048,0,34,16,15,65
3050,0,31,0,18,49
3051,0,15,0,18,33
3052,0,34,17,17,68
3053,0,16,17,17,50
3054,0,34,0,16,50
3056,0,34,0,17,51
3058,0,32,0,17,49
3061,0,16,0,17,33
3062,0,34,17,17,68
3063,0,17,17,17,51
3064,0,34,0,17,51
3065,0,17,0,17,34
3066,0,32,0,17,49
3068,0,34,0,16,50
3071,0,18,0,15,33
3072,0,34,16,16,66
3073,0,19,16,16,51
3074,0,32,0,17,49
3075,0,16,0,17,33
3076,0,33,0,19,52
3078,0,35,0,16,51
3079,0,16,0,16,32
3082,0,32,0,18,50
3083,0,16,0,18,34
3084,0,34,0,16,50
3085,0,16,0,16,32
3086,0,32,0,18,50
3088,0,34,0,18,52
3089,0,16,0,18,34
3090,0,34,0,17,51
3093,0,17,0,15,32
3094,0,34,15,17,66
3095,0,19,15,17,51
3097,0,17,0,17,34
3098,0,32,18,16,66
3099,0,15,18,16,49
3100,0,34,16,19,69
3101,0,16,16,19,51
3103,0,19,16,17,52
3104,0,33,15,18,66
3105,0,17,15,18,50
3106,0,33,17,16,66
3107,0,18,17,16,51
3108,0,33,0,17,50
3109,0,16,0,17,33
3110,0,33,17,17,67
3111,0,16,17,17,50
3112,0,34,17,15,66
3113,0,17,17,15,49
3114,0,32,0,16,48
3116,0,34,18,16,68
3117,0,18,18,16,52
3118,0,34,0,16,50
3119,0,16,0,16,32
3121,0,17,0,16,33
3122,0,33,0,16,49
3123,0,17,0,16,33
3125,0,18,0,16,34
3126,0,32,0,17,49
3127,0,16,0,17,33
3128,0,35,0,16,51
3129,0,18,0,16,34
3130,0,33,0,16,49
3132,0,33,0,14,47
3133,0,17,0,14,31
3134,0,34,0,17,51
3136,0,33,0,16,49
3138,0,32,0,18,50
3139,0,16,0,18,34
3140,0,34,0,18,52
3142,0,34,0,15,49
3146,0,32,0,17,49
3147,0,16,0,17,33
3149,0,16,0,18,34
3150,0,33,0,16,49
3151,0,15,0,16,31
3152,0,35,0,16,51
3153,0,19,0,16,35
3155,0,17,0,16,33
3157,0,17,0,16,33
3158,0,32,0,17,49
3159,0,16,0,17,33
3161,0,18,0,17,35
3164,0,33,0,16,49
3165,0,17,0,16,33
3167,0,18,0,16,34
3168,0,33,0,17,50
3169,0,17,0,17,34
3170,0,33,0,17,50
3172,0,34,0,16,50
3175,0,17,17,17,51
3176,0,34,0,17,51
3177,0,17,0,17,34
3178,0,33,17,17,67
3180,0,34,0,15,49
3182,0,32,0,17,49
3183,0,17,0,17,34
3184,0,33,16,17,66
3185,0,16,16,17,49
3187,0,17,0,17,34
3188,0,35,0,15,50
3189,0,18,0,15,33
3192,0,35,0,15,50
3193,0,18,0,15,33
3196,0,34,0,15,49
3199,0,16,0,18,34
3201,0,18,0,15,33
3202,0,30,0,20,50
3203,0,15,0,20,35
3204,0,37,15,17,69
3206,0,32,17,16,65
3207,0,17,17,16,50
3208,0,33,0,16,49
3211,0,18,17,16,51
3212,0,33,0,18,51
3214,0,34,0,15,49
3216,0,34,0,16,50
3217,0,19,0,16,35
3218,0,34,0,14,48
3219,0,18,0,14,32
3220,0,31,16,17,64
3221,0,17,16,17,50
3222,0,33,0,18,51
3224,0,35,16,16,67
3225,0,17,16,16,49
3226,0,32,17,17,66
3227,0,16,17,17,50
3228,0,34,0,17,51
3229,0,17,0,17,34
3231,0,15,0,18,33
3232,0,35,0,15,50
3233,0,17,0,15,32
3234,0,33,0,16,49
3235,0,18,0,16,34
3236,0,33,0,17,50
3238,0,33,0,17,50
3239,0,16,0,17,33
3241,0,16,0,16,32
3242,0,35,0,16,51
3243,0,19,0,16,35
3244,0,32,0,17,49
3245,0,16,0,17,33
3247,0,18,0,16,34
3249,0,17,0,16,33
3250,0,32,0,18,50
3252,0,34,0,17,51
3256,0,32,0,18,50
3258,0,34,0,19,53
3259,0,16,0,19,35
3262,0,34,0,18,52
3263,0,16,0,18,34
3265,0,15,0,18,33
3267,0,17,0,16,33
3269,0,17,16,17,50
3270,0,33,16,16,65
3271,0,17,16,16,49
3272,0,32,17,17,66
3273,0,16,17,17,50
3274,0,34,0,17,51
3275,0,17,0,17,34
3277,0,17,0,17,34
3278,0,34,0,16,50
3279,0,17,0,16,33
3280,0,34,0,14,48
3281,0,18,0,14,32
3282,0,31,0,17,48
3283,0,17,0,17,34
3284,0,34,0,18,52
3286,0,33,0,16,49
3287,0,15,0,16,31
3288,0,34,0,15,49
3289,0,18,0,15,33
3290,0,33,0,17,50
3291,0,18,0,17,35
3293,0,17,0,15,32
3294,0,33,0,17,50
3295,0,18,0,17,35
3296,0,34,0,16,50
3297,0,17,0,16,33
3298,0,32,16,18,66
3299,0,16,16,18,50
3300,0,34,0,17,51
3301,0,18,0,17,35
3304,0,35,0,15,50
3306,0,32,0,17,49
3307,0,17,0,17,34
3309,0,14,0,21,35
3310,0,36,16,17,69
3311,0,15,16,17,48
3312,0,33,0,18,51
3314,0,34,17,16,67
3315,0,16,17,16,49
3316,0,33,0,17,50
3317,0,16,0,17,33
3318,0,34,15,17,66
3319,0,17,15,17,49
3321,0,17,19,16,52
3322,0,35,0,17,52
3324,0,33,17,17,67
3326,0,34,16,17,67
3327,0,17,16,17,50
3328,0,33,17,16,66
3330,0,33,17,17,67
3331,0,16,17,17,50
3332,0,34,0,15,49
3333,0,17,0,15,32
3334,0,32,0,17,49
3335,0,17,0,17,34
3336,0,33,0,19,52
3342,0,31,0,20,51
3343,0,15,0,20,35
3344,0,36,0,16,52
3345,0,16,0,16,32
3346,0,33,18,16,67
3348,0,34,17,17,68
3349,0,16,17,17,50
3350,0,34,16,16,66
3352,0,32,16,18,66
3353,0,16,16,18,50
3354,0,34,17,16,67
3355,0,18,17,16,51
3356,0,33,0,17,50
3357,0,16,0,17,33
3358,0,33,18,16,67
3360,0,34,16,17,67
3362,0,33,16,17,66
3364,0,33,17,17,67
3366,0,34,0,16,50
3367,0,17,0,16,33
3368,0,32,18,17,67
3369,0,16,18,17,51
3370,0,35,0,16,51
3371,0,17,0,16,33
3372,0,33,16,28,77
3373,0,17,16,28,61
3374,0,44,0,26,70
3376,0,26,0,13,39
3377,17,29,17,17,80
3378,0,29,17,17,63
3379,0,16,17,17,50
3381,0,17,16,18,51
3383,0,18,0,17,35
3384,0,34,0,16,50
3385,0,17,0,16,33
3386,0,32,0,16,48
3387,0,16,0,16,32
3388,0,32,19,16,67
3393,0,17,16,17,50
3396,0,34,16,16,66
3397,0,17,16,16,49
3398,0,32,0,18,50
3399,0,16,0,18,34
3400,0,34,0,17,51
3401,0,16,0,17,33
3402,0,34,18,14,66
3403,0,17,18,14,49
3404,0,32,19,15,66
3406,0,34,18,16,68
3407,0,15,18,16,49
3408,0,34,0,15,49
3409,0,16,0,15,31
3410,0,32,0,17,49
3411,0,17,0,17,34
3413,0,18,0,16,34
3415,0,16,16,19,51
3417,0,19,16,18,53
3419,0,18,16,16,50
3420,0,32,0,17,49
3421,0,16,0,17,33
3422,0,33,17,16,66
3423,0,16,17,16,49
3424,0,33,0,17,50
3425,0,16,0,17,33
3427,0,18,15,17,50
3428,0,32,0,17,49
3430,0,33,0,18,51
3431,0,16,0,18,34
3432,0,35,16,16,67
3434,0,32,17,16,65
3435,0,16,17,16,49
3436,0,33,17,16,66
3438,0,33,17,18,68
3439,0,16,17,18,51
3441,0,18,17,16,51
3442,0,33,16,17,66
3443,0,16,16,17,49
3444,0,33,16,16,65
3445,0,17,16,16,49
3447,0,16,18,24,58
3448,0,42,0,10,52
3450,0,26,0,26,52
3451,16,26,0,28,70
3452,0,26,0,28,54
3453,0,45,0,17,62
3454,18,17,0,17,52
3455,0,17,0,17,34
3456,0,33,0,16,49
3458,0,33,0,17,50
3459,0,17,0,17,34
3460,0,34,0,17,51
3461,0,17,0,17,34
3462,0,34,0,17,51
3463,0,17,0,17,34
3464,0,34,0,16,50
3465,0,17,0,16,33
3466,0,33,0,15,48
3467,0,17,0,15,32
3468,0,32,0,16,48
3469,0,17,0,16,33
3470,0,33,0,18,51
3473,0,16,0,16,32
3474,0,32,0,17,49
3475,0,16,0,17,33
3477,0,17,0,16,33
3478,0,34,0,16,50
3479,0,18,0,16,34
3480,0,32,0,17,49
3484,0,32,18,16,66
3485,0,15,18,16,49
3489,0,16,16,19,51
3490,0,35,17,16,68
3491,0,19,17,16,52
3492,0,33,0,17,50
3493,0,16,0,17,33
3494,0,32,17,17,66
3495,0,15,17,17,49
3496,0,34,16,18,68
3498,0,34,16,17,67
3500,0,33,16,17,66
3502,0,33,17,16,66
3505,0,16,17,16,49
3506,0,33,0,17,50
3508,0,34,15,19,68
3509,0,17,15,19,51
3510,0,34,15,17,66
3511,0,19,15,17,51
3513,0,17,18,16,51
3515,0,16,17,16,49
3520,0,32,0,19,51
3524,0,31,0,16,47
3527,0,17,18,16,51
3529,0,16,0,16,32
3530,0,34,0,17,51
3532,0,33,0,18,51
3533,0,16,0,18,34
3534,0,34,0,16,50
3537,0,17,16,16,49
3538,0,32,18,17,67
3541,0,17,16,16,49
3542,0,32,0,18,50
3543,0,16,0,18,34
3545,0,16,0,18,34
3546,0,33,0,18,51
3547,0,15,0,18,33
3550,0,32,16,18,66
3551,0,19,16,18,53
3553,0,18,0,16,34
3554,0,32,0,18,50
3555,0,16,0,18,34
3556,0,37,0,10,47
3557,0,19,0,10,29
3558,0,30,0,16,46
3559,20,34,0,16,70
3560,0,34,0,16,50
3561,0,18,0,16,34
3563,0,18,0,16,34
3564,0,33,0,16,49
3565,0,17,0,16,33
3566,0,32,0,17,49
3567,0,16,0,17,33
3568,0,34,0,16,50
3569,0,17,0,16,33
3570,0,33,16,21,70
3571,0,17,16,21,54
3572,0,37,0,14,51
3573,21,29,0,17,67
3574,0,29,0,17,46
3575,0,15,0,17,32
3576,0,33,0,18,51
3577,0,16,0,18,34
3578,0,35,0,15,50
3579,0,17,0,15,32
3582,0,33,0,18,51
3583,0,16,0,18,34
3584,0,35,0,14,49
3586,0,33,0,15,48
3587,0,19,0,15,34
3588,0,33,0,15,48
3589,0,18,0,15,33
3590,0,33,0,17,50
3594,0,35,0,17,52
3595,0,18,0,17,35
3596,0,33,0,18,51
3597,0,16,0,18,34
3598,0,34,0,16,50
3599,0,16,0,16,32
3600,0,33,0,15,48
3601,0,17,0,15,32
3602,0,32,0,17,49
3603,0,17,0,17,34
3607,0,18,17,15,50
3608,0,32,0,17,49
3609,0,15,0,17,32
3610,0,34,0,17,51
3612,0,34,0,15,49
3613,0,17,0,15,32
3615,0,17,0,17,34
3619,0,16,0,18,34
3620,0,33,17,16,66
3621,0,15,17,16,48
3622,0,33,0,18,51
3624,0,35,16,17,68
3625,0,17,16,17,50
3627,0,17,0,15,32
3629,0,17,0,17,34
3630,0,34,0,16,50
3632,0,35,17,14,66
3633,0,19,17,14,50
3635,0,14,0,17,31
3636,0,36,0,15,51
3637,0,19,0,15,34
3638,0,31,17,16,64
3640,0,33,0,18,51
3641,0,16,0,18,34
3643,0,18,0,14,32
3644,0,32,0,18,50
3645,0,18,0,18,36
3647,0,14,18,18,50
3649,0,18,0,15,33
3650,0,32,0,16,48
3651,0,17,0,16,33
3652,0,32,0,16,48
3655,0,17,0,18,35
3657,0,17,0,15,32
3658,0,31,0,19,50
3660,0,35,0,17,52
3661,0,16,0,17,33
3663,0,17,0,16,33
3664,0,34,16,16,66
3665,0,18,16,16,50
3666,0,32,0,17,49
3667,0,16,0,17,33
3668,0,34,0,17,51
3669,0,17,0,17,34
3670,0,33,0,16,49
3671,0,16,0,16,32
3672,0,32,0,18,50
3676,0,34,0,15,49
3678,0,33,0,17,50
3679,0,18,0,17,35
3680,0,33,0,16,49
3681,0,16,0,16,32
3682,0,36,0,12,48
3683,0,20,0,12,32
3684,0,30,0,19,49
3686,0,35,0,17,52
3688,0,32,0,17,49
3689,0,15,0,17,32
3690,0,34,0,17,51
3691,0,17,0,17,34
3692,0,32,0,18,50
3693,0,15,0,18,33
3696,0,32,0,17,49
3701,0,16,17,18,51
3702,0,35,0,17,52
3703,0,18,0,17,35
3704,0,35,0,15,50
3705,0,18,0,15,33
3707,0,16,0,17,33
3708,0,34,0,15,49
3713,0,19,0,14,33
3714,0,33,0,16,49
3715,0,19,0,16,35
3716,0,32,0,16,48
3717,0,16,0,16,32
3718,0,33,0,15,48
3722,0,35,0,16,51
3723,0,18,0,16,34
3724,0,33,0,16,49
3726,0,32,17,18,67
3727,0,16,17,18,51
3729,0,18,17,16,51
3731,0,16,0,16,32
3733,0,18,15,18,51
3735,0,18,17,17,52
3737,0,17,0,15,32
3739,0,17,17,15,49
3740,0,32,0,17,49
3742,0,35,0,18,53
3743,0,18,0,18,36
3744,0,32,0,17,49
3745,0,14,0,17,31
3746,0,34,0,16,50
3749,0,18,16,17,51
3752,0,33,18,15,66
3756,0,35,0,17,52
3758,0,31,18,16,65
3759,0,14,18,16,48
3760,0,34,0,18,52
3761,0,16,0,18,34
3762,0,35,16,16,67
3763,0,17,16,16,49
3764,0,32,0,16,48
3765,0,16,0,16,32
3766,0,34,17,17,68
3767,0,18,17,17,52
3768,0,34,16,16,66
3769,0,17,16,16,49
3773,0,16,0,17,33
3774,0,34,0,16,50
3778,0,34,0,16,50
3780,0,34,0,17,51
3782,0,34,0,16,50
3783,0,17,0,16,33
3784,0,33,0,15,48
3786,0,33,0,17,50
3788,0,32,0,17,49
3789,0,15,0,17,32
3790,0,34,0,17,51
3792,0,34,0,15,49
3793,0,17,0,15,32
3794,0,33,0,16,49
3795,0,18,0,16,34
3796,0,32,0,17,49
3798,0,35,0,17,52
3799,0,18,0,17,35
3800,0,32,0,16,48
3801,0,15,0,16,31
3802,0,33,0,17,50
3803,0,17,0,17,34
3804,0,33,0,17,50
3805,0,16,0,17,33
3806,0,33,18,17,68
3807,0,16,18,17,51
3808,0,35,16,18,69
3809,0,17,16,18,51
3810,0,34,0,16,50
3812,0,32,0,18,50
3813,0,16,0,18,34
3814,0,34,0,16,50
3815,0,16,0,16,32
3816,0,32,0,18,50
3817,0,16,0,18,34
3821,0,17,0,16,33
3822,0,33,16,17,66
3823,0,17,16,17,50
3825,0,17,0,16,33
3827,0,18,17,17,52
3828,0,34,0,20,54
3830,0,20,0,30,50
3832,0,32,16,16,64
3833,0,16,16,16,48
3834,0,32,0,17,49
3836,0,34,0,18,52
3837,0,17,0,18,35
3838,0,35,0,17,52
3839,0,17,0,17,34
3841,0,14,0,19,33
3843,0,14,19,16,49
3844,0,35,17,17,69
3846,0,34,15,18,67
3847,0,17,15,18,50
3849,0,18,0,16,34
3853,0,17,16,17,50
3854,0,33,0,18,51
3855,0,17,0,18,35
3856,0,35,16,21,72
3857,0,17,16,21,54
3859,0,21,0,17,38
3860,0,17,0,27,44
3861,0,45,19,15,79
3865,0,15,0,16,31
3867,0,15,18,17,50
3868,0,35,0,16,51
3869,0,17,0,16,33
3870,0,32,19,17,68
3871,0,16,19,17,52
3873,0,17,0,16,33
3875,0,19,13,18,50
3876,0,31,15,17,63
3877,0,18,15,17,50
3879,0,17,0,16,33
3880,0,34,0,18,52
3881,0,18,0,18,36
3882,0,35,0,14,49
3884,0,32,0,15,47
3885,0,18,0,15,33
3887,0,17,18,16,51
3888,0,34,18,14,66
3889,0,16,18,14,48
3890,0,32,0,19,51
3891,0,14,0,19,33
3892,0,34,0,18,52
3894,0,35,0,17,52
3895,0,17,0,17,34
3897,0,16,0,17,33
3898,0,35,0,14,49
3899,0,18,0,14,32
3900,0,31,0,15,46
3901,0,17,0,15,32
3902,0,32,0,19,51
3903,0,17,0,19,36
3904,0,35,18,15,68
3905,0,16,18,15,49
3907,0,15,0,16,31
3911,0,15,0,17,32
3912,0,35,0,15,50
3913,0,18,0,15,33
3914,0,31,0,18,49
3915,0,16,0,18,34
3916,0,36,0,17,53
3918,0,33,0,14,47
3919,0,16,0,14,30
3921,0,21,0,14,35
3924,0,32,0,18,50
3925,0,16,0,18,34
3927,0,15,0,18,33
3928,0,37,0,12,49
3929,0,19,0,12,31
3930,0,31,0,17,48
3931,0,19,0,17,36
3932,0,33,0,17,50
3933,0,16,0,17,33
3934,0,33,0,16,49
3935,0,16,0,16,32
3936,0,33,0,16,49
3937,0,17,0,16,33
3939,0,16,0,19,35
3940,0,35,0,16,51
3941,0,16,0,16,32
3942,0,34,0,15,49
3943,0,18,0,15,33
3945,0,19,0,16,35
3946,0,33,0,16,49
3947,0,17,0,16,33
3949,0,17,15,17,49
3950,0,32,17,16,65
3951,0,17,17,16,50
3952,0,33,0,17,50
3953,0,16,0,17,33
3955,0,16,0,17,33
3956,0,34,0,18,52
3957,0,17,0,18,35
3959,0,15,0,19,34
3961,0,15,0,18,33
3962,0,35,0,16,51
3963,0,17,0,16,33
3964,0,31,0,18,49
3965,0,15,0,18,33
3966,0,33,0,19,52
3967,0,15,0,19,34
3969,0,15,0,16,31
3972,0,33,0,16,49
3974,0,33,0,19,52
3976,0,35,16,17,68
3977,0,16,16,17,49
3978,0,33,0,16,49
3979,0,17,0,16,33
3980,0,32,18,16,66
3981,0,16,18,16,50
3982,0,34,16,16,66
3984,0,32,0,18,50
3986,0,35,15,18,68
3987,0,17,15,18,50
3990,0,34,0,17,51
3991,0,18,0,17,35
3994,0,33,0,15,48
3995,0,17,0,15,32
3997,0,18,17,15,50
3999,0,15,18,17,50
4000,0,35,0,16,51
4001,0,17,0,16,33
4002,0,33,16,16,65
4003,0,17,16,16,49
4004,0,32,18,16,66
4005,0,16,18,16,50
4006,0,34,16,18,68
4008,0,34,0,15,49
4009,0,18,0,15,33
4010,0,34,15,17,66
4011,0,19,15,17,51
4013,0,17,0,18,35
4015,0,16,17,16,49
4020,0,34,0,15,49
4021,0,17,0,15,32
4022,0,32,18,15,65
4024,0,33,0,18,51
4026,0,36,15,17,68
4027,0,18,15,17,50
4029,0,17,16,17,50
4031,0,17,0,16,33
4032,0,33,16,15,64
4033,0,17,16,15,48
4035,0,15,0,19,34
4036,0,37,0,16,53
4038,0,32,0,17,49
4040,0,35,17,16,68
4041,0,18,17,16,51
4042,0,33,0,15,48
4043,0,16,0,15,31
4045,0,18,0,15,33
4046,0,32,17,16,65
4047,0,17,17,16,50
4048,0,33,0,18,51
4049,0,16,0,18,34
4050,0,35,0,16,51
4051,0,17,0,16,33
4052,0,33,0,16,49
4053,0,17,0,16,33
4054,0,37,12,17,66
4055,0,21,12,17,50
4056,0,29,0,17,46
4058,0,33,19,17,69
4060,0,36,16,16,68
4061,0,17,16,16,49
4062,0,32,0,17,49
4063,0,16,0,17,33
4064,0,34,14,17,65
4065,0,17,14,17,48
4066,0,31,0,16,47
4068,0,36,0,16,52
4071,0,18,0,16,34
4072,0,30,0,17,47
4076,0,34,0,16,50
4077,0,16,0,16,32
4079,0,18,0,17,35
4081,0,16,0,16,32
4083,0,18,0,17,35
4085,0,14,0,19,33
4086,0,34,0,15,49
4087,0,15,0,15,30
4089,0,20,0,17,37
4093,0,16,0,19,35
4095,0,17,0,16,33
4096,0,30,0,18,48
4097,0,14,0,18,32
4099,0,18,0,15,33
4100,0,34,0,15,49
4101,0,19,0,15,34
4103,0,15,0,18,33
4104,0,33,0,17,50
4105,0,15,0,17,32
4106,0,36,0,17,53
4107,0,19,0,17,36
4108,0,31,0,19,50
4109,0,14,0,19,33
4110,0,34,0,18,52
4111,0,15,0,18,33
4112,0,39,0,29,68
4113,0,21,0,29,50
4115,18,33,0,15,66
4116,0,33,0,15,48
4117,0,18,0,15,33
4118,0,34,0,14,48
4120,0,30,0,18,48
4122,0,35,0,18,53
4123,0,17,0,18,35
4124,0,35,0,15,50
4126,0,32,0,18,50
4127,0,17,0,18,35
4128,0,33,0,18,51
4129,0,15,0,18,33
4130,0,35,0,15,50
4131,0,17,0,15,32
4132,0,33,0,15,48
4133,0,18,0,15,33
4134,0,32,17,16,65
4135,0,17,17,16,50
4136,0,33,0,17,50
4137,0,16,0,17,33
4138,0,35,0,17,52
4141,0,17,14,19,50
4143,0,19,17,15,51
4145,0,15,0,18,33
4147,0,15,0,17,32
4148,0,34,0,16,50
4149,0,17,0,16,33
4150,0,35,0,15,50
4151,0,19,0,15,34
4154,0,36,0,13,49
4155,0,16,0,13,29
4157,0,17,0,16,33
4159,0,18,0,16,34
4160,0,34,0,15,49
4162,0,33,0,17,50
4163,0,18,0,17,35
4164,0,34,0,16,50
4165,0,17,0,16,33
4166,0,33,0,17,50
4167,0,17,0,17,34
4168,0,34,0,16,50
4169,0,17,0,16,33
4170,0,32,0,16,48
4171,0,16,0,16,32
4174,0,33,0,18,51
4175,0,17,0,18,35
4177,0,15,18,15,48
4179,0,15,17,16,48
4180,0,33,19,17,69
4181,0,16,19,17,52
4183,0,17,0,14,31
4184,0,32,0,16,48
4185,0,18,0,16,34
4187,0,16,17,19,52
4190,0,31,0,16,47
4191,0,16,0,16,32
4192,0,33,0,18,51
4194,0,34,0,17,51
4195,0,16,0,17,33
4196,0,33,16,17,66
4197,0,16,16,17,49
4199,0,17,19,16,52
4200,0,35,0,17,52
4203,0,17,0,16,33
4204,0,33,16,16,65
4205,0,17,16,16,49
4206,0,32,0,17,49
4208,0,33,18,16,67
4209,0,16,18,16,50
4210,0,34,18,15,67
4211,0,16,18,15,49
4213,0,15,0,16,31
4214,0,35,0,14,49
4215,0,19,0,14,33
4217,0,20,14,17,51
4218,0,31,0,17,48
4219,0,17,0,17,34
4221,0,16,0,18,34
4222,0,33,0,19,52
4223,0,15,0,19,34
4225,0,17,0,15,32
4226,0,31,0,19,50
4227,0,16,0,19,35
4228,0,35,0,15,50
4229,0,16,0,15,31
4230,0,32,0,16,48
4231,0,17,0,16,33
4232,0,33,0,17,50
4236,0,33,0,18,51
4237,0,19,0,18,37
4239,0,15,0,16,31
4240,0,35,0,16,51
4243,0,17,0,15,32
4244,0,33,0,16,49
4245,0,18,0,16,34
4246,0,33,18,14,65
4247,0,17,18,14,49
4249,0,14,0,17,31
4250,0,34,0,18,52
4251,0,17,0,18,35
4252,0,34,15,19,68
4253,0,16,15,19,50
4254,0,34,16,17,67
4255,0,19,16,17,52
4256,0,33,0,16,49
4257,0,17,0,16,33
4259,0,17,0,17,34
4260,0,33,0,18,51
4262,0,34,0,15,49
4265,0,19,0,15,34
4267,0,16,0,18,34
4268,0,31,14,24,69
4269,0,13,14,24,51
4270,14,24,0,15,53
4271,0,24,0,15,39
4272,0,33,0,17,50
4274,0,32,0,18,50
4276,0,34,0,16,50
4278,0,34,0,16,50
4280,0,33,0,17,50
4281,0,17,0,17,34
4283,0,15,18,17,50
4284,0,35,0,17,52
4286,0,34,0,16,50
4287,0,17,0,16,33
4288,0,30,19,16,65
4289,0,14,19,16,49
4290,0,35,18,15,68
4293,0,15,0,17,32
4295,0,18,0,16,34
4296,0,32,17,17,66
4297,0,16,17,17,50
4298,0,34,0,16,50
4300,0,32,0,17,49
4301,0,16,0,17,33
4303,0,17,17,16,50
4308,0,35,0,16,51
4309,0,17,0,16,33
4311,0,17,0,16,33
4312,0,32,16,19,67
4315,0,19,14,18,51
4316,0,32,0,18,50
4317,0,18,0,18,36
4318,0,34,0,16,50
4320,0,33,18,16,67
4321,0,17,18,16,51
4323,0,16,16,16,48
4324,0,32,17,18,67
4326,0,35,0,16,51
4327,0,18,0,16,34
4328,0,33,15,17,65
4329,0,17,15,17,49
4331,0,17,17,17,51
4332,0,34,0,16,50
4336,0,35,16,17,68
4337,0,18,16,17,51
4338,0,33,16,16,65
4339,0,17,16,16,49
4340,0,32,0,18,50
4342,0,34,17,16,67
4343,0,16,17,16,49
4345,0,16,0,17,33
4347,0,17,16,17,50
4348,0,33,0,16,49
4349,0,17,0,16,33
4350,0,34,0,16,50
4351,0,18,0,16,34
4354,0,32,0,21,53
4357,0,11,0,20,31
4358,0,36,0,17,53
4360,0,34,0,15,49
4361,0,17,0,15,32
4362,0,32,0,17,49
4363,0,17,0,17,34
4364,0,33,16,18,67
4365,0,16,16,18,50
4366,0,34,17,15,66
4367,0,18,17,15,50
4368,0,32,0,18,50
4370,0,34,0,16,50
4371,0,16,0,16,32
4374,0,35,16,16,67
4376,0,32,18,16,66
4379,0,16,0,16,32
4380,0,34,16,16,66
4381,0,18,16,16,50
4382,0,32,18,15,65
4383,0,16,18,15,49
4385,0,15,18,17,50
4386,0,35,15,18,68
4387,0,17,15,18,50
4389,0,18,16,17,51
4390,0,33,16,16,65
4391,0,17,16,16,49
4392,0,32,19,16,67
4394,0,35,0,15,50
4397,0,18,16,18,52
4398,0,34,0,17,51
4400,0,33,17,15,65
4401,0,16,17,15,48
4404,0,34,0,17,51
4405,0,15,0,17,32
4406,0,34,0,16,50
4407,0,17,0,16,33
4408,0,33,0,17,50
4411,0,16,0,18,34
4412,0,34,0,16,50
4413,0,16,0,16,32
4414,0,32,18,16,66
4415,0,16,18,16,50
4417,0,16,0,17,33
4419,0,17,0,18,35
4420,0,33,16,17,66
4421,0,15,16,17,48
4422,0,33,0,16,49
4424,0,34,16,16,66
4425,0,18,16,16,50
4427,0,16,0,17,33
4428,0,35,15,18,68
4429,0,18,15,18,51
4430,0,33,17,17,67
4431,0,18,17,17,52
4432,0,34,0,15,49
4434,0,30,19,16,65
4435,0,15,19,16,50
4437,0,16,0,17,33
4438,0,34,0,16,50
4439,0,17,0,16,33
4442,0,33,0,17,50
4443,0,17,0,17,34
4444,0,35,0,15,50
4445,0,18,0,15,33
4446,0,33,0,16,49
4448,0,33,0,17,50
4449,0,17,0,17,34
4450,0,33,0,15,48
4451,0,16,0,15,31
4452,0,32,0,17,49
4453,0,17,0,17,34
4454,0,33,0,18,51
4455,0,16,0,18,34
4457,0,17,0,17,34
4458,0,32,0,18,50
4460,0,33,0,17,50
4461,0,15,0,17,32
4465,0,18,0,15,33
4467,0,16,0,19,35
4468,0,35,0,17,52
4469,0,16,0,17,33
4470,0,33,0,18,51
4471,0,16,0,18,34
4472,0,35,0,17,52
4473,0,17,0,17,34
4474,0,32,0,17,49
4475,0,15,0,17,32
4477,0,16,0,17,33
4480,0,33,0,16,49
4481,0,18,0,16,34
4482,0,43,0,26,69
4483,0,27,0,26,53
4484,0,26,0,15,41
4485,17,33,0,16,66
4486,0,33,0,16,49
4487,0,18,0,16,34
4488,0,33,0,16,49
4489,0,17,0,16,33
4490,0,33,0,18,51
4491,0,17,0,18,35
4492,0,33,0,17,50
4493,0,15,0,17,32
4495,0,17,16,16,49
4497,0,16,0,19,35
4498,0,35,0,15,50
4499,0,16,0,15,31
4500,0,33,0,17,50
4501,0,18,0,17,35
4502,0,34,16,16,66
4503,0,17,16,16,49
4504,0,32,18,15,65
4505,0,16,18,15,49
4506,0,33,0,17,50
4507,0,15,0,17,32
4508,0,35,0,16,51
4509,0,18,0,16,34
4510,0,32,0,17,49
4512,0,34,0,16,50
4513,0,17,0,16,33
4517,0,18,0,16,34
4518,0,33,0,16,49
4520,0,35,15,16,66
4521,0,19,15,16,50
4522,0,31,0,16,47
4523,0,16,0,16,32
4524,0,34,0,17,51
4525,0,18,0,17,35
4526,0,33,0,17,50
4527,0,16,0,17,33
4528,0,34,16,17,67
4530,0,33,17,15,65
4533,0,15,0,19,34
4536,0,36,0,16,52
4538,0,33,0,16,49
4540,0,35,0,16,51
4542,0,32,0,16,48
4543,0,16,0,16,32
4545,0,17,17,16,50
4546,0,33,0,17,50
4547,0,16,0,17,33
4548,0,34,0,17,51
4549,0,17,0,17,34
4550,0,33,0,17,50
4551,0,16,0,17,33
4552,0,33,0,17,50
4553,0,16,0,17,33
4554,0,34,0,16,50
4555,0,17,0,16,33
4556,0,34,0,17,51
4557,0,18,0,17,35
4559,0,17,0,15,32
4560,15,17,0,16,48
4561,0,17,0,16,33
4562,0,34,0,18,52
4565,0,15,0,16,31
4566,0,33,0,16,49
4567,0,17,0,16,33
4568,0,32,18,16,66
4569,0,16,18,16,50
4571,0,16,0,18,34
4572,0,34,0,16,50
4573,0,16,0,16,32
4574,0,34,0,16,50
4575,0,18,0,16,34
4576,0,32,0,17,49
4577,0,16,0,17,33
4578,0,35,0,15,50
4581,0,18,0,16,34
4582,0,33,0,16,49
4583,0,17,0,16,33
4584,0,34,0,16,50
4585,0,18,0,16,34
4587,0,16,0,16,32
4588,0,33,0,17,50
4589,0,17,0,17,34
4590,0,37,0,18,55
4591,0,20,0,18,38
4593,0,32,0,18,50
4594,0,17,0,18,35
4595,0,32,0,20,52
4596,0,14,0,20,34
4597,0,35,0,17,52
4599,0,34,0,15,49
4601,0,33,0,15,48
4603,0,33,16,17,66
4605,0,33,18,16,67
4606,0,17,18,16,51
4607,0,34,0,20,54
4608,0,16,0,20,36
4609,0,33,0,18,51
4610,0,13,0,18,31
4611,0,33,0,17,50
4612,0,15,0,17,32
4613,0,34,0,16,50
4614,0,17,0,16,33
4615,0,33,18,15,66
4616,0,17,18,15,50
4621,0,34,0,17,51
4623,0,32,0,19,51
4624,0,15,0,19,34
4625,0,35,0,16,51
4628,0,16,18,15,49
4629,0,33,0,19,52
4630,0,15,0,19,34
4631,0,35,0,17,52
4632,0,16,0,17,33
4633,0,33,0,16,49
4634,0,16,0,16,32
4635,0,32,0,20,52
4636,0,16,0,20,36
4638,0,13,0,19,32
4641,0,34,16,32,82
4642,0,17,16,32,65
4644,0,32,0,3,35
4645,0,22,0,18,40
4646,19,34,0,16,69
4647,0,34,0,16,50
4648,0,16,0,16,32
4649,0,33,0,17,50
4650,0,17,0,17,34
4652,0,14,0,16,30
4653,0,33,19,17,69
4654,0,17,19,17,53
4656,0,17,0,16,33
4657,0,32,0,17,49
4658,0,16,0,17,33
4659,0,34,0,18,52
4660,0,17,0,18,35
4662,0,14,0,20,34
4663,0,33,0,17,50
4664,0,13,0,17,30
4666,0,17,0,19,36
4667,0,34,0,17,51
4668,0,15,0,17,32
4669,0,33,18,15,66
4670,0,16,18,15,49
4671,0,33,0,18,51
4673,0,33,17,16,66
4674,0,15,17,16,48
4675,0,33,17,18,68
4676,0,16,17,18,51
4677,0,35,16,17,68
4678,0,18,16,17,51
4679,0,33,0,17,50
4680,0,17,0,17,34
4682,0,16,0,16,32
4683,0,32,0,18,50
4684,0,16,0,18,34
4686,0,18,0,15,33
4687,0,34,0,16,50
4688,0,19,0,16,35
4689,0,33,14,18,65
4690,0,17,14,18,49
4691,0,32,0,16,48
4692,0,18,0,16,34
4694,0,20,0,13,33
4695,0,30,0,18,48
4696,0,17,0,18,35
4697,0,34,0,14,48
4698,0,16,0,14,30
4701,0,36,0,14,50
4702,0,18,0,14,32
4703,0,32,0,16,48
4704,0,18,0,16,34
4705,0,33,0,15,48
4708,0,17,0,18,35
4710,0,15,0,16,31
4711,0,33,0,17,50
4714,0,17,0,17,34
4716,0,16,0,18,34
4718,0,16,0,17,33
4719,0,35,0,14,49
4721,0,31,0,17,48
4723,0,34,0,16,50
4724,0,17,0,16,33
4725,0,33,0,17,50
4726,0,17,0,17,34
4727,0,35,0,31,66
4728,0,18,0,31,49
4729,0,31,0,21,52
4731,16,16,0,16,48
4732,0,16,0,16,32
4733,0,33,0,16,49
4735,0,34,0,17,51
4737,0,32,0,18,50
4741,0,34,14,17,65
4742,0,18,14,17,49
4743,0,31,0,19,50
4745,0,33,0,18,51
4750,0,17,0,15,32
4753,0,33,0,16,49
4754,0,17,0,16,33
4759,0,35,0,15,50
4760,0,18,0,15,33
4761,0,33,0,16,49
4762,0,18,0,16,34
4763,0,34,0,17,51
4766,0,15,0,18,33
4768,0,16,0,15,31
4770,0,19,0,16,35
4771,0,33,0,17,50
4772,0,17,0,17,34
4773,0,33,16,16,65
4774,0,16,16,16,48
4775,0,32,0,17,49
4776,0,16,0,17,33
4777,0,34,0,17,51
4778,0,17,0,17,34
4779,0,33,0,18,51
4780,0,16,0,18,34
4783,0,33,0,16,49
4784,0,17,0,16,33
4785,0,38,0,12,50
4787,0,28,0,17,45
4788,0,16,0,17,33
4789,0,33,0,18,51
4791,0,35,16,16,67
4792,0,17,16,16,49
4793,0,32,0,18,50
4794,0,16,0,18,34
4795,0,35,16,16,67
4796,0,17,16,16,49
4797,0,32,16,17,65
4799,0,33,0,18,51
4804,0,16,0,17,33
4805,0,35,0,14,49
4806,0,18,0,14,32
4808,0,17,19,16,52
4810,0,16,18,15,49
4811,0,33,0,17,50
4814,0,17,0,16,33
4815,0,32,17,18,67
4816,0,16,17,18,51
4818,0,18,0,16,34
4820,0,17,16,16,49
4821,0,32,16,19,67
4823,0,35,0,16,51
4825,0,34,15,17,66
4826,0,18,15,17,50
4827,0,32,0,16,48
4828,0,17,0,16,33
4829,0,34,0,21,55
4831,0,37,17,17,71
4833,0,34,0,16,50
4834,0,17,0,16,33
4835,0,33,0,14,47
4836,0,17,0,14,31
4837,0,33,16,17,66
4838,0,19,16,17,52
4840,0,17,16,17,50
4841,0,33,0,17,50
4842,0,17,0,17,34
4845,0,36,0,12,48
4847,0,29,0,17,46
4849,0,33,0,18,51
4850,0,16,0,18,34
4853,0,33,0,16,49
4855,0,34,0,16,50
4856,0,18,0,16,34
4857,0,32,0,16,48
4859,0,35,0,16,51
4861,0,33,0,15,48
4862,0,17,0,15,32
4864,0,18,0,15,33
4867,0,34,0,16,50
4868,0,17,0,16,33
4870,0,18,0,16,34
4871,0,34,0,15,49
4872,0,18,0,15,33
4873,0,32,17,17,66
4874,0,17,17,17,51
4877,0,33,0,16,49
4881,0,33,0,17,50
4882,0,16,0,17,33
4883,0,34,0,16,50
4884,0,17,0,16,33
4885,0,33,0,16,49
4887,0,33,0,16,49
4888,0,17,0,16,33
4889,0,33,0,17,50
4890,0,17,0,17,34
4892,0,17,0,18,35
4893,0,33,0,17,50
4894,0,15,0,17,32
4895,0,34,0,17,51
4896,0,17,0,17,34
4898,0,16,0,17,33
4899,0,33,0,16,49
4900,0,16,0,16,32
4902,0,17,0,16,33
4903,0,33,0,16,49
4904,0,17,0,16,33
4906,0,19,0,16,35
4907,0,33,0,15,48
4909,0,32,0,17,49
4911,0,35,0,16,51
4912,0,18,0,16,34
4913,0,34,0,15,49
4914,0,18,0,15,33
4915,0,31,0,17,48
4917,0,34,0,16,50
4918,0,17,0,16,33
4919,0,33,0,16,49
4920,0,17,0,16,33
4921,0,32,0,18,50
4922,0,16,0,18,34
4923,0,34,0,18,52
4924,0,16,0,18,34
4925,0,34,0,16,50
4927,0,33,0,18,51
4930,0,17,0,16,33
4931,0,33,0,17,50
4932,0,17,0,17,34
4933,0,33,0,16,49
4934,0,16,0,16,32
4935,0,34,0,16,50
4937,0,33,0,16,49
4939,0,32,0,17,49
4940,0,16,0,17,33
4942,0,18,0,16,34
4943,0,33,0,17,50
4945,0,33,0,16,49
4946,0,16,0,16,32
4949,0,32,0,17,49
4951,0,32,0,18,50
4952,0,15,0,18,33
4954,0,16,0,17,33
4955,0,35,0,15,50
4956,0,18,0,15,33
4957,0,31,17,17,65
4958,0,16,17,17,50
4960,0,17,17,16,50
4962,0,16,16,17,49
4964,0,17,0,17,34
4965,0,34,0,18,52
4966,0,17,0,18,35
4967,0,35,0,14,49
4968,0,17,0,14,31
4969,0,31,0,19,50
4970,0,17,0,19,36
4972,0,16,0,17,33
4973,0,33,0,15,48
4974,0,16,0,15,31
4976,0,19,16,17,52
4977,0,33,0,16,49
4978,0,17,0,16,33
4980,0,17,0,16,33
4981,0,32,0,18,50
4982,0,16,0,18,34
4985,0,34,0,17,51
4987,0,32,0,18,50
4988,0,15,0,18,33
4989,0,34,0,17,51
4992,0,16,0,17,33
4996,0,19,0,13,32
4997,0,33,0,15,48
4998,0,20,0,15,35
4999,0,31,0,16,47
5000,0,16,0,16,32
5001,0,35,0,15,50
5002,0,19,0,15,34
5004,0,18,0,16,34
5006,0,15,0,17,32
5007,0,36,0,17,53
5010,0,16,0,16,32
5011,0,32,0,17,49
5013,0,34,0,17,51
5014,0,17,0,17,34
5018,0,16,0,16,32
5019,0,34,0,17,51
5020,0,18,0,17,35
5021,0,32,0,16,48
5022,0,15,0,16,31
5024,0,19,0,16,35
5025,0,33,0,16,49
5026,0,17,0,16,33
5027,0,33,0,15,48
5029,0,33,0,18,51
5032,0,14,18,18,50
5034,0,18,16,15,49
5035,0,31,0,19,50
5036,0,15,0,19,34
5038,0,17,16,16,49
5039,0,32,0,15,47
5040,0,16,0,15,31
5041,0,34,17,14,65
5042,0,19,17,14,50
5043,0,31,0,18,49
5044,0,14,0,18,32
5045,0,35,0,17,52
5048,0,17,16,16,49
5049,0,32,16,19,67
5050,0,16,16,19,51
5053,0,34,0,15,49
5054,0,17,0,15,32
5055,0,32,15,17,64
5056,0,17,15,17,49
5060,0,16,0,18,34
5061,0,33,0,18,51
5062,0,15,0,18,33
5064,0,16,17,18,51
5065,0,35,15,16,66
5066,0,18,15,16,49
5067,0,31,17,16,64
5068,0,16,17,16,49
5070,0,16,19,15,50
5073,0,34,16,16,66
5076,0,16,0,17,33
5077,0,33,0,19,52
5078,0,16,0,19,35
5079,0,35,0,16,51
5082,0,18,0,16,34
5083,0,32,17,16,65
5084,0,16,17,16,49
5085,0,33,0,19,52
5086,0,16,0,19,35
5087,0,34,0,18,52
5088,0,15,0,18,33
5095,0,32,0,16,48
5096,0,17,0,16,33
5098,0,19,0,16,35
5099,0,32,0,16,48
5102,0,18,16,17,51
5103,0,33,0,17,50
5104,0,17,0,17,34
5105,0,33,16,18,67
5108,0,18,0,16,34
5109,0,32,18,16,66
5110,0,16,18,16,50
5112,0,16,16,16,48
5114,0,16,18,16,50
5115,0,34,18,15,67
5116,0,16,18,15,49
5119,0,35,16,16,67
5120,0,17,16,16,49
5121,0,32,0,16,48
5122,0,16,0,16,32
5123,0,35,0,15,50
5124,0,19,0,15,34
5125,0,33,0,15,48
5126,0,18,0,15,33
5127,0,34,0,15,49
5128,0,19,0,15,34
5129,0,31,0,18,49
5131,0,36,0,13,49
5132,0,18,0,13,31
5137,0,32,0,14,46
5138,0,19,0,14,33
5139,0,33,0,16,49
5140,0,19,0,16,35
5141,0,32,16,17,65
5144,0,17,0,16,33
5145,0,34,0,15,49
5146,0,18,0,15,33
5148,0,17,0,18,35
5149,0,33,0,16,49
5150,0,15,0,16,31
5151,0,36,0,17,53
5152,0,20,0,17,37
5153,0,32,0,16,48
5154,0,15,0,16,31
5157,0,34,0,17,51
5158,0,15,0,17,32
5159,0,34,0,18,52
5160,0,17,0,18,35
5161,0,33,0,18,51
5162,0,15,0,18,33
5163,0,32,0,19,51
5164,0,14,0,19,33
5165,0,36,0,15,51
5167,0,51,0,4,55
5168,0,36,0,4,40
5169,0,4,15,17,36
5172,0,15,0,18,33
5176,0,16,16,17,49
5177,0,33,0,17,50
5178,0,17,0,17,34
5179,0,33,0,17,50
5181,0,35,0,17,52
5182,0,18,0,17,35
5183,0,32,18,17,67
5184,0,15,18,17,50
5185,0,35,16,17,68
5187,0,33,17,16,66
5188,0,17,17,16,50
5190,0,16,0,16,32
5191,0,32,18,15,65
5192,0,16,18,15,49
5193,0,33,0,20,53
5196,0,19,0,16,35
5197,0,16,0,16,32
5198,0,32,0,35,67
5199,0,16,0,35,51
5201,19,33,16,17,85
5202,0,33,16,17,66
5203,0,17,16,17,50
5205,0,17,0,16,33
5206,0,33,17,17,67
5207,0,17,17,17,51
5208,0,34,17,16,67
5209,0,17,17,16,50
5210,0,33,15,18,66
5211,0,16,15,18,49
5212,0,33,0,17,50
5215,0,16,18,17,51
5218,0,34,16,31,81
5219,0,17,16,31,64
5220,0,47,18,16,81
5221,0,31,18,16,65
5222,17,18,16,34,85
5223,0,18,16,34,68
5224,0,50,16,17,83
5225,0,34,16,17,67
5227,0,16,17,16,49
5230,0,34,16,36,86
5232,0,52,0,14,66
5233,0,36,0,14,50
5237,0,17,16,18,51
5239,0,18,17,16,51
5240,0,33,17,16,66
5241,0,16,17,16,49
5242,0,33,17,17,67
5244,0,34,16,17,67
5245,0,17,16,17,50
5246,0,33,17,16,66
5247,0,17,17,16,50
5248,0,33,18,16,67
5249,0,16,18,16,50
5251,0,16,16,16,48
5252,0,32,17,18,67
5253,0,16,17,18,51
5254,0,35,16,16,67
5256,0,32,17,17,66
5257,0,16,17,17,50
5258,0,34,17,15,66
5259,0,17,17,15,49
5260,0,32,0,17,49
5261,0,15,0,17,32
5262,0,35,16,16,67
5263,0,18,16,16,50
5266,0,34,16,17,67
5267,0,16,16,17,49
5268,0,33,0,16,49
5269,0,17,0,16,33
5271,0,18,17,17,52
5272,0,34,0,16,50
5273,0,17,0,16,33
5274,0,32,0,35,67
5275,0,16,0,35,51
5279,0,15,0,18,33
5280,0,34,0,16,50
5281,0,16,0,16,32
5285,0,18,0,33,51
5286,0,33,0,16,49
5287,18,33,0,17,68
5288,0,33,0,17,50
5289,0,17,0,17,34
5291,0,16,0,17,33
5292,0,33,18,16,67
5293,0,16,18,16,50
5295,0,16,16,34,66
5297,0,34,0,17,51
5298,18,17,0,17,52
5299,0,17,0,17,34
5302,18,17,0,17,52
5303,0,17,0,17,34
5304,0,34,16,16,66
5305,0,17,16,16,49
5306,0,32,16,34,82
5307,0,16,16,34,66
5308,0,50,16,16,82
5314,0,33,0,17,50
5315,0,16,0,17,33
5316,0,34,0,17,51
5317,0,17,0,17,34
5318,0,33,0,17,50
5319,0,16,0,17,33
5321,0,18,0,15,33
5322,0,32,16,18,66
5323,0,17,16,18,51
5324,0,34,0,17,51
5325,0,18,0,17,35
5327,0,33,0,16,49
5329,0,16,0,17,33
5331,0,16,0,17,33
5332,0,33,0,18,51
5333,0,16,0,18,34
5334,0,34,17,18,69
5338,0,48,18,16,82
5339,0,33,18,16,67
5340,0,17,18,16,51
5342,0,32,0,17,49
5343,0,16,0,17,33
5345,0,34,0,34,68
5346,0,18,0,34,52
5347,0,34,0,16,50
5349,0,16,0,18,34
5350,0,35,0,30,65
5351,0,17,0,30,47
5353,16,18,16,35,85
5354,0,18,16,35,69
5355,0,16,0,35,51
5356,0,35,0,16,51
5357,0,19,0,16,35
5358,0,33,0,16,49
5359,0,17,0,16,33
5360,0,33,0,17,50
5361,0,17,0,17,34
5362,0,50,0,35,85
5363,0,33,0,35,68
5365,0,35,0,14,49
5367,0,14,0,18,32
5368,0,34,17,16,67
5369,0,16,17,16,49
5370,0,33,0,17,50
5371,0,16,0,17,33
5373,0,16,0,17,33
5374,0,33,0,19,52
5375,0,16,0,19,35
5376,0,34,0,17,51
5378,0,35,0,16,51
5380,0,33,0,16,49
5381,0,17,0,16,33
5383,0,16,0,17,33
5384,0,34,0,16,50
5385,0,17,0,16,33
5387,0,17,0,16,33
5388,0,33,0,34,67
5390,0,34,0,17,51
5391,0,18,0,17,35
5394,0,51,0,16,67
5395,0,35,0,16,51
5397,0,16,0,17,33
5399,0,16,0,16,32
5401,0,18,0,17,35
5403,0,16,0,16,32
5406,0,33,0,33,66
5407,0,15,0,33,48
5408,0,33,16,17,66
5409,0,17,16,17,50
5412,0,34,0,16,50
5413,0,16,0,16,32
5414,0,33,0,17,50
5415,0,17,0,17,34
5416,0,34,0,34,68
5417,0,17,0,34,51
5418,0,34,0,16,50
5421,0,17,0,16,33
5422,0,50,0,16,66
5423,0,34,0,16,50
5424,0,18,0,16,34
5427,0,17,0,16,33
5428,0,33,0,18,51
5429,0,17,0,18,35
5432,0,17,0,18,35
5433,0,18,0,17,35
5434,0,34,0,16,50
5435,0,17,0,16,33
5437,0,16,0,18,34
5438,0,34,0,17,51
5439,0,16,0,17,33
5440,0,33,0,33,66
5441,0,16,0,33,49
5443,0,17,0,17,34
5444,0,34,15,18,67
5446,0,33,17,16,66
5447,0,18,17,16,51
5448,0,33,16,17,66
5449,0,16,16,17,49
5450,0,33,16,18,67
5451,0,17,16,18,51
5452,0,34,17,16,67
5453,0,18,17,16,51
5454,0,33,0,16,49
5455,0,16,0,16,32
5456,0,51,0,17,68
5457,0,35,0,17,52
5458,0,18,0,17,35
5459,0,17,0,16,33
5460,0,32,0,17,49
5461,0,16,0,17,33
5462,0,33,0,34,67
5463,0,16,0,34,50
5464,0,34,0,17,51
5465,18,34,0,16,68
5466,0,34,0,16,50
5468,0,49,16,17,82
5469,0,33,16,17,66
5470,0,17,16,17,50
5471,0,33,0,17,50
5472,0,17,0,17,34
5475,0,19,16,17,52
5476,0,33,0,16,49
5477,0,17,0,16,33
5478,0,50,0,16,66
5479,0,34,0,16,50
5480,0,18,0,16,34
5482,0,33,0,19,52
5483,0,16,0,19,35
5484,0,52,0,15,67
5485,0,33,0,15,48
5487,0,15,0,17,32
5489,0,17,0,16,33
5490,0,33,0,16,49
5491,0,17,0,16,33
5492,0,34,16,35,85
5493,0,18,16,35,69
5494,0,51,16,16,83
5495,0,35,16,16,67
5497,0,16,0,16,32
5498,0,32,0,18,50
5500,0,35,0,15,50
5502,0,50,16,17,83
5503,0,35,16,17,68
5504,19,16,17,16,68
5505,0,16,17,16,49
5506,0,33,0,17,50
5507,0,16,0,17,33
5508,0,34,16,16,66
5511,0,16,17,18,51
5512,0,35,0,16,51
5513,0,18,0,16,34
5514,0,32,0,32,64
5518,0,18,0,17,35
5519,0,17,0,17,34
5520,0,33,0,17,50
5522,0,34,0,17,51
5523,0,17,0,17,34
5524,0,34,0,15,49
5526,0,34,0,15,49
5531,0,33,18,17,68
5533,0,18,17,17,52
5534,0,34,17,15,66
5535,0,17,17,15,49
5536,0,32,0,17,49
5537,0,15,0,17,32
5538,0,34,0,15,49
5539,0,17,0,15,32
5540,0,32,0,17,49
5541,0,17,0,17,34
5543,0,16,0,17,33
5544,0,35,0,16,51
5547,0,17,0,33,50
5548,0,33,0,33,66
5551,0,17,0,16,33
5553,0,18,0,16,34
5555,0,17,0,16,33
5556,0,33,0,34,67
5557,0,17,0,34,51
5558,0,34,0,16,50
5559,0,18,0,16,34
5560,0,32,0,34,66
5561,0,16,0,34,50
5562,0,34,0,18,52
5563,0,17,0,18,35
5564,0,33,0,18,51
5567,0,17,0,16,33
5568,0,32,0,18,50
5570,0,34,0,17,51
5572,0,34,0,16,50
5573,0,17,0,16,33
5575,0,17,0,16,33
5576,0,32,0,17,49
5579,0,18,0,17,35
5580,0,34,0,17,51
5581,0,17,0,17,34
5582,0,33,0,16,49
5583,0,16,0,16,32
5584,0,32,0,16,48
5592,0,34,0,17,51
5594,0,34,15,18,67
5595,0,17,15,18,50
5596,0,33,16,16,65
5598,0,32,16,35,83
5599,0,16,16,35,67
5600,0,51,15,18,84
5601,0,35,15,18,68
5602,0,18,15,18,51
5603,0,33,0,17,50
5604,0,18,0,17,35
5605,0,17,0,17,34
5609,0,17,0,16,33
5610,0,32,0,17,49
5611,0,16,0,17,33
5613,0,17,0,15,32
5614,0,32,0,17,49
5615,0,17,0,17,34
5616,0,33,0,18,51
5617,0,16,0,18,34
5618,0,35,0,15,50
5619,0,17,0,15,32
5620,0,32,0,17,49
5621,0,17,0,17,34
5622,0,34,0,16,50
5623,0,17,0,16,33
5625,0,18,0,15,33
5626,0,33,0,15,48
5627,0,18,0,15,33
5628,0,34,0,15,49
5629,0,19,0,15,34
5630,0,33,0,17,50
5631,0,18,0,17,35
5632,0,32,0,18,50
5633,0,15,0,18,33
5634,0,35,0,14,49
5635,0,17,0,14,31
5637,0,18,0,16,34
5638,0,34,0,15,49
5639,0,18,0,15,33
5640,0,32,0,17,49
5641,0,17,0,17,34
5642,0,34,0,16,50
5643,0,17,0,16,33
5644,0,34,17,17,68
5645,0,18,17,17,52
5646,0,34,0,15,49
5647,0,17,0,15,32
5648,0,31,0,17,48
5650,0,34,0,17,51
5651,0,17,0,17,34
5652,0,36,13,18,67
5653,0,19,13,18,50
5654,0,31,0,24,55
5655,0,18,0,24,42
5656,0,36,15,15,66
5659,0,15,0,17,32
5661,0,16,17,16,49
5663,0,16,0,18,34
5664,0,34,0,17,51
5666,0,33,0,18,51
5667,0,16,0,18,34
5668,0,35,0,16,51
5669,0,17,0,16,33
5671,0,16,16,19,51
5673,0,19,0,16,35
5674,0,33,16,16,65
5675,0,17,16,16,49
5677,0,16,0,17,33
5678,0,35,0,15,50
5679,0,18,0,15,33
5680,0,32,0,18,50
5682,0,33,0,18,51
5684,0,34,0,33,67
5686,0,33,0,16,49
5687,0,18,0,16,34
5689,0,17,0,17,34
5690,0,34,0,16,50
5691,0,17,0,16,33
5692,0,34,30,5,69
5693,0,18,30,5,53
5695,0,5,15,16,36
5697,0,16,17,16,49
5698,0,33,18,17,68
5700,0,35,15,16,66
5701,0,17,15,16,48
5702,0,31,0,17,48
5703,0,16,0,17,33
5706,0,32,19,15,66
5707,0,17,19,15,51
5708,0,34,0,16,50
5710,0,34,0,16,50
5711,0,18,0,16,34
5712,0,32,17,17,66
5715,0,17,0,17,34
5716,0,33,0,18,51
5717,0,16,0,18,34
5718,0,36,0,15,51
5721,0,15,0,18,33
5723,0,16,0,17,33
5724,0,35,0,17,52
5726,0,47,0,19,66
5727,0,30,0,19,49
5728,0,16,0,19,35
5730,0,33,0,16,49
5731,0,16,0,16,32
5733,0,17,0,16,33
5734,0,34,0,16,50
5736,0,32,0,19,51
5737,0,16,0,19,35
5739,0,33,0,31,64
5741,0,31,0,18,49
5742,0,17,0,18,35
5743,0,18,0,16,34
5744,0,34,0,15,49
5745,0,18,0,15,33
5747,0,18,16,16,50
5748,0,32,0,18,50
5749,0,16,0,18,34
5750,0,33,0,19,52
5751,0,15,0,19,34
5752,0,34,0,17,51
5753,0,15,0,17,32
5754,0,35,0,16,51
5755,0,18,0,16,34
5758,0,35,14,18,67
5759,0,19,14,18,51
5760,0,32,0,17,49
5761,0,18,0,17,35
5762,0,34,15,18,67
5763,0,17,15,18,50
5765,0,18,16,17,51
5766,0,33,16,34,83
5767,0,17,16,34,67
5769,0,34,15,18,67
5770,18,33,16,17,84
5771,0,33,16,17,66
5772,0,18,16,17,51
5773,0,16,0,17,33
5774,0,34,0,16,50
5775,0,17,0,16,33
5776,0,34,0,16,50
5777,0,18,0,16,34
5778,0,33,16,18,67
5779,0,17,16,18,51
5781,0,18,0,16,34
5782,0,33,0,16,49
5783,0,17,0,16,33
5784,0,34,0,15,49
5785,0,18,0,15,33
5786,0,32,0,31,63
5788,0,50,0,16,66
5789,16,19,0,16,51
5790,0,19,0,16,35
5791,0,16,0,17,33
5793,0,16,0,34,50
5794,0,34,0,16,50
5795,18,51,0,16,85
5796,0,51,0,16,67
5797,0,35,0,16,51
5798,19,16,0,17,52
5799,0,16,0,17,33
5803,0,16,16,16,48
5804,0,32,0,35,67
5805,0,16,0,35,51
5806,0,35,0,33,68
5807,19,33,16,34,102
5809,18,50,0,17,85
5813,0,17,0,33,50
5814,0,33,0,32,65
5815,0,18,0,32,50
5816,0,32,0,17,49
5817,17,35,0,16,68
5819,0,18,0,16,34
5820,0,33,0,16,49
5821,0,17,0,16,33
5825,0,19,0,17,36
5826,0,33,0,15,48
5827,0,16,0,15,31
5828,0,33,0,16,49
5832,0,34,0,16,50
5833,0,18,0,16,34
5834,0,34,0,16,50
5835,0,18,0,16,34
5836,0,31,0,17,48
5838,0,51,0,16,67
5840,18,16,0,33,67
5841,0,16,0,33,49
5842,0,52,0,15,67
5844,0,19,0,15,34
5847,0,16,0,34,50
5848,0,34,0,17,51
5849,18,33,0,16,67
5850,0,33,0,16,49
5852,0,33,17,17,67
5853,0,17,17,17,51
5854,0,34,0,16,50
5855,0,17,0,16,33
5856,0,33,17,17,67
5857,0,17,17,17,51
5859,0,17,15,18,50
5860,0,33,16,18,67
5862,0,34,17,16,67
5863,0,18,17,16,51
5864,0,33,16,16,65
5865,0,16,16,16,48
5866,0,32,19,16,67
5867,0,16,19,16,51
5868,0,35,16,17,68
5869,0,16,16,17,49
5870,0,33,17,33,83
5871,0,17,17,33,67
5872,0,50,0,16,66
5873,0,33,0,16,49
5874,0,20,0,16,36
5875,0,16,0,17,33
5876,0,33,0,18,51
5877,0,16,0,18,34
5880,0,36,0,14,50
5881,0,18,0,14,32
5882,0,30,0,18,48
5884,0,35,0,17,52
5885,0,17,0,17,34
5887,0,16,16,16,48
5888,0,32,0,18,50
5890,0,34,0,17,51
5892,0,34,0,16,50
5895,0,16,0,18,34
5896,0,35,0,15,50
5897,0,17,0,15,32
5898,0,33,16,16,65
5899,0,18,16,16,50
5900,0,32,0,18,50
5901,0,16,0,18,34
5902,0,34,0,16,50
5903,0,16,0,16,32
5904,0,49,0,17,66
5906,0,17,0,17,34
5908,0,33,0,19,52
5909,0,16,0,19,35
5910,0,36,0,16,52
5911,0,17,0,16,33
5915,0,18,14,18,50
5916,0,32,0,18,50
5917,0,18,0,18,36
5918,0,34,0,17,51
5919,0,16,0,17,33
5920,0,34,0,16,50
5921,0,17,0,16,33
5922,0,32,0,35,67
5923,0,16,0,35,51
5924,0,35,0,31,66
5925,0,19,0,31,50
5927,0,35,0,17,52
5928,0,18,0,17,35
5930,0,33,0,17,50
5931,0,17,0,17,34
5932,0,33,0,17,50
5934,0,33,0,17,50
5935,0,16,0,17,33
5937,0,16,0,18,34
5939,0,15,0,19,34
5941,0,17,0,16,33
5942,0,31,0,35,66
5943,0,15,0,35,50
5944,0,35,0,15,50
5945,0,19,0,15,34
5946,0,32,0,18,50
5947,0,17,0,18,35
5948,0,33,0,34,67
5949,0,15,0,34,49
5950,0,34,0,17,51
5951,0,18,0,17,35
5953,0,33,0,19,52
5954,0,18,0,19,37
5955,0,19,0,15,34
5956,0,32,0,17,49
5958,0,32,0,18,50
5960,0,34,0,17,51
5962,0,34,0,19,53
5963,0,17,0,19,36
5965,0,14,0,35,49
5966,0,35,0,14,49
5967,0,20,0,14,34
5970,0,51,0,17,68
5971,0,33,0,17,50
5972,0,19,0,17,36
5973,0,17,0,17,34
5974,0,33,0,18,51
5975,0,16,0,18,34
5977,0,16,0,16,32
5978,0,37,0,14,51
5979,0,21,0,14,35
5980,0,47,0,17,64
5981,0,33,0,17,50
5982,0,19,0,17,36
5983,0,17,0,14,31
5984,0,47,0,19,66
5988,0,32,0,17,49
5990,0,36,0,15,51
5991,0,19,0,15,34
5992,0,32,0,17,49
5995,0,15,0,33,48
5998,0,19,0,15,34
