序号,发送->接收,接收->转发,转发->接收,接收->处理,总计
1,82,18,83,16,199
2,58,31,68,15,172
3,51,31,68,15,165
5,67,16,68,16,167
6,65,34,67,15,181
7,68,16,67,15,166
9,65,19,65,17,166
11,66,17,66,17,166
12,67,32,51,16,166
13,67,17,51,16,151
14,65,34,83,16,198
15,66,17,83,16,182
16,66,33,66,19,184
17,68,16,66,19,169
18,51,16,66,19,152
19,66,18,67,16,167
22,66,35,66,16,183
23,69,16,66,16,167
24,51,16,66,16,149
25,67,15,73,13,168
26,66,35,51,15,167
27,66,16,51,15,148
30,73,28,67,16,184
33,68,17,65,16,166
34,78,17,67,17,179
35,65,17,67,17,166
37,65,17,67,17,166
39,66,18,67,17,168
40,67,33,51,15,166
43,68,17,68,16,169
44,67,32,69,15,183
45,67,15,69,15,166
46,51,15,69,15,150
47,65,20,81,18,184
49,67,17,66,15,165
51,53,33,67,16,169
52,81,18,65,19,183
53,83,34,67,22,206
54,66,34,67,22,189
56,67,31,58,10,166
58,65,36,65,16,182
60,67,32,67,16,182
61,51,32,67,16,166
62,58,10,67,16,151
63,66,16,67,16,165
64,65,34,67,17,183
65,59,18,67,17,161
67,66,17,51,15,149
68,67,34,65,18,184
69,67,18,65,18,168
70,67,32,68,16,183
71,68,15,68,16,167
72,51,15,68,16,150
73,69,14,69,15,167
75,66,17,67,18,168
76,68,34,65,18,185
77,83,33,65,18,199
79,66,18,65,18,167
81,69,14,66,18,167
82,65,33,66,17,181
83,68,15,66,17,166
84,65,33,69,15,182
88,66,36,65,18,185
89,65,19,65,18,167
90,50,19,65,18,152
92,51,17,66,16,150
93,51,33,68,15,167
94,50,15,68,15,148
96,66,35,67,14,182
97,64,19,67,14,164
98,68,33,67,15,183
100,68,34,65,18,185
101,52,34,65,18,169
102,50,17,65,18,150
103,66,19,65,19,169
104,67,32,69,16,184
105,65,17,69,16,167
106,65,33,52,14,164
108,65,36,83,16,200
109,69,17,83,16,185
111,67,14,53,16,150
112,52,14,53,16,135
113,66,16,67,17,166
114,83,16,67,16,182
115,67,16,67,16,166
116,53,16,67,16,152
117,50,33,101,14,198
118,67,34,81,19,201
120,67,32,68,17,184
122,101,33,65,19,218
124,81,19,65,19,184
125,65,19,65,19,168
126,68,35,64,18,185
128,68,30,67,17,182
129,54,30,67,17,168
130,65,34,67,16,182
131,67,15,67,16,165
132,64,33,66,18,181
134,52,15,66,18,151
135,65,17,67,17,166
136,67,32,68,16,183
138,66,35,65,17,183
140,67,33,65,19,184
142,68,32,68,17,185
143,66,16,68,17,167
144,65,33,69,16,183
146,65,35,65,18,183
148,68,34,64,19,185
149,68,17,64,19,168
151,66,15,52,16,149
152,65,33,70,15,183
153,66,15,70,15,166
154,64,35,66,17,182
157,50,35,65,16,166
158,70,31,67,16,184
159,66,16,67,16,165
160,66,34,66,18,184
161,66,17,66,18,167
162,65,33,68,16,182
163,66,17,68,16,167
164,67,33,68,15,183
165,66,17,68,15,166
166,66,35,65,17,183
168,51,17,65,17,150
169,68,17,67,15,167
170,51,17,67,15,150
171,65,17,68,17,167
172,65,35,65,17,182
173,66,18,65,17,166
174,67,33,66,17,183
175,67,18,66,17,168
177,68,15,68,15,166
178,65,34,67,17,183
180,66,34,67,17,184
181,66,17,67,17,167
182,68,33,67,20,188
183,66,18,67,20,171
184,67,34,53,12,166
185,67,17,53,12,149
188,51,16,66,16,149
189,70,12,68,15,165
192,66,34,66,16,182
193,62,18,66,16,162
195,66,18,65,19,168
196,67,33,66,17,183
197,67,17,66,17,167
198,66,32,69,16,183
199,67,16,69,16,168
200,65,34,68,15,182
203,67,18,66,16,167
204,69,33,67,16,185
205,66,17,67,16,166
206,51,17,67,16,151
207,51,33,67,15,166
208,66,34,66,17,183
209,66,18,66,17,167
210,67,33,66,17,183
212,67,33,66,17,183
213,66,18,66,17,167
215,67,16,64,19,166
216,66,33,67,18,184
217,68,16,67,18,169
218,66,31,70,17,184
220,64,36,66,18,184
221,66,17,66,18,167
225,68,15,69,15,167
226,66,33,67,18,184
228,65,36,65,17,183
229,65,19,65,17,166
230,69,31,51,16,167
231,66,16,51,16,149
232,51,16,51,16,134
233,68,16,67,16,167
234,65,33,67,17,182
236,51,16,67,17,151
237,65,18,66,16,165
238,67,33,67,17,184
239,66,17,67,17,167
240,67,33,68,14,182
242,66,34,67,17,184
243,66,18,67,17,168
245,67,17,67,16,167
246,68,33,65,17,183
248,67,34,66,17,184
249,67,17,66,17,167
250,67,31,67,17,182
252,65,35,66,16,182
253,65,18,66,16,165
258,66,33,67,17,183
259,65,17,67,17,166
260,67,34,50,17,168
261,68,16,50,17,151
262,51,16,50,17,134
265,66,17,67,17,167
266,50,17,67,17,151
267,51,32,83,17,183
268,66,35,65,17,183
269,67,17,65,17,166
270,67,32,67,17,183
271,67,15,67,17,166
272,83,17,66,18,184
274,65,34,83,16,198
275,82,32,67,17,198
276,67,32,67,17,183
277,68,15,67,17,167
279,67,17,100,15,199
281,82,34,66,17,199
283,117,32,68,18,235
284,100,32,68,18,218
287,66,17,68,18,169
288,66,34,101,17,218
289,100,18,84,16,218
290,100,32,52,16,200
292,68,32,52,16,168
293,51,32,52,16,151
294,101,33,66,18,218
297,66,16,66,18,166
298,52,16,66,18,152
299,102,15,68,15,200
300,99,34,65,18,216
301,82,34,65,18,199
302,66,34,65,18,183
304,100,31,67,19,217
307,65,16,67,19,167
309,67,17,66,17,167
311,68,15,67,17,167
312,52,15,67,17,151
313,68,15,67,17,167
314,66,33,67,16,182
315,66,16,67,16,165
316,67,34,49,17,167
317,65,17,49,17,148
318,67,33,84,17,201
319,67,16,84,17,184
321,66,17,68,15,166
322,49,17,68,15,149
324,84,17,65,17,183
325,68,17,65,17,167
327,51,33,65,18,167
329,67,15,51,16,149
330,65,33,68,17,183
332,65,34,66,18,183
334,51,16,66,18,151
335,68,16,66,18,168
336,68,32,69,15,184
337,67,15,69,15,166
338,51,15,69,15,150
339,66,16,50,20,152
341,67,17,81,18,183
342,69,35,64,17,185
343,66,20,64,17,167
345,52,32,64,19,167
346,81,18,68,15,182
347,66,18,68,15,167
348,64,32,69,15,180
350,64,36,65,18,183
351,69,17,65,18,169
353,66,18,66,17,167
354,51,18,66,17,152
355,65,17,68,15,165
356,65,34,66,17,182
357,68,16,66,17,167
360,51,17,64,17,149
361,50,32,68,15,165
362,66,32,69,16,183
365,66,19,65,17,167
367,66,18,65,17,166
369,68,16,67,19,170
370,65,33,53,14,165
371,67,16,53,14,150
373,66,17,67,17,167
375,69,14,66,18,167
377,68,16,67,16,167
378,67,32,69,15,183
379,65,15,69,15,164
380,66,35,67,16,184
381,66,17,67,16,166
384,69,33,65,18,185
386,67,34,64,19,184
389,68,15,67,18,168
390,65,33,68,16,182
391,67,15,68,16,166
392,64,34,67,17,182
393,67,15,67,17,166
394,67,34,66,17,184
395,67,16,66,17,166
396,68,33,67,17,185
397,65,17,67,17,166
399,66,16,67,18,167
400,50,16,67,18,151
401,67,17,66,18,168
402,67,33,66,17,183
403,67,16,66,17,166
404,67,33,68,15,183
406,66,33,67,17,183
407,67,15,67,17,166
408,66,35,66,16,183
409,65,18,66,16,165
410,68,32,68,18,186
413,67,17,65,18,167
414,66,34,67,16,183
415,67,18,67,16,168
416,68,31,52,17,168
417,69,13,52,17,151
419,67,18,65,17,167
420,67,33,67,15,182
421,65,17,67,15,164
424,65,35,65,17,182
425,84,32,67,16,199
426,67,32,67,16,182
427,66,17,67,16,166
428,67,33,67,17,184
429,67,16,67,17,167
430,65,34,67,15,181
431,67,17,67,15,166
432,67,33,65,19,184
434,67,34,66,17,184
435,67,17,66,17,167
436,50,17,66,17,150
437,66,16,52,17,151
438,65,35,66,17,183
439,67,16,66,17,166
440,66,34,66,18,184
442,52,17,66,18,153
443,50,32,67,17,166
444,66,34,67,17,184
445,66,17,67,17,167
447,69,15,67,16,167
448,67,34,66,19,186
449,67,17,66,19,169
450,50,17,66,19,152
451,66,16,67,17,166
452,51,16,67,17,151
453,66,17,68,16,167
454,66,34,67,16,183
458,68,33,67,16,184
459,65,17,67,16,165
460,67,32,67,16,182
461,66,16,67,16,165
463,66,18,65,17,166
464,67,32,69,15,183
465,67,16,69,15,167
466,51,16,69,15,151
467,66,17,67,18,168
468,65,36,66,15,182
469,66,19,66,15,166
472,67,35,66,17,185
473,68,17,66,17,168
474,66,32,67,15,180
475,66,17,67,15,165
476,67,34,66,16,183
478,66,33,67,17,183
481,66,18,67,15,166
483,65,18,66,18,167
485,69,16,51,16,152
486,51,16,51,16,134
487,66,18,67,15,166
488,66,34,82,19,201
489,67,16,82,19,184
490,51,16,82,19,168
491,85,33,66,17,201
492,67,33,66,17,183
493,64,18,66,17,165
494,66,35,66,16,183
495,64,19,66,16,165
496,68,31,67,16,182
498,66,35,83,17,201
499,85,32,68,15,200
500,66,32,68,15,181
501,51,32,68,15,166
502,67,35,99,18,219
503,66,19,99,18,202
504,83,17,84,14,198
505,84,32,52,14,182
507,52,32,52,14,150
508,99,32,84,17,232
509,101,14,84,17,216
511,69,14,84,17,184
514,84,16,100,17,217
515,98,17,67,17,199
517,67,17,67,17,168
518,100,34,82,17,233
524,100,33,68,17,218
525,98,17,68,17,200
526,82,17,68,17,184
527,65,17,68,17,167
529,99,18,70,10,197
530,83,18,70,10,181
531,85,33,65,17,200
533,67,16,65,17,165
534,104,28,68,17,217
535,88,28,68,17,201
536,70,28,68,17,183
537,63,18,68,17,166
538,65,34,68,17,184
540,78,18,66,18,180
541,68,18,66,18,170
542,68,34,67,17,186
544,68,32,68,17,185
545,69,15,68,17,169
546,66,35,67,16,184
547,67,17,67,16,167
549,67,16,50,16,149
551,67,17,66,16,166
552,67,32,67,16,182
554,50,16,67,16,149
556,66,33,67,17,183
557,66,17,67,17,167
559,66,16,52,16,150
560,65,35,66,17,183
561,67,17,66,17,167
562,67,33,67,16,183
563,68,16,67,16,167
566,66,34,66,17,183
567,66,17,66,17,166
568,67,33,67,17,184
570,67,33,68,16,184
571,69,14,68,16,167
572,66,34,66,18,184
573,67,17,66,18,168
575,65,17,66,17,165
576,68,32,51,15,166
577,67,16,51,15,149
578,66,34,82,17,199
579,67,16,82,17,182
580,66,32,67,18,183
581,67,15,67,18,167
583,66,16,68,16,166
584,82,17,67,16,182
586,67,35,65,17,184
588,68,32,66,18,184
589,68,16,66,18,168
592,65,33,68,16,182
593,66,16,68,16,166
594,66,33,51,18,168
595,50,33,51,18,152
597,67,17,67,16,167
598,68,34,66,16,184
599,66,18,66,16,166
600,51,18,66,16,151
601,51,33,66,17,167
602,67,33,68,16,184
603,67,17,68,16,168
604,66,33,51,16,166
606,66,35,65,17,183
607,67,18,65,17,167
608,68,32,68,14,182
609,52,32,68,14,166
613,66,18,66,15,165
615,51,31,68,16,166
616,66,35,66,16,183
617,66,18,66,16,166
618,66,33,65,18,182
621,67,17,67,16,167
624,65,35,83,16,199
625,67,17,83,16,183
626,67,33,66,17,183
627,67,17,66,17,167
628,51,17,66,17,151
629,67,15,51,16,149
630,65,34,66,18,183
631,83,33,51,16,183
633,66,16,51,16,149
634,51,16,51,16,134
637,67,16,67,17,167
638,51,16,67,17,151
640,68,33,70,14,185
641,66,17,70,14,167
643,66,16,68,16,166
644,66,37,63,17,183
645,66,21,63,17,167
648,51,17,66,16,150
650,63,34,67,16,180
651,66,17,67,16,166
654,50,17,67,17,151
655,66,18,65,18,167
656,67,33,67,17,184
657,51,33,67,17,168
659,51,32,52,15,150
660,65,35,66,17,183
661,67,17,66,17,167
662,67,32,66,18,183
663,50,32,66,18,166
664,52,15,66,18,151
666,66,32,51,18,167
667,66,15,51,18,150
668,51,15,51,18,135
669,67,17,66,16,166
670,67,34,66,15,182
671,66,18,66,15,165
672,51,18,66,15,150
673,51,32,68,15,166
674,66,34,66,18,184
675,66,18,66,18,168
676,66,34,65,17,182
677,51,34,65,17,167
678,68,32,50,16,166
679,52,32,50,16,150
680,66,33,66,18,183
681,51,33,66,18,168
684,50,16,68,17,151
685,67,14,69,16,166
686,66,35,50,17,168
687,67,17,50,17,151
688,68,34,81,17,200
694,65,33,67,17,182
695,65,17,67,17,166
696,65,35,67,15,182
697,67,17,67,15,166
698,68,32,67,17,184
700,67,35,65,18,185
701,66,18,65,18,167
703,51,32,67,16,166
704,67,33,66,17,183
705,67,16,66,17,166
706,65,34,66,17,182
707,68,16,66,17,167
711,65,17,67,17,166
712,66,34,66,16,182
713,67,17,66,16,166
714,51,17,66,16,150
715,51,33,68,15,167
716,67,33,68,17,185
717,67,16,68,17,168
718,66,35,66,16,183
720,68,33,67,15,183
721,66,18,67,15,166
722,68,33,65,17,183
723,52,33,65,17,167
725,67,18,66,16,167
726,67,31,68,16,182
728,65,35,66,17,183
729,66,18,66,17,167
730,66,33,66,18,183
731,67,17,66,18,168
732,68,33,67,17,185
733,67,17,67,17,168
736,66,34,83,17,200
737,68,16,83,17,184
738,67,33,67,17,184
740,67,35,65,17,184
743,66,17,66,17,166
744,67,33,66,18,184
745,68,16,66,18,168
747,67,16,83,19,185
748,66,33,69,16,184
749,66,16,69,16,167
750,66,35,66,16,183
751,67,17,66,16,166
752,83,19,66,15,183
753,85,32,66,17,200
754,69,32,66,17,184
755,51,32,66,17,166
756,66,34,67,15,182
758,66,32,66,18,182
759,65,17,66,18,166
760,66,35,66,17,184
762,67,31,67,17,182
763,67,16,67,17,167
764,66,35,67,16,184
765,67,17,67,16,167
767,68,15,67,20,170
771,66,16,67,17,166
772,67,35,67,15,184
773,70,15,67,15,167
774,52,15,67,15,149
775,66,17,66,17,166
776,67,35,66,15,183
777,64,18,66,15,163
778,67,31,50,17,165
779,67,16,50,17,150
780,66,35,82,16,199
781,66,18,82,16,182
782,66,32,66,17,181
783,66,17,66,17,166
785,50,33,69,16,168
786,65,33,52,15,165
787,83,36,66,15,200
788,66,36,66,15,183
790,69,31,66,17,183
791,68,15,66,17,166
792,52,15,66,17,150
793,69,16,68,16,169
794,66,31,53,15,165
795,65,16,53,15,149
797,64,20,64,17,165
798,68,31,68,16,183
799,53,31,68,16,168
801,67,17,51,18,153
802,64,35,65,14,178
804,68,34,64,17,183
805,68,18,64,17,167
806,51,18,64,17,150
809,63,19,67,17,166
810,64,33,67,18,182
811,66,16,67,18,167
812,66,34,67,16,183
813,70,16,67,16,169
815,67,16,68,15,166
816,51,16,68,15,150
817,67,16,67,16,166
818,67,34,66,17,184
819,66,18,66,17,167
820,68,33,65,18,184
822,67,33,68,16,184
823,67,17,68,16,168
824,66,32,52,18,168
825,68,15,52,18,153
826,50,15,52,18,135
828,50,18,82,16,166
829,67,18,64,19,168
831,52,32,66,16,166
832,66,32,67,17,182
833,66,16,67,17,166
834,64,34,68,17,183
835,68,15,68,17,168
836,51,15,68,17,151
837,66,17,52,14,149
838,67,35,82,18,202
839,65,18,82,18,183
842,52,14,69,16,151
844,65,35,66,16,182
847,53,33,67,16,169
848,51,17,67,16,151
849,51,33,65,17,166
850,66,34,66,16,182
851,66,18,66,16,166
852,67,31,51,18,167
853,51,31,51,18,151
855,66,18,67,15,166
856,66,34,82,18,200
857,50,34,82,18,184
858,51,18,82,18,169
859,52,33,83,16,184
860,67,32,67,17,183
862,65,35,66,15,181
863,66,18,66,15,165
864,83,16,68,16,183
866,67,34,67,16,184
867,67,17,67,16,167
868,66,34,66,16,182
869,65,19,66,16,166
871,51,33,65,18,167
872,67,33,66,17,183
875,66,16,68,16,166
876,65,34,66,18,183
877,49,34,66,18,167
879,67,17,67,16,167
881,66,16,51,17,150
882,66,35,65,19,185
883,67,17,65,19,168
886,51,17,67,15,150
889,68,16,67,15,166
890,67,32,86,15,200
893,65,18,66,16,165
894,67,33,83,16,199
895,67,18,83,16,184
897,69,15,66,16,166
901,81,35,65,16,197
902,66,35,65,16,182
903,66,19,65,16,166
904,69,32,67,17,185
906,67,33,51,16,167
907,69,15,51,16,151
908,65,34,50,17,166
911,66,16,67,17,166
912,51,16,67,17,151
913,68,17,67,15,167
914,50,17,67,15,149
915,50,33,67,15,165
917,84,33,68,16,201
918,67,33,68,16,184
919,65,18,68,16,167
920,67,33,65,19,184
922,66,35,64,17,182
924,68,30,67,18,183
925,69,14,67,18,168
926,65,34,51,16,166
928,64,33,68,16,181
929,65,16,68,16,165
930,67,34,67,18,186
931,66,16,67,18,167
935,66,17,68,14,165
936,67,33,71,10,181
937,69,15,71,10,165
938,51,15,71,10,147
939,67,18,81,18,184
942,71,30,67,16,184
943,54,30,67,16,167
946,63,34,67,15,179
948,67,32,67,17,183
949,68,16,67,17,168
950,50,16,67,17,150
951,67,17,67,15,166
953,66,17,50,17,150
954,67,35,64,17,183
956,67,32,68,15,182
957,52,32,68,15,167
958,50,17,68,15,150
960,64,36,64,17,181
962,68,32,67,15,182
963,52,32,67,15,166
964,68,32,67,18,185
965,68,15,67,18,168
967,66,18,64,20,168
969,65,17,68,15,165
970,67,32,51,16,166
975,65,16,67,18,166
976,51,16,67,18,152
977,69,12,68,17,166
978,65,33,68,17,183
979,67,16,68,17,168
982,68,33,51,14,166
983,51,33,51,14,149
986,66,32,52,17,167
987,67,14,52,17,150
988,51,14,52,17,134
989,67,15,68,16,166
991,66,17,66,17,166
993,67,16,65,18,166
995,66,17,50,16,149
997,66,15,53,15,149
999,67,16,67,16,166
1000,50,16,67,16,149
1001,68,15,67,17,167
1002,53,15,67,17,152
1003,67,16,51,16,150
1004,67,34,83,17,201
1005,64,18,83,17,182
1006,67,33,67,18,185
1007,67,16,67,18,168
1008,51,16,67,18,152
1009,51,34,51,14,150
1011,83,32,67,17,199
1012,67,32,67,17,183
1013,69,14,67,17,167
1014,51,14,67,17,149
1017,65,16,68,17,166
1018,67,34,67,17,185
1019,66,17,67,17,167
1020,66,34,67,16,183
1021,67,17,67,16,167
1025,67,17,81,19,184
1026,67,32,68,15,182
1030,65,35,66,16,182
1031,65,19,66,16,166
1033,52,33,83,16,184
1034,68,33,66,18,185
1035,68,17,66,18,169
1036,66,33,67,17,183
1038,83,16,67,17,183
1039,67,16,67,17,167
1040,66,34,65,17,182
1042,67,33,66,17,183
1044,51,16,66,17,150
1046,65,34,68,16,183
1047,65,17,68,16,166
1048,66,33,66,18,183
1051,68,17,66,17,168
1052,68,31,69,16,184
1054,66,35,66,19,186
1055,66,17,66,19,168
1056,66,34,99,17,216
1057,67,17,99,17,200
1058,69,32,84,18,203
1059,67,16,84,18,185
1060,66,34,68,14,182
1061,116,35,81,18,250
1062,99,35,81,18,233
1063,100,18,81,18,217
1065,65,18,81,18,182
1066,68,33,116,15,232
1067,100,18,98,18,234
1069,99,18,65,18,200
1070,81,18,65,18,182
1071,67,18,65,18,168
1072,99,32,68,17,216
1073,101,15,68,17,201
1074,98,34,51,16,199
1075,83,34,51,16,184
1076,65,34,51,16,166
1077,66,16,51,16,149
1081,50,33,66,18,167
1082,51,16,66,18,151
1083,83,33,68,16,200
1084,66,33,68,16,183
1086,66,35,65,17,183
1087,68,17,65,17,167
1088,51,17,65,17,150
1089,51,33,66,18,168
1090,68,32,68,16,184
1095,50,34,65,17,166
1096,68,33,66,17,184
1097,51,33,66,17,167
1098,67,32,68,16,183
1100,65,34,67,18,184
1101,66,17,67,18,168
1102,66,34,65,18,183
1103,66,17,65,18,166
1105,67,17,67,17,168
1106,67,32,68,17,184
1109,49,35,68,14,166
1111,66,16,67,18,167
1112,52,16,67,18,153
1113,67,18,65,16,166
1114,68,32,67,15,182
1117,68,15,68,15,166
1118,65,34,65,19,183
1119,67,18,65,19,169
1120,67,34,66,16,183
1121,64,19,66,16,165
1122,68,31,67,18,184
1124,65,35,65,18,183
1125,69,16,65,18,168
1126,50,16,65,18,149
1129,66,15,67,17,165
1131,67,16,67,16,166
1132,67,33,67,17,184
1133,65,17,67,17,166
1134,67,34,67,16,184
1135,66,17,67,16,166
1136,67,33,66,18,184
1137,67,17,66,18,168
1138,67,34,67,15,183
1140,67,32,50,18,167
1141,67,16,50,18,151
1143,67,17,84,15,183
1144,67,33,66,17,183
1147,66,16,68,17,167
1148,84,15,68,17,184
1150,66,34,66,18,184
1151,50,34,66,18,168
1155,51,32,66,18,167
1156,51,15,66,18,150
1159,66,15,52,17,150
1160,66,35,67,17,185
1161,66,17,67,17,167
1162,67,34,66,17,184
1163,67,17,66,17,167
1166,67,33,67,16,183
1167,67,16,67,16,166
1168,66,34,65,16,181
1169,50,34,65,16,165
1170,50,17,65,16,148
1172,67,32,50,17,166
1173,66,16,50,17,149
1175,65,18,66,17,166
1176,66,33,67,16,182
1177,66,17,67,16,166
1178,50,17,67,16,150
1180,66,34,66,17,183
1182,67,33,50,16,166
1183,51,33,50,16,150
1186,66,33,67,19,185
1188,50,16,67,19,152
1189,49,35,51,17,152
1192,51,16,52,15,134
1193,67,17,65,15,164
1194,51,17,65,15,148
1196,52,15,67,18,152
1197,65,17,65,18,165
1198,65,33,66,17,181
1199,64,18,66,17,165
1200,67,32,51,16,166
1202,51,14,51,16,132
1204,66,33,68,16,183
1206,51,16,68,16,151
1207,66,17,50,16,149
1210,68,32,66,18,184
1212,50,16,66,18,150
1213,65,16,51,17,149
1214,65,33,85,17,200
1216,52,14,85,17,168
1218,51,17,67,17,152
1219,65,18,65,16,164
1220,69,33,66,16,184
1221,67,17,66,16,166
1222,67,32,67,18,184
1224,65,34,68,16,183
1225,65,18,68,16,167
1226,66,33,51,16,166
1227,65,17,51,16,149
1228,67,35,66,15,183
1229,69,17,66,15,167
1230,68,32,66,18,184
1233,67,16,65,18,166
1234,66,32,66,18,182
1236,66,33,69,17,185
1237,66,15,69,17,167
1238,65,33,68,16,182
1239,50,33,68,16,167
1241,66,18,65,18,167
1243,51,32,67,16,166
1245,66,17,50,17,150
1246,65,34,84,16,199
1247,66,16,84,16,182
1249,51,33,67,16,167
1250,50,17,67,16,150
1251,65,17,68,16,166
1254,67,34,65,17,183
1255,67,18,65,17,167
1256,68,33,68,17,186
1258,67,32,53,15,167
1260,65,36,66,16,183
1261,66,19,66,16,167
1263,68,15,66,17,166
1264,53,15,66,17,151
1266,66,32,66,17,181
1267,65,16,66,17,164
1269,67,17,82,18,184
1270,84,14,68,15,181
1273,84,33,83,17,217
1274,82,18,83,17,200
1275,64,18,83,17,182
1276,68,33,100,16,217
1277,51,33,100,16,200
1278,66,32,84,18,200
1279,83,35,67,16,201
1280,65,35,67,16,183
1282,67,33,84,16,200
1283,84,34,66,18,202
1284,84,18,66,18,186
1286,67,32,101,17,217
1289,84,33,51,15,183
1293,83,32,52,17,184
1294,67,32,52,17,168
1295,66,15,52,17,150
1296,51,15,52,17,135
1297,66,20,63,16,165
1298,70,31,66,17,184
1299,67,17,66,17,167
1301,67,16,51,17,151
1303,65,18,65,18,166
1305,67,17,66,15,165
1307,52,31,69,14,166
1308,65,35,67,15,182
1310,66,34,65,18,183
1313,51,33,66,16,166
1314,67,32,68,17,184
1315,52,32,68,17,169
1316,65,34,68,14,181
1317,51,34,68,14,167
1321,67,17,66,17,167
1322,51,17,66,17,151
1323,52,32,67,16,167
1324,66,34,66,15,181
1325,65,18,66,15,164
1327,69,16,68,15,168
1328,51,16,68,15,150
1329,51,33,67,18,169
1331,64,20,64,16,164
1332,68,32,65,19,184
1333,67,17,65,19,168
1334,67,32,52,15,166
1335,52,32,52,15,151
1336,64,33,83,18,198
1337,65,17,83,18,183
1338,65,34,67,16,182
1339,66,15,67,16,164
1340,52,15,67,16,150
1343,64,18,66,18,166
1344,67,34,67,15,183
1345,51,34,67,15,167
1346,68,32,68,16,184
1348,66,35,66,18,185
1349,68,17,66,18,169
1350,67,33,65,18,183
1351,66,18,65,18,167
1352,68,33,67,16,184
1353,66,17,67,16,166
1356,65,35,67,17,184
1357,67,17,67,17,168
1358,67,33,51,16,167
1359,65,17,51,16,149
1360,68,34,66,16,184
1361,66,18,66,16,166
1363,51,33,64,19,167
1364,51,16,64,19,150
1365,51,33,67,15,166
1366,66,31,51,19,167
1369,67,17,65,18,167
1370,67,34,65,16,182
1371,51,34,65,16,166
1372,51,19,65,16,151
1373,68,14,67,17,166
1375,68,16,67,16,167
1376,65,33,68,17,183
1379,66,17,51,17,151
1380,67,34,67,16,184
1381,67,18,67,16,168
1382,50,18,67,16,151
1384,51,17,66,16,150
1385,52,33,67,17,169
1386,67,33,65,18,183
1387,66,17,65,18,166
1388,66,34,65,18,183
1389,67,18,65,18,168
1390,67,31,52,16,166
1391,51,31,52,16,150
1392,51,14,52,16,133
1394,65,34,66,17,182
1395,66,16,66,17,165
1396,52,16,66,17,151
1397,50,37,62,18,167
1398,71,29,66,18,184
1400,66,33,51,15,165
1402,62,33,66,18,179
1404,66,33,68,16,183
1405,67,15,68,16,166
1406,51,15,68,16,150
1407,67,14,67,17,165
1409,66,17,67,15,165
1413,66,18,68,15,167
1414,49,18,68,15,150
1416,50,17,68,17,152
1417,67,19,66,15,167
1419,68,17,66,17,168
1420,51,17,66,17,151
1422,66,32,68,15,181
1423,51,32,68,15,166
1425,66,15,68,17,166
1426,64,36,64,20,184
1427,66,19,64,20,169
1430,68,32,68,16,184
1431,68,15,68,16,167
1434,52,15,66,17,150
1435,67,16,66,16,165
1436,52,16,66,16,150
1437,64,17,66,17,164
1438,66,33,68,15,182
1439,66,16,68,15,165
1440,66,33,70,13,182
1441,66,17,70,13,166
1442,49,17,70,13,149
1443,66,18,66,18,168
1446,70,31,66,19,186
1447,53,31,66,19,169
1448,66,34,51,15,166
1449,51,34,51,15,151
1451,69,15,68,17,169
1453,67,15,67,18,167
1456,68,33,51,15,167
1457,66,16,51,15,148
1458,51,16,51,15,133
1459,67,14,72,13,166
1460,65,34,67,16,182
1461,67,15,67,16,165
1462,51,15,67,16,149
1463,66,20,62,16,164
1465,66,16,68,16,166
1466,67,33,51,17,168
1467,65,17,51,17,150
1469,65,19,66,17,167
1471,52,33,67,16,168
1472,51,17,67,16,151
1476,67,33,67,15,182
1477,66,17,67,15,165
1479,66,16,68,15,165
1480,65,35,65,18,183
1481,67,17,65,18,167
1482,67,33,67,17,184
1483,66,18,67,17,168
1484,68,32,67,17,184
1486,65,35,66,18,184
1487,68,17,66,18,169
1488,67,32,52,14,165
1491,66,17,69,14,166
1492,66,32,67,17,182
1494,52,14,67,17,150
1495,66,20,81,17,184
1496,69,30,68,17,184
1498,67,33,68,16,184
1500,81,17,66,17,181
1501,67,17,66,17,167
1502,68,33,67,16,184
1504,68,33,66,17,184
1505,66,17,66,17,166
1508,67,32,51,16,166
1509,51,32,51,16,150
1510,50,16,51,16,133
1511,66,17,66,17,166
1512,66,33,68,15,182
1513,67,16,68,15,166
1514,51,16,68,15,150
1515,67,16,83,17,183
1516,66,35,65,17,183
1518,68,31,84,17,200
1519,82,34,67,17,200
1520,83,17,67,17,184
1521,66,17,67,17,167
1522,65,35,100,15,215
1525,84,34,66,17,201
1526,67,34,66,17,184
1527,50,34,66,17,167
1528,100,32,67,16,215
1529,100,17,67,16,200
1531,66,17,67,16,166
1532,66,33,83,18,200
1533,82,34,67,16,199
1535,66,18,67,16,167
1536,67,33,69,14,183
1538,67,34,66,16,183
1540,67,35,82,16,200
1541,51,35,82,16,184
1542,69,31,67,16,183
1543,67,17,67,16,167
1544,66,33,66,18,183
1545,66,17,66,18,167
1546,82,16,66,17,181
1547,68,16,66,17,167
1548,67,32,70,14,183
1549,67,16,70,14,167
1550,66,34,68,15,183
1552,66,36,63,19,184
1553,67,19,63,19,168
1554,51,19,63,19,152
1556,68,31,53,15,167
1557,66,16,53,15,150
1558,63,34,83,19,199
1559,68,15,83,19,185
1560,50,15,83,19,167
1561,69,15,68,15,167
1562,53,15,68,15,151
1564,68,34,66,15,183
1565,64,19,66,15,164
1567,54,32,66,17,169
1569,70,15,67,15,167
1570,66,32,50,18,166
1573,64,18,66,17,165
1574,67,33,65,19,184
1575,52,33,65,19,169
1576,50,18,65,19,152
1577,67,17,66,18,168
1578,66,32,69,17,184
1580,65,34,52,16,167
1581,68,15,52,16,151
1583,67,17,82,17,183
1586,52,16,66,16,150
1587,66,17,67,17,167
1588,66,33,67,16,182
1589,65,17,67,16,165
1590,66,34,65,18,183
1591,66,18,65,18,167
1592,67,33,66,18,184
1593,51,33,66,18,168
1594,67,32,52,15,166
1595,51,32,52,15,150
1596,65,34,66,16,181
1598,66,33,67,16,182
1599,68,15,67,16,166
1600,52,15,67,16,150
1602,66,34,51,16,167
1604,67,34,67,19,187
1607,69,16,53,13,151
1608,51,16,53,13,133
1609,51,34,65,16,166
1610,67,32,66,19,184
1611,69,13,66,19,167
1614,65,33,68,17,183
1616,66,35,66,18,185
1619,52,33,67,16,168
1621,66,16,67,17,166
1623,67,16,66,17,166
1624,51,16,66,17,150
1625,66,17,67,17,167
1626,50,17,67,17,151
1627,66,16,68,18,168
1629,67,17,52,15,151
1630,67,34,81,17,199
1632,68,33,65,18,184
1633,69,15,65,18,167
1634,52,15,65,18,150
1635,67,16,67,17,167
1636,66,32,52,15,165
1641,52,32,67,16,167
1642,52,15,67,16,150
1643,66,18,65,17,166
1644,67,32,66,17,182
1645,66,16,66,17,165
1646,51,16,66,17,150
1647,66,17,50,17,150
1648,65,33,68,16,182
1651,67,17,66,18,168
1652,50,17,66,18,151
1653,67,17,65,19,168
1654,68,32,66,18,184
1655,67,16,66,18,167
1657,67,15,51,16,149
1658,65,33,68,16,182
1659,68,14,68,16,166
1660,66,34,68,15,183
1661,66,16,68,15,165
1662,51,16,68,15,150
1664,68,34,65,18,185
1665,66,18,65,18,167
1667,65,17,51,17,150
1668,66,33,69,15,183
1670,65,35,68,15,183
1671,68,17,68,15,168
1672,51,17,68,15,151
1674,69,34,65,15,183
1675,66,19,65,15,165
1676,68,31,67,17,183
1677,66,16,67,17,166
1679,67,17,66,16,166
1680,65,33,67,16,181
1681,65,18,67,16,166
1682,67,33,66,18,184
1683,67,16,66,18,167
1684,66,34,66,16,182
1685,67,18,66,16,167
1686,67,32,69,15,183
1689,68,16,67,18,169
1691,66,19,65,18,168
1693,66,17,66,17,166
1694,67,33,67,18,185
1695,69,15,67,18,169
1696,65,33,67,16,181
1697,68,15,67,16,166
1698,66,34,66,18,184
1700,67,33,66,17,183
1701,67,15,66,17,165
1702,67,33,67,17,184
1703,66,17,67,17,167
1705,66,15,68,16,165
1707,67,17,67,17,168
1708,67,34,67,16,184
1709,66,17,67,16,166
1710,68,33,67,16,184
1711,51,33,67,16,167
1712,67,34,66,18,185
1713,67,17,66,18,168
1714,67,33,66,17,183
1715,67,17,66,17,167
1716,67,33,85,15,200
1718,66,33,67,16,182
1721,67,16,50,17,150
1722,66,34,51,15,166
1724,67,33,67,18,185
1727,66,15,67,16,164
1728,51,15,67,16,149
1729,68,16,67,17,168
1731,67,15,67,18,167
1732,52,15,67,18,152
1733,65,18,66,17,166
1734,67,33,50,16,166
1735,66,16,50,16,148
1736,67,33,83,17,200
1737,51,33,83,17,184
1738,51,15,83,17,166
1739,66,16,67,18,167
1740,50,16,67,18,151
1741,65,18,66,16,165
1742,68,32,67,18,185
1743,66,17,67,18,168
1744,67,34,51,15,167
1746,66,33,67,16,182
1748,67,33,67,16,183
1749,67,15,67,16,165
1751,50,34,66,19,169
1752,67,33,52,16,168
1753,65,17,52,16,150
1754,67,33,68,17,185
1756,66,35,67,14,182
1757,69,16,67,14,166
1758,52,16,67,14,149
1759,52,33,66,17,168
1760,68,34,64,17,183
1761,66,17,64,17,164
1764,66,32,67,18,183
1765,66,15,67,18,166
1766,64,34,68,15,181
1767,50,34,68,15,167
1768,66,33,68,17,184
1770,67,35,66,16,184
1771,50,35,66,16,167
1772,68,33,68,15,184
1774,68,33,66,17,184
1776,50,16,66,17,149
1777,51,35,64,17,167
1778,68,31,67,17,183
1779,51,31,67,17,166
1780,66,33,69,15,183
1781,67,16,69,15,167
1782,64,34,68,16,182
1783,66,17,68,16,167
1785,67,18,65,18,168
1788,68,32,68,16,184
1789,51,32,68,16,167
1790,65,34,65,18,182
1791,68,16,65,18,167
1794,68,31,68,16,183
1795,50,31,68,16,165
1796,50,15,68,16,149
1797,66,17,66,16,165
1798,66,33,66,18,183
1799,66,17,66,18,167
1800,51,17,66,18,152
1803,66,17,68,17,168
1804,66,35,65,18,184
1805,50,35,65,18,168
1807,67,18,67,16,168
1808,68,32,51,14,165
1810,65,35,83,16,199
1811,68,17,83,16,184
1812,67,30,69,16,182
1813,66,14,69,16,165
1814,51,14,69,16,150
1817,83,33,66,17,199
1819,51,33,66,17,167
1821,66,16,68,16,166
1822,84,15,67,17,183
1823,68,15,67,17,167
1825,84,32,52,15,183
1826,68,32,52,15,167
1827,66,16,52,15,149
1828,51,16,52,15,134
1829,67,17,99,18,201
1833,100,16,101,17,234
1834,99,34,67,17,217
1835,99,16,67,17,199
1837,67,16,67,17,167
1839,83,34,84,16,217
1840,101,32,52,16,201
1842,67,32,52,16,167
1845,85,33,67,17,202
1846,84,16,67,17,184
1847,67,16,67,17,167
1848,52,16,67,17,152
1849,83,33,50,16,182
1850,67,33,50,16,166
1851,66,17,50,16,149
1852,67,33,66,18,184
1853,68,16,66,18,168
1854,66,33,67,16,182
1857,67,15,68,16,166
1858,66,34,67,16,183
1860,67,34,66,17,184
1861,65,18,66,17,166
1862,68,33,66,17,184
1863,66,17,66,17,166
1864,67,33,66,18,184
1866,66,33,66,17,182
1867,50,33,66,17,166
1868,66,33,50,16,165
1869,67,16,50,16,149
1870,66,33,86,15,200
1873,66,16,68,17,167
1874,50,16,68,17,151
1876,67,34,66,18,185
1877,69,15,66,18,168
1878,53,15,66,18,152
1879,50,33,67,17,167
1880,67,33,69,15,184
1881,65,16,69,15,165
1882,66,34,50,18,168
1883,67,16,50,18,151
1885,67,18,81,17,183
1886,69,33,65,17,184
1887,66,18,65,17,166
1888,50,18,65,17,150
1891,83,33,67,18,201
1893,50,33,67,18,168
1894,66,33,52,15,166
1897,67,16,67,18,168
1898,67,33,69,14,183
1899,68,15,69,14,166
1900,52,15,69,14,150
1901,66,17,68,16,167
1902,67,35,64,17,183
1903,67,17,64,17,165
1904,52,17,64,17,150
1905,52,33,81,17,183
1906,68,31,67,17,183
1907,66,15,67,17,165
1911,82,33,67,16,198
1912,67,33,67,16,183
1913,67,16,67,16,166
1914,66,34,68,16,184
1915,69,15,68,16,168
1916,52,15,68,16,151
1919,64,19,66,17,166
1922,51,17,65,17,150
1923,52,33,66,18,169
1924,66,32,68,16,182
1925,67,15,68,16,166
1926,65,34,68,16,183
1927,66,17,68,16,167
1928,66,34,66,17,183
1929,67,16,66,17,166
1930,52,16,66,17,151
1932,68,32,67,16,183
1935,67,17,67,16,167
1936,66,33,66,17,182
1939,50,34,83,18,185
1940,67,32,69,16,184
1942,66,33,52,16,167
1943,67,16,52,16,151
1944,65,36,66,16,183
1946,69,32,67,17,185
1947,52,32,67,17,168
1948,52,16,67,17,152
1951,66,17,67,15,165
1954,66,34,65,17,182
1955,66,18,65,17,166
1956,67,31,67,17,182
1957,50,31,67,17,165
1958,65,34,68,16,183
1959,67,16,68,16,167
1960,65,33,68,17,183
1961,50,33,68,17,168
1963,66,18,66,17,167
1964,68,33,66,17,184
1966,68,33,67,17,185
1967,68,16,67,17,168
1968,50,16,67,17,150
1969,67,16,66,18,167
1973,67,15,67,18,167
1976,65,34,68,17,184
1978,67,35,66,16,184
1979,67,17,66,16,166
1980,52,17,66,16,151
1982,68,33,66,18,185
1983,67,16,66,18,167
1984,66,32,84,17,199
1985,67,16,84,17,184
1987,67,15,67,16,165
1989,68,16,100,16,200
1991,82,33,68,17,200
1992,67,33,68,17,185
1993,98,18,65,19,200
1994,100,34,66,18,218
1995,84,34,66,18,202
2000,65,35,65,19,184
2001,49,35,65,19,168
2002,50,16,65,19,150
2003,83,31,51,17,182
2005,65,16,51,17,149
2006,65,34,67,18,184
2007,66,15,67,18,166
2008,65,34,67,17,183
2013,68,16,67,15,166
2014,67,33,67,16,183
2015,67,16,67,16,166
2016,67,34,65,16,182
2018,67,33,67,15,182
2019,65,18,67,15,165
2020,67,32,67,18,184
2021,67,16,67,18,168
2022,65,35,66,16,182
2023,66,19,66,16,167
2025,66,17,67,18,168
2026,67,34,83,17,201
2027,69,16,83,17,185
2028,50,16,83,17,166
2029,84,33,67,16,200
2030,67,33,67,16,183
2031,67,15,67,16,165
2032,51,15,67,16,149
2033,67,17,67,17,168
2034,67,33,66,17,183
2035,65,17,66,17,165
2037,66,18,66,19,169
2039,68,15,53,16,152
2041,67,17,67,15,166
2042,66,35,65,18,184
2043,68,16,65,18,167
2044,53,16,65,18,152
2045,52,32,67,17,168
2046,67,33,66,16,182
2047,63,18,66,16,163
2048,65,34,65,17,181
2049,65,16,65,17,163
2050,51,16,65,17,149
2052,66,33,51,16,166
2054,65,35,65,18,183
2055,65,18,65,18,166
2056,68,32,51,17,168
2057,52,32,51,17,152
2058,51,16,51,17,135
2059,67,16,67,18,168
2060,65,35,67,17,184
2061,67,17,67,17,168
2062,51,17,67,17,152
2063,67,16,52,17,152
2065,67,17,67,17,168
2066,67,34,65,17,183
2068,52,17,65,17,151
2069,51,33,66,16,166
2070,67,32,68,16,183
2072,50,15,68,16,149
2074,66,34,66,16,182
2077,67,17,66,16,166
2079,66,18,66,17,167
2080,66,33,67,16,182
2081,66,17,67,16,166
2082,66,33,67,18,184
2083,67,17,67,18,169
2085,67,17,51,15,150
2086,67,33,84,16,200
2087,67,17,84,16,184
2088,67,33,67,17,184
2089,68,15,67,17,167
2091,50,33,67,16,166
2092,66,34,66,17,183
2093,66,16,66,17,165
2095,66,16,67,17,166
2098,66,34,67,15,182
2099,66,17,67,15,165
2100,67,33,66,18,184
2101,68,16,66,18,168
2102,51,16,66,18,151
2103,66,18,67,16,167
2104,67,32,67,17,183
2106,66,35,65,19,185
2108,67,32,52,15,166
2109,52,32,52,15,151
2110,67,33,68,15,183
2111,66,16,68,15,165
2112,65,34,66,18,183
2113,68,15,66,18,167
2114,52,15,66,18,151
2115,50,34,83,15,182
2116,68,32,66,19,185
2119,67,16,101,17,201
2120,83,15,69,17,184
2121,83,34,52,16,185
2122,66,34,52,16,168
2124,101,33,67,16,217
2125,84,33,67,16,200
2126,69,33,67,16,185
2127,67,16,67,16,166
2128,52,16,67,16,151
2129,82,35,82,17,216
2130,83,17,82,17,199
2131,83,33,66,18,200
2132,67,33,66,18,184
2133,117,33,70,13,233
2134,101,33,70,13,217
2136,82,17,70,13,182
2137,66,17,70,13,166
2138,66,33,101,16,216
2139,82,37,80,16,215
2140,103,30,66,18,217
2141,87,30,66,18,201
2142,70,30,66,18,184
2144,101,32,67,18,218
2145,85,32,67,18,202
2146,80,16,67,18,181
2147,67,16,67,18,168
2148,66,35,65,18,184
2150,67,32,51,15,165
2151,51,32,51,15,149
2153,67,15,66,17,165
2155,67,15,68,18,168
2157,81,35,84,17,217
2158,66,35,84,17,202
2159,65,18,84,17,184
2160,50,18,84,17,169
2162,53,16,67,17,153
2165,66,17,66,16,165
2166,67,33,66,18,184
2169,67,16,51,14,148
2171,65,17,70,12,164
2172,66,32,69,15,182
2173,67,14,69,15,165
2174,51,14,69,15,149
2175,49,38,64,15,166
2178,69,33,81,17,200
2179,85,32,66,18,201
2180,64,32,66,18,180
2181,52,32,66,18,168
2182,81,19,66,17,183
2183,85,31,68,18,202
2185,66,17,68,18,169
2186,66,35,65,18,184
2187,68,17,65,18,168
2188,66,33,67,15,181
2189,69,16,67,15,167
2190,52,16,67,15,150
2191,68,14,68,16,166
2192,51,14,68,16,149
2195,64,18,67,17,166
2196,50,18,67,17,152
2198,66,34,68,16,184
2199,51,34,68,16,169
2201,68,16,67,15,166
2203,68,18,64,17,167
2205,67,16,65,18,166
2206,51,16,65,18,150
2207,50,32,51,17,150
2211,68,17,67,17,169
2212,51,17,67,17,152
2213,51,34,65,17,167
2214,69,33,65,17,184
2215,68,16,65,17,166
2216,67,32,67,17,183
2217,68,15,67,17,167
2218,65,33,67,17,182
2219,65,16,67,17,165
2221,65,17,67,16,165
2222,67,33,66,18,184
2223,67,16,66,18,167
2224,67,34,66,16,183
2225,67,17,66,16,166
2228,50,16,68,16,150
2229,67,16,50,16,149
2230,66,34,67,16,183
2233,66,16,69,16,167
2234,50,16,69,16,151
2236,67,34,65,16,182
2237,67,18,65,16,166
2238,51,18,65,16,150
2240,66,33,67,16,182
2241,67,16,67,16,166
2243,65,18,67,16,166
2245,67,16,50,17,150
2246,51,16,50,17,134
2247,67,18,66,16,167
2248,67,33,66,19,185
2249,66,17,66,19,168
2250,50,17,66,19,152
2251,51,33,52,14,150
2252,66,33,66,18,183
2253,66,17,66,18,167
2255,69,14,68,17,168
2256,52,14,68,17,151
2257,69,14,52,16,151
2259,82,33,66,18,199
2261,66,16,66,18,166
2265,66,16,68,15,165
2266,66,35,65,16,182
2268,52,17,65,16,150
2270,68,32,67,17,184
2273,66,19,64,18,167
2274,67,32,67,17,183
2275,68,16,67,17,168
2276,67,32,68,16,183
2277,68,15,68,16,167
2278,64,35,65,17,181
2279,66,17,65,17,165
2280,67,33,67,17,184
2281,67,16,67,17,167
2282,68,32,52,17,169
2283,66,16,52,17,151
2284,65,35,83,17,200
2285,65,18,83,17,183
2286,67,34,66,16,183
2287,68,17,66,16,167
2289,52,32,67,16,167
2290,66,34,66,17,183
2291,66,17,66,17,166
2292,66,33,68,17,184
2293,67,17,68,17,169
2294,67,33,66,17,183
2296,66,35,65,16,182
2298,68,31,68,16,183
2299,69,14,68,16,167
2300,52,14,68,16,150
2302,65,34,66,18,183
2303,64,18,66,18,166
2305,67,17,66,17,167
2306,67,33,67,16,183
2307,66,18,67,16,167
2308,66,33,67,18,184
2309,68,15,67,18,168
2311,68,17,51,16,152
2314,50,17,67,16,150
2315,68,16,66,17,167
2316,51,16,66,17,150
2317,51,33,68,15,167
2318,67,33,67,16,183
2319,65,17,67,16,165
2320,66,35,82,16,199
2321,66,18,82,16,182
2322,68,32,66,18,184
2323,67,17,66,18,168
2324,67,34,83,18,202
2325,66,18,83,18,185
2326,82,16,69,14,181
2327,67,16,69,14,166
2330,83,18,65,17,183
2331,67,18,65,17,167
2333,65,17,101,16,199
2335,83,33,67,17,200
2336,65,33,67,17,182
2337,51,33,67,17,168
2338,101,33,68,15,217
2340,67,33,68,15,183
2341,66,17,68,15,166
2342,67,33,101,16,217
2343,66,16,101,16,199
2344,83,18,66,16,183
2345,85,33,67,16,201
2347,98,19,84,15,216
2348,101,34,65,17,217
2349,84,34,65,17,200
2350,66,34,65,17,182
2353,103,15,83,17,218
2356,65,34,66,18,183
2357,115,34,67,16,232
2358,99,34,67,16,216
2360,83,17,67,16,183
2362,66,33,68,15,182
2364,85,16,66,17,184
2365,68,16,66,17,167
2366,67,34,66,16,183
2367,65,18,66,16,165
2368,68,32,68,16,184
2369,65,17,68,16,166
2371,67,17,66,17,167
2372,66,34,66,16,182
2373,51,34,66,16,167
2374,68,32,67,18,185
2375,67,16,67,18,168
2377,67,17,67,17,168
2378,66,33,66,17,182
2379,66,17,66,17,166
2381,68,16,84,16,184
2382,67,32,68,16,183
2383,68,15,68,16,167
2384,66,35,65,20,186
2385,65,18,65,20,168
2388,68,32,69,14,183
2389,51,32,69,14,166
2390,65,36,65,17,183
2391,68,16,65,17,166
2393,52,33,66,17,168
2394,69,32,67,16,184
2395,63,18,67,16,164
2397,66,17,66,17,166
2398,66,33,67,17,183
2399,69,16,67,17,169
2400,67,33,51,15,166
2401,66,17,51,15,149
2402,66,34,65,19,184
2403,66,17,65,19,167
2404,50,17,65,19,151
2405,68,15,68,16,167
2407,66,16,67,17,166
2408,65,35,66,18,184
2409,67,16,66,18,167
2410,68,32,52,15,167
2412,67,34,66,17,184
2414,66,33,67,16,182
2415,68,15,67,16,166
2416,52,15,67,16,150
2417,50,33,50,18,151
2418,66,34,68,16,184
2419,65,17,68,16,166
2420,67,34,66,16,183
2422,50,18,66,16,150
2425,52,32,68,15,167
2426,66,33,66,17,182
2427,67,17,66,17,167
2428,65,35,67,15,182
2429,66,18,67,15,166
2430,68,31,69,16,184
2431,52,31,69,16,168
2432,66,36,64,18,184
2434,67,33,65,17,182
2435,52,33,65,17,167
2439,67,16,67,16,166
2440,65,34,66,16,181
2441,66,17,66,16,165
2442,51,17,66,16,150
2444,67,33,66,17,183
2445,66,17,66,17,166
2446,66,33,68,15,182
2450,66,35,68,15,184
2451,67,18,68,15,168
2452,68,33,50,17,168
2453,65,18,50,17,150
2454,68,35,65,17,185
2456,68,32,67,17,184
2457,68,17,67,17,169
2458,50,17,67,17,151
2460,65,34,65,17,181
2461,67,17,65,17,166
2462,67,34,66,16,183
2463,51,34,66,16,167
2465,51,31,51,17,150
2469,66,17,66,17,166
2470,51,17,66,17,151
2473,67,16,66,19,168
2474,66,34,51,16,167
2477,67,15,67,17,166
2478,51,15,67,17,150
2479,68,16,65,17,166
2480,51,16,65,17,149
2481,67,15,66,18,166
2482,67,33,69,14,183
2483,65,16,69,14,164
2484,65,33,69,14,181
2485,65,16,69,14,164
2486,66,36,81,19,202
2487,67,18,81,19,185
2488,69,33,67,16,185
2489,66,19,67,16,168
2491,51,33,66,16,166
2492,66,34,65,17,182
2493,67,19,65,17,168
2495,53,32,66,18,169
2496,66,33,67,16,182
2497,67,17,67,16,167
2502,51,16,66,18,151
2503,66,17,67,16,166
2505,66,16,50,17,149
2508,67,33,50,16,166
2510,50,17,50,16,133
2511,67,14,68,18,167
2512,65,34,68,17,184
2514,50,16,68,17,151
2515,65,17,66,17,165
2516,68,34,84,15,201
2518,52,16,84,15,167
2519,83,34,66,17,200
2520,66,34,66,17,183
2523,82,33,68,16,199
2524,67,33,68,16,184
2525,66,17,68,16,167
2526,66,34,100,18,218
2527,82,34,84,16,216
2531,117,34,67,16,234
2532,100,34,67,16,217
2534,84,16,67,16,183
2536,51,16,67,16,150
2537,85,33,67,16,201
2538,85,16,67,16,184
2540,67,33,66,16,182
2541,51,33,66,16,166
2542,83,17,65,16,181
2543,83,32,67,16,198
2544,67,32,67,16,182
2547,82,34,50,17,183
2549,65,18,50,17,150
2550,67,34,82,17,200
2552,68,33,66,16,183
2553,52,33,66,16,167
2554,50,17,66,16,149
2555,67,18,66,18,169
2556,67,32,52,15,166
2557,66,17,52,15,150
2559,66,18,82,17,183
2560,66,33,66,17,182
2561,69,15,66,17,167
2562,52,15,66,17,150
2563,67,18,67,16,168
2564,82,17,51,15,165
2566,66,35,82,17,200
2567,67,18,82,17,184
2572,65,34,67,16,182
2573,66,17,67,16,166
2574,68,33,68,17,186
2575,66,16,68,17,167
2577,67,17,68,16,168
2578,67,34,66,15,182
2579,66,18,66,15,165
2581,51,34,81,19,185
2583,52,32,68,16,168
2584,66,33,51,15,165
2586,65,35,64,18,182
2587,65,19,64,18,166
2588,68,31,69,15,183
2590,51,15,69,15,150
2591,50,33,68,17,168
2592,64,36,66,15,181
2593,66,18,66,15,165
2594,69,32,67,15,183
2595,67,17,67,15,166
2596,51,17,67,15,150
2597,67,17,67,15,166
2600,67,34,64,17,182
2602,67,31,67,18,183
2603,52,31,67,18,168
2605,50,33,52,18,153
2606,64,34,67,17,182
2607,66,17,67,17,167
2608,67,36,66,16,185
2609,68,18,66,16,168
2611,53,31,51,16,151
2612,67,35,64,20,186
2614,66,32,52,14,164
2615,51,32,52,14,149
2617,68,14,68,15,165
2618,64,34,67,18,183
2620,52,14,67,18,151
2621,65,17,67,17,166
2624,67,34,51,15,167
2625,68,16,51,15,150
2626,67,32,67,16,182
2627,52,32,67,16,167
2629,67,15,66,17,165
2630,51,15,66,17,149
2631,67,15,69,15,166
2633,64,17,68,17,166
2634,66,36,66,15,183
2635,65,19,66,15,165
2636,69,32,66,18,185
2637,53,32,66,18,169
2638,68,34,66,16,184
2639,51,34,66,16,167
2642,66,34,82,19,201
2644,66,32,69,14,181
2645,51,32,69,14,166
2646,66,35,82,18,201
2648,82,19,66,17,184
2649,66,19,66,17,168
2650,69,31,85,17,202
2652,82,18,67,16,183
2653,67,18,67,16,168
2654,66,32,100,17,215
2655,52,32,100,17,201
2656,67,35,82,17,201
2657,85,32,67,16,200
2658,67,32,67,16,182
2660,100,34,67,16,217
2661,82,34,67,16,199
2662,82,17,67,16,182
2663,66,17,67,16,166
2664,67,34,99,17,217
2666,101,34,67,14,216
2667,84,34,67,14,199
2669,67,18,67,14,166
2670,99,35,64,18,216
2673,67,18,64,18,167
2674,67,31,68,15,181
2675,83,33,50,19,185
2676,66,33,50,19,168
2677,66,16,50,19,151
2680,68,34,65,18,185
2681,66,19,65,18,168
2682,50,19,65,18,152
2683,68,15,51,15,149
2685,69,15,67,18,169
2686,65,33,52,17,167
2687,66,15,52,17,150
2688,51,15,52,17,135
2691,67,17,65,17,166
2692,52,17,65,17,151
2693,52,34,65,17,168
2694,69,31,51,16,167
2696,65,34,67,17,183
2697,67,17,67,17,168
2698,65,33,51,15,164
2699,50,33,51,15,149
2700,51,16,51,15,133
2701,66,18,83,17,184
2702,67,32,68,17,184
2703,67,15,68,17,167
2704,51,15,68,17,151
2705,50,33,52,16,151
2706,65,35,67,15,182
2709,52,33,66,18,169
2710,52,16,66,18,152
2712,67,32,83,17,199
2713,65,17,83,17,182
2714,66,34,66,16,182
2715,67,16,66,16,165
2717,51,33,67,15,166
2718,67,33,69,15,184
2719,65,17,69,15,166
2720,66,34,65,18,183
2722,67,35,64,17,183
2724,69,30,69,16,184
2725,53,30,69,16,168
2727,68,16,51,17,152
2728,64,35,65,18,182
2730,51,18,65,18,152
2735,67,17,83,17,184
2737,51,32,68,15,166
2738,52,15,68,15,150
2739,65,19,65,18,167
2740,67,33,66,17,183
2742,68,32,51,15,166
2743,52,32,51,15,150
2744,65,34,83,16,198
2745,67,16,83,16,182
2747,51,32,67,16,166
2748,51,15,67,16,149
2750,66,33,68,15,182
2752,67,34,66,17,184
2753,66,18,66,17,167
2754,67,34,67,15,183
2755,66,18,67,15,166
2757,67,17,67,18,169
2758,66,35,66,17,184
2759,67,18,66,17,168
2760,67,32,51,15,165
2761,52,32,51,15,150
2763,50,34,68,15,167
2764,66,32,69,14,181
2766,51,15,69,14,149
2767,66,18,65,18,167
2771,65,18,67,16,166
2774,65,34,65,18,182
2775,68,17,65,18,168
2776,67,35,64,16,182
2777,65,19,64,16,164
2778,69,30,67,17,183
2779,67,15,67,17,166
2780,65,34,68,16,183
2781,67,16,68,16,167
2782,64,33,68,16,181
2783,65,17,68,16,166
2784,67,35,67,16,185
2785,66,18,67,16,167
2786,68,33,66,17,184
2787,68,17,66,17,168
2788,51,17,66,17,151
2789,67,18,65,18,168
2793,67,16,66,17,166
2794,65,34,66,18,183
2795,67,16,66,18,167
2797,66,16,69,15,166
2798,66,34,68,17,185
2799,65,17,68,17,167
2800,66,35,83,17,201
2802,69,33,67,16,185
2803,67,18,67,16,168
2804,50,18,67,16,151
2805,67,16,100,17,200
2806,83,17,66,17,183
2809,50,32,51,18,151
2810,100,35,64,18,217
2811,83,35,64,18,200
2812,66,35,64,18,183
2814,51,18,64,18,151
2815,83,32,84,18,217
2816,83,16,84,18,201
2817,82,34,68,15,199
2818,64,34,68,15,181
2821,100,18,66,16,200
2822,84,18,66,16,184
2823,66,18,66,16,166
2825,52,32,116,16,216
2827,84,32,66,18,200
2828,66,32,66,18,182
2831,99,16,68,17,200
2832,98,35,67,15,215
2833,82,35,67,15,199
2834,66,35,67,15,183
2836,99,34,65,17,215
2837,84,34,65,17,200
2838,68,34,65,17,184
2839,67,17,65,17,166
2841,67,18,67,15,167
2842,67,32,69,16,184
2843,67,15,69,16,167
2844,65,35,66,16,182
2845,67,18,66,16,167
2846,67,34,65,17,183
2847,65,19,65,17,166
2848,69,32,67,17,185
2849,68,16,67,17,168
2850,66,33,67,16,182
2851,51,33,67,16,167
2852,65,34,67,16,182
2853,66,17,67,16,166
2855,68,16,68,15,167
2856,67,34,67,16,184
2857,66,18,67,16,167
2859,66,18,65,17,166
2860,50,18,65,17,150
2862,67,32,68,15,182
2863,51,32,68,15,166
2865,67,19,80,17,183
2866,68,32,65,16,181
2867,52,32,65,16,165
2869,51,32,67,16,166
2870,64,33,50,16,163
2871,65,17,50,16,148
2873,66,18,84,16,184
2874,67,32,68,16,183
2876,50,16,68,16,150
2877,68,17,67,15,167
2878,67,33,66,18,184
2879,68,16,66,18,168
2880,68,34,67,15,184
2882,67,32,67,18,184
2883,65,17,67,18,167
2886,67,32,68,16,183
2887,52,32,68,16,168
2888,67,33,68,15,183
2890,65,35,66,15,181
2892,68,33,65,17,183
2896,66,32,67,19,184
2900,67,32,50,17,166
2901,52,32,50,17,151
2903,69,14,68,16,167
2904,65,34,68,16,183
2906,50,17,68,16,151
2907,65,17,65,19,166
2909,67,18,67,15,167
2910,50,18,67,15,150
2911,51,31,51,18,151
2912,65,36,65,19,185
2913,68,17,65,19,169
2914,67,33,65,16,181
2915,66,18,65,16,165
2917,66,16,67,18,167
2918,65,33,67,17,182
2920,51,14,67,17,149
2922,67,33,67,17,184
2923,66,15,67,17,165
2924,67,34,65,18,184
2925,68,17,65,18,168
2927,66,16,66,17,165
2928,67,32,51,17,167
2929,67,15,51,17,150
2930,65,34,67,16,182
2931,66,16,67,16,165
2932,66,34,66,18,184
2933,66,17,66,18,167
2934,51,17,66,18,152
2935,68,15,66,18,167
2936,67,33,85,15,200
2938,66,33,67,17,183
2941,68,17,100,16,201
2942,68,32,68,16,184
2943,82,34,67,17,200
2944,67,34,67,17,185
2946,100,33,66,18,217
2947,83,33,66,18,200
2948,68,33,66,18,185
2949,51,33,66,18,168
2952,82,17,82,18,199
2955,67,14,50,18,149
2957,99,18,67,16,200
2958,82,18,67,16,183
2959,64,18,67,16,165
2960,50,18,67,16,151
2961,101,16,83,17,217
2962,84,16,83,17,200
2963,85,34,66,16,201
2964,67,34,66,16,183
2965,50,34,66,16,166
2966,68,32,66,17,183
2968,83,17,67,16,183
2969,67,17,67,16,167
2972,66,35,67,16,184
2974,67,32,68,17,184
2975,67,16,68,17,168
2976,67,35,65,17,184
2977,50,35,65,17,167
2978,67,33,67,16,183
2980,68,32,51,17,168
2981,51,32,51,17,151
2982,65,35,82,19,201
2983,66,18,82,19,185
2984,67,33,68,18,186
2985,66,17,68,18,169
2987,67,17,53,13,150
2989,66,19,83,15,183
2990,68,31,67,16,182
2991,52,31,67,16,166
2994,83,15,51,18,167
2995,80,34,84,15,213
2996,67,34,84,15,200
2997,65,18,84,15,182
2998,68,35,64,17,184
3000,51,18,64,17,150
3001,53,32,67,16,168
3003,67,15,66,17,165
3006,67,31,68,18,184
3007,66,15,68,18,167
3009,66,19,50,16,151
3010,67,32,83,16,198
3011,65,18,83,16,182
3012,68,34,65,17,184
3014,50,16,65,17,148
3015,52,33,65,19,169
3016,83,16,67,17,183
3019,66,16,66,19,167
3020,65,34,69,13,181
3022,67,32,50,20,169
3023,67,15,50,20,152
3024,66,37,65,17,185
3026,69,33,66,15,183
3027,65,20,66,15,166
3028,50,20,66,15,151
3029,51,32,65,18,166
3031,69,17,65,17,168
3032,66,31,68,17,182
3033,65,16,68,17,166
3035,66,16,68,15,165
3036,65,34,68,14,181
3037,67,17,68,14,166
3038,68,34,65,17,184
3040,51,17,65,17,150
3041,51,34,65,18,168
3043,51,31,68,16,166
3044,65,34,67,17,183
3045,67,17,67,17,168
3047,69,16,67,16,168
3048,52,16,67,16,151
3050,67,34,83,17,201
3051,66,17,83,17,183
3052,67,33,67,16,183
3053,51,33,67,16,167
3054,50,17,67,16,150
3056,67,33,67,15,182
3058,67,32,68,15,182
3061,67,17,67,14,165
3062,67,33,67,15,182
3063,51,33,67,15,166
3064,68,34,65,17,184
3065,65,19,65,17,166
3066,67,33,65,17,182
3068,67,32,66,17,182
3071,68,16,66,19,169
3072,65,33,52,15,165
3073,67,16,52,15,150
3074,66,33,68,16,183
3075,66,16,68,16,166
3076,66,34,67,17,184
3078,52,15,67,17,151
3079,68,16,66,17,167
3082,50,17,67,17,151
3083,66,16,51,16,149
3084,66,34,84,17,201
3085,67,17,84,17,185
3086,50,17,84,17,168
3088,51,16,68,15,150
3089,67,17,66,17,167
3090,67,34,66,17,184
3093,51,32,67,18,168
3094,66,34,67,15,182
3095,66,17,67,15,165
3097,68,16,66,17,167
3098,67,34,67,16,184
3099,68,16,67,16,167
3100,67,32,51,16,166
3101,65,17,51,16,149
3103,65,18,65,17,165
3104,67,32,68,16,183
3105,52,32,68,16,168
3106,51,16,68,16,151
3107,50,33,51,17,151
3108,65,35,83,16,199
3109,66,18,83,16,183
3110,50,18,83,16,167
3111,67,17,66,18,168
3112,51,17,66,18,152
3113,51,34,65,18,168
3114,67,32,66,17,182
3116,66,33,67,18,184
3117,68,15,67,18,168
3118,65,33,67,18,183
3119,67,15,67,18,167
3121,65,17,51,15,148
3122,67,33,68,17,185
3123,67,15,68,17,167
3125,68,15,52,15,150
3126,51,15,52,15,133
3127,67,16,66,17,166
3128,68,32,67,18,185
3129,67,15,67,18,167
3130,52,15,67,18,152
3132,66,33,67,17,183
3133,66,16,67,17,166
3134,67,34,67,16,184
3136,67,33,68,16,184
3138,67,34,50,18,169
3139,66,17,50,18,151
3140,50,17,50,18,135
3142,68,34,64,16,182
3146,82,16,67,18,183
3147,66,16,67,18,167
3149,66,18,84,17,185
3150,68,33,68,16,185
3151,67,16,68,16,167
3152,67,33,68,18,186
3153,51,33,68,18,170
3155,67,17,67,16,167
3157,50,33,66,17,166
3158,68,34,65,17,184
3159,68,16,65,17,166
3161,51,32,67,16,166
3164,65,34,66,18,183
3165,66,17,66,18,167
3167,66,17,51,15,149
3168,67,33,67,16,183
3169,67,16,67,16,166
3170,66,33,68,16,183
3172,51,15,68,16,150
3175,65,18,82,16,181
3176,68,32,66,18,184
3177,52,32,66,18,168
3178,50,16,66,18,150
3180,66,32,67,19,184
3182,66,35,66,16,183
3183,67,17,66,16,166
3184,50,17,66,16,149
3185,51,32,69,14,166
3187,68,15,67,16,166
3188,66,35,66,17,184
3189,65,19,66,17,167
3192,67,34,65,16,182
3193,67,18,65,16,166
3196,51,15,68,17,151
3199,64,19,67,16,166
3201,67,16,66,17,166
3202,52,16,66,17,151
3203,52,34,66,16,168
3204,67,32,67,17,183
3206,66,34,67,15,182
3207,67,17,67,15,166
3208,66,33,66,16,181
3211,50,34,66,17,167
3212,67,32,67,17,183
3214,66,34,66,17,183
3216,66,33,67,16,182
3217,51,33,67,16,167
3218,51,16,67,16,150
3219,51,33,68,17,169
3220,66,34,67,17,184
3221,66,17,67,17,167
3222,67,34,65,18,184
3224,68,33,66,17,184
3225,51,33,66,17,167
3226,67,32,67,19,185
3227,51,32,67,19,169
3228,50,15,67,19,151
3229,66,16,67,17,166
3231,66,16,51,17,150
3232,67,34,66,17,184
3233,68,15,66,17,166
3234,67,34,65,16,182
3235,67,17,65,16,165
3236,51,17,65,16,149
3238,66,33,68,15,182
3239,66,16,68,15,165
3241,66,19,66,16,167
3242,68,33,66,18,185
3243,51,33,66,18,168
3244,68,33,67,17,185
3245,67,18,67,17,169
3247,66,17,51,16,150
3249,51,34,67,17,169
3250,51,16,67,17,151
3252,51,16,65,18,150
3256,51,14,53,15,133
3258,65,34,71,13,183
3259,67,15,71,13,166
3262,67,38,62,18,185
3263,64,22,62,18,166
3265,53,30,50,17,150
3267,68,16,68,16,168
3269,67,17,65,17,166
3270,50,17,65,17,149
3271,51,33,65,18,167
3272,68,32,67,18,185
3273,66,16,67,18,167
3274,65,33,52,15,165
3275,66,16,52,15,149
3277,67,16,66,18,167
3278,67,33,67,18,185
3279,68,15,67,18,168
3280,52,15,67,18,152
3281,66,16,52,16,150
3282,66,34,83,18,201
3283,66,16,83,18,183
3284,51,16,83,18,168
3286,52,16,67,16,151
3287,50,32,51,18,151
3288,66,35,82,17,200
3289,65,18,82,17,182
3290,67,34,65,16,182
3291,51,34,65,16,166
3293,52,34,82,17,185
3294,68,31,68,16,183
3295,66,17,68,16,167
3296,65,34,66,17,182
3297,66,18,66,17,167
3298,65,34,82,16,197
3299,68,17,82,16,183
3300,68,32,66,17,183
3301,68,16,66,17,167
3304,64,34,51,17,166
3306,66,35,67,16,184
3307,66,18,67,16,167
3309,51,33,66,16,166
3310,51,17,66,16,150
3311,51,34,82,18,185
3312,67,32,68,15,182
3314,66,34,82,19,201
3315,51,34,82,19,186
3316,82,18,67,15,182
3317,66,18,67,15,166
3318,68,32,83,17,200
3319,84,35,65,17,201
3321,85,32,66,16,199
3322,67,32,66,16,181
3324,83,17,68,16,184
3326,65,33,51,17,166
3327,67,16,51,17,151
3328,66,35,65,17,183
3330,68,33,66,16,183
3331,67,17,66,16,166
3332,51,17,66,16,150
3333,84,34,66,17,201
3334,65,34,66,17,182
3335,66,17,66,17,166
3336,66,33,67,17,183
3342,67,32,68,16,183
3343,67,15,68,16,166
3344,66,35,66,18,185
3345,67,17,66,18,168
3346,50,17,66,18,151
3348,68,33,68,14,183
3349,66,17,68,14,165
3350,66,34,65,19,184
3352,67,34,65,18,184
3353,51,34,65,18,168
3354,68,31,52,15,166
3355,50,31,52,15,148
3356,65,34,83,17,199
3357,68,15,83,17,183
3358,65,33,67,16,181
3360,52,15,67,16,150
3362,83,17,68,15,183
3364,67,32,51,18,168
3366,65,36,83,16,200
3367,68,17,83,16,184
3368,68,33,66,18,185
3369,67,18,66,18,169
3370,51,18,66,18,153
3371,67,16,67,16,166
3372,66,33,67,17,183
3373,68,16,67,17,168
3374,66,34,67,15,182
3376,67,33,66,17,183
3377,66,17,66,17,166
3378,67,34,66,21,188
3379,66,17,66,21,170
3381,51,32,55,13,151
3383,66,17,67,17,167
3384,66,34,66,16,182
3385,72,13,66,16,167
3386,55,13,66,16,150
3387,67,17,67,16,167
3388,67,33,67,16,183
3393,66,17,66,18,167
3396,66,33,68,16,183
3397,66,17,68,16,167
3398,66,34,66,16,182
3399,68,16,66,16,166
3400,67,34,66,17,184
3401,68,17,66,17,168
3402,68,32,68,16,184
3403,66,16,68,16,166
3404,66,34,66,17,183
3406,66,34,67,16,183
3407,50,34,67,16,167
3408,51,17,67,16,151
3409,52,32,69,14,167
3410,66,35,65,17,183
3411,66,18,65,17,166
3413,67,18,64,17,166
3415,52,31,66,18,167
3417,66,16,51,17,150
3419,67,16,68,16,167
3420,66,35,69,14,184
3421,67,17,69,14,167
3422,51,17,69,14,151
3423,51,33,66,17,167
3424,68,36,64,17,185
3425,66,20,64,17,167
3427,67,16,66,17,166
3428,66,34,66,18,184
3430,64,32,68,15,179
3431,67,15,68,15,165
3432,66,34,67,16,183
3434,66,34,67,17,184
3435,67,16,67,17,167
3436,68,33,66,18,185
3438,67,34,83,16,200
3439,65,18,83,16,182
3441,52,32,67,18,169
3442,51,15,67,18,151
3443,68,17,82,16,183
3444,83,16,66,19,184
3445,66,16,66,19,167
3447,81,34,67,18,200
3448,82,16,67,18,183
3450,66,34,100,19,219
3451,67,15,100,19,201
3452,68,33,86,13,200
3453,83,33,53,13,182
3454,67,33,53,13,166
3455,66,15,53,13,147
3456,100,32,68,17,217
3458,86,13,68,17,184
3459,68,13,68,17,166
3460,53,13,68,17,151
3461,82,34,83,18,217
3462,100,34,67,15,216
3463,81,34,67,15,197
3464,68,34,67,15,184
3465,67,17,67,15,166
3466,100,35,66,17,218
3467,83,35,66,17,201
3468,83,18,66,17,184
3469,66,18,66,17,167
3470,67,33,67,15,182
3473,67,17,67,16,167
3474,66,34,66,16,182
3475,68,17,66,16,167
3477,66,18,65,18,167
3478,67,33,67,16,183
3479,66,17,67,16,166
3480,66,32,51,17,166
3484,67,33,66,18,184
3485,51,33,66,18,168
3489,51,32,67,18,168
3490,66,34,66,18,184
3491,69,16,66,18,169
3492,66,33,51,17,167
3493,67,16,51,17,151
3494,67,33,83,18,201
3495,67,15,83,18,183
3496,66,35,66,16,183
3498,51,17,66,16,150
3500,67,34,67,14,182
3502,66,34,65,17,182
3505,69,16,66,17,168
3506,67,32,51,17,167
3508,65,34,65,19,183
3509,65,17,65,19,166
3510,66,34,66,17,183
3511,52,34,66,17,169
3513,51,31,68,16,166
3515,83,33,50,17,183
3520,66,34,67,17,184
3524,69,32,67,15,183
3527,50,33,65,19,167
3529,65,19,65,16,165
3530,67,31,70,14,182
3532,65,34,68,17,184
3533,69,15,68,17,169
3534,65,36,65,17,183
3537,51,32,66,16,165
3538,68,33,66,18,185
3541,51,33,66,17,167
3542,66,33,66,19,184
3543,65,17,66,19,167
3545,67,15,69,16,167
3546,66,33,52,16,167
3547,67,16,52,16,151
3550,69,32,67,17,185
3551,52,32,67,17,168
3553,66,17,65,18,166
3554,66,33,65,17,181
3555,65,18,65,17,165
3556,67,32,67,17,183
3557,50,32,67,17,166
3558,65,33,51,18,167
3559,68,15,51,18,152
3560,65,34,66,17,182
3561,65,17,66,17,165
3563,66,18,65,17,166
3564,51,18,65,17,151
3565,52,31,51,16,150
3566,66,34,67,16,183
3567,66,17,67,16,166
3568,65,33,68,15,181
3569,67,16,68,15,166
3570,51,16,68,15,150
3571,50,34,68,15,167
3572,67,34,67,16,184
3573,66,18,67,16,167
3574,68,34,65,18,185
3575,51,34,65,18,168
3576,68,33,65,17,183
3577,67,18,65,17,167
3578,67,32,68,15,182
3579,68,16,68,15,167
3582,65,35,65,17,182
3583,66,18,65,17,166
3584,68,33,66,17,184
3586,68,32,83,19,202
3587,66,17,83,19,185
3588,65,34,68,16,183
3589,67,17,68,16,168
3590,66,33,69,16,184
3594,49,19,65,18,151
3595,67,18,82,17,184
3596,69,31,68,16,184
3597,69,15,68,16,168
3598,65,35,67,16,183
3599,67,17,67,16,167
3600,66,33,66,16,181
3601,66,17,66,16,165
3602,51,17,66,16,150
3603,66,18,81,17,182
3607,84,32,67,16,199
3608,81,17,67,16,181
3609,82,34,66,17,199
3610,66,34,66,17,183
3612,99,33,51,16,199
3613,84,33,51,16,184
3615,50,33,51,16,150
3619,50,34,67,17,168
3620,51,16,67,17,151
3621,83,34,67,16,200
3622,87,14,67,16,184
3624,67,34,66,16,183
3625,84,33,66,17,200
3627,64,17,66,17,164
3629,66,17,66,17,166
3630,66,33,67,15,181
3632,66,33,68,17,184
3633,67,16,68,17,168
3635,67,17,66,17,167
3636,50,17,66,17,150
3637,65,19,66,17,167
3638,68,32,68,15,183
3640,66,34,66,17,183
3641,68,17,66,17,168
3643,66,17,66,17,166
3644,68,32,51,16,167
3645,66,17,51,16,150
3647,66,17,66,17,166
3649,68,16,67,17,168
3650,51,16,67,17,151
3651,68,15,51,19,153
3652,66,34,69,13,182
3655,66,19,80,17,182
3657,53,33,64,16,166
3658,69,30,67,17,183
3660,63,34,68,16,181
3661,64,17,68,16,165
3663,51,33,66,18,168
3664,67,35,67,15,184
3665,50,35,67,15,167
3666,50,18,67,15,150
3667,52,31,51,17,151
3668,66,36,66,16,184
3669,67,18,66,16,167
3670,67,32,67,16,182
3671,66,17,67,16,166
3672,51,17,67,16,151
3676,67,33,67,16,183
3678,66,34,66,16,182
3679,66,18,66,16,166
3680,67,33,66,18,184
3681,67,17,66,18,168
3682,67,33,67,17,184
3683,67,17,67,17,168
3684,66,33,51,16,166
3686,66,34,65,17,182
3688,67,33,69,15,184
3689,51,33,69,15,168
3690,51,16,69,15,151
3691,66,15,52,15,148
3692,65,37,63,18,183
3693,65,20,63,18,166
3696,52,15,69,16,152
3701,67,17,65,18,167
3702,52,17,65,18,152
3703,51,31,52,17,151
3704,64,34,69,14,181
3705,67,15,69,14,165
3707,66,17,65,19,167
3708,52,17,65,19,153
3713,69,16,65,19,169
3714,66,33,65,19,183
3715,68,17,65,19,169
3716,68,32,67,18,185
3717,66,15,67,18,166
3718,65,33,67,16,181
3722,67,33,66,18,184
3723,66,15,66,18,165
3724,67,34,67,17,185
3726,67,32,65,21,185
3727,67,14,65,21,167
3729,68,17,51,15,151
3731,66,13,69,17,165
3733,68,15,50,18,151
3735,66,16,66,18,166
3737,65,18,65,17,165
3739,82,34,51,17,184
3740,66,34,51,17,168
3742,65,33,67,18,183
3743,66,16,67,18,167
3744,67,35,67,17,186
3745,67,17,67,17,168
3746,51,17,67,17,152
3749,67,17,65,19,168
3752,67,33,52,15,167
3756,67,33,68,15,183
3758,52,15,68,15,150
3759,81,35,66,16,198
3760,82,19,66,16,183
3761,64,19,66,16,165
3762,68,32,68,14,182
3763,82,34,67,15,198
3764,67,34,67,15,183
3765,51,34,67,15,167
3766,66,34,67,15,182
3767,67,18,67,15,167
3768,68,33,67,15,183
3769,52,33,67,15,167
3773,53,33,66,17,169
3774,67,32,66,19,184
3778,66,32,67,17,182
3780,66,33,68,18,185
3782,65,34,69,14,182
3783,66,16,69,14,165
3784,67,34,66,17,184
3786,51,17,66,17,151
3788,69,31,50,17,167
3789,52,31,50,17,150
3790,66,35,65,18,184
3792,66,32,68,15,181
3793,52,32,68,15,167
3794,50,17,68,15,150
3795,83,35,67,17,202
3796,65,35,67,17,184
3798,68,33,51,15,167
3799,66,18,51,15,150
3800,68,34,83,16,201
3801,67,17,83,16,183
3802,67,32,67,17,183
3803,52,32,67,17,168
3804,51,15,67,17,150
3805,65,20,63,16,164
3806,68,31,65,18,182
3807,66,16,65,18,165
3808,51,16,65,18,150
3809,68,15,67,17,167
3810,63,33,51,18,165
3812,65,34,67,17,183
3813,66,16,67,17,166
3814,67,35,66,17,185
3815,51,35,66,17,169
3816,51,18,66,17,152
3817,67,16,51,17,151
3821,67,17,65,20,169
3822,51,17,65,20,153
3823,51,33,52,14,150
3825,66,16,66,18,166
3827,69,14,66,16,165
3828,52,14,66,16,148
3830,66,34,67,17,184
3832,50,16,67,17,150
3833,64,19,67,17,167
3834,69,32,52,15,168
3836,67,35,82,16,200
3837,68,18,82,16,184
3838,67,32,66,17,182
3839,69,15,66,17,167
3841,66,18,67,16,167
3843,65,16,67,16,164
3844,66,35,66,15,182
3846,67,32,67,16,182
3847,51,32,67,16,166
3849,66,18,67,16,167
3853,51,34,66,18,169
3854,67,32,69,15,183
3855,52,32,69,15,168
3856,66,34,50,15,165
3857,67,17,50,15,149
3859,85,30,69,17,201
3860,69,30,69,17,185
3861,67,15,69,17,168
3865,65,19,65,17,166
3867,67,17,65,16,165
3868,50,17,65,16,148
3869,53,31,68,16,168
3870,65,34,66,17,182
3871,65,17,66,17,165
3873,67,18,66,16,167
3875,67,16,67,18,168
3876,66,34,67,17,184
3877,67,17,67,17,168
3879,50,33,51,16,150
3880,50,17,51,16,134
3881,68,16,66,16,166
3882,51,16,66,16,149
3884,51,16,68,17,152
3885,64,18,52,15,149
3887,65,19,81,18,183
3888,68,32,67,17,184
3889,53,32,67,17,169
3890,52,15,67,17,151
3891,68,17,67,17,169
3892,66,33,67,17,183
3894,67,34,65,16,182
3895,67,17,65,16,165
3897,69,16,65,18,168
3898,51,16,65,18,150
3899,67,15,68,17,167
3900,65,33,52,15,165
3901,64,17,52,15,148
3902,65,35,67,17,184
3903,66,17,67,17,167
3904,68,32,66,17,183
3905,52,32,66,17,167
3907,66,18,69,14,167
3911,66,21,80,16,183
3912,69,31,65,19,184
3913,52,31,65,19,167
3914,52,17,65,19,153
3915,52,33,66,17,168
3916,64,32,69,16,181
3918,65,34,51,15,165
3919,50,34,51,15,150
3921,50,35,82,17,184
3924,51,15,68,17,151
3925,68,16,65,18,167
3927,66,17,67,15,165
3928,51,17,67,15,150
3929,66,15,66,19,166
3930,65,35,66,16,182
3931,67,17,66,16,166
3932,50,17,66,16,149
3933,65,16,70,15,166
3934,66,35,50,16,167
3935,67,16,50,16,149
3936,66,35,64,18,183
3937,67,19,64,18,168
3939,66,16,68,17,167
3940,50,16,68,17,151
3941,67,16,52,17,152
3942,64,35,67,15,181
3943,67,17,67,15,166
3945,51,34,66,16,167
3946,52,17,66,16,151
3947,66,18,65,18,167
3949,65,18,67,15,165
3950,66,32,68,16,182
3951,67,16,68,16,167
3952,65,35,65,16,181
3953,68,17,65,16,166
3955,66,18,83,17,184
3956,68,32,68,18,186
3957,66,16,68,18,168
3959,66,17,53,14,150
3961,84,32,67,18,201
3962,68,32,67,18,185
3963,52,32,67,18,169
3964,53,14,67,18,152
3965,66,18,50,15,149
3966,67,32,66,18,183
3967,65,16,66,18,165
3969,68,15,67,17,167
3972,51,15,67,18,151
3974,51,16,67,16,150
3976,67,34,67,15,183
3977,67,16,67,15,165
3978,67,33,66,17,183
3979,66,17,66,17,166
3980,67,34,65,18,184
3981,65,18,65,18,166
3982,67,32,67,17,183
3984,66,33,51,16,166
3986,65,34,68,17,184
3987,68,16,68,17,169
3990,51,16,52,16,135
3991,66,18,84,16,184
3994,52,16,67,16,151
3995,83,35,64,19,201
3997,67,16,64,19,166
3999,66,17,102,13,198
4000,85,14,84,17,200
4001,80,36,65,17,198
4002,64,36,65,17,182
4003,67,17,65,17,166
4004,102,30,67,16,215
4005,98,17,67,16,198
4006,84,17,67,16,184
4008,65,35,82,19,201
4009,84,32,69,14,199
4010,81,16,69,14,180
4011,68,16,69,14,167
4013,66,18,84,15,183
4015,66,19,64,18,167
4020,64,34,66,17,181
4021,50,34,66,17,167
4022,66,33,69,15,183
4024,67,33,67,18,185
4026,66,36,65,18,185
4027,67,19,65,18,169
4029,51,31,52,15,149
4031,68,16,84,16,184
4032,65,33,67,16,181
4033,68,15,67,16,166
4035,66,16,50,18,150
4036,66,34,66,19,185
4038,67,34,51,15,167
4040,50,18,51,15,134
4041,68,14,68,16,166
4042,66,34,66,16,182
4043,69,15,66,16,166
4045,66,16,64,19,165
4046,68,32,69,15,184
4047,65,16,69,15,165
4048,66,32,68,17,183
4049,64,16,68,17,165
4050,64,37,65,17,183
4051,67,18,65,17,167
4052,69,31,51,15,166
4053,53,31,51,15,150
4054,52,16,51,15,134
4055,66,17,66,16,165
4056,65,32,69,15,181
4058,51,15,69,15,150
4060,66,35,66,15,182
4061,65,19,66,15,165
4062,69,34,82,17,202
4063,66,19,82,17,184
4064,69,32,67,17,185
4065,68,17,67,17,169
4066,66,33,51,15,165
4068,65,34,66,16,181
4071,52,32,68,16,168
4072,51,15,68,16,150
4076,68,31,68,18,185
4077,66,15,68,18,167
4079,66,17,67,17,167
4081,66,17,50,16,149
4083,69,15,68,16,168
4085,67,16,51,17,151
4086,50,16,51,17,134
4087,65,18,68,16,167
4089,67,17,66,16,166
4093,68,15,66,17,166
4095,64,18,66,16,164
4096,65,32,68,17,182
4097,66,15,68,17,166
4099,67,17,67,17,168
4100,66,34,66,16,182
4101,65,18,66,16,165
4103,68,16,67,16,167
4104,51,16,67,16,150
4105,51,33,50,16,150
4106,50,16,50,16,132
4107,65,18,83,17,183
4108,67,32,68,17,184
4109,50,32,68,17,167
4110,50,16,68,17,151
4111,67,16,69,15,167
4112,65,35,66,16,182
4113,67,17,66,16,166
4115,51,34,67,17,169
4116,52,17,67,17,153
4117,51,32,52,15,150
4118,66,35,65,17,183
4120,67,32,67,16,182
4122,52,15,67,16,150
4123,51,33,50,17,151
4124,65,34,66,17,182
4126,67,33,67,17,184
4127,52,33,67,17,169
4128,50,17,67,17,151
4129,67,16,51,16,150
4130,66,34,67,15,182
4131,67,17,67,15,166
4132,67,33,66,18,184
4133,67,16,66,18,167
4134,51,16,66,18,151
4135,66,18,66,18,168
4136,67,32,66,19,184
4137,65,17,66,19,167
4138,66,34,67,16,183
4141,69,14,68,17,168
4143,67,16,66,17,166
4145,65,17,67,16,165
4147,66,16,66,18,166
4148,50,16,66,18,150
4149,67,17,68,15,167
4150,67,32,67,17,183
4151,66,16,67,17,166
4154,68,31,68,15,182
4155,67,16,68,15,166
4157,66,17,66,16,165
4159,67,17,81,18,183
4160,68,32,67,16,183
4162,66,37,81,17,201
4163,65,21,81,17,184
4164,81,18,83,18,200
4165,66,18,83,18,185
4166,67,34,117,15,233
4167,51,34,117,15,217
4168,64,34,98,18,214
4169,86,33,65,18,202
4170,83,18,65,18,184
4171,67,18,65,18,168
4174,98,33,67,16,214
4175,83,33,67,16,199
4177,50,33,67,16,166
4179,101,14,84,18,217
4180,100,34,50,18,202
4181,82,34,50,18,184
4183,100,16,82,17,215
4184,101,34,65,18,218
4185,82,34,65,18,199
4187,68,18,65,18,169
4190,82,17,83,18,200
4191,66,17,83,18,184
4192,65,35,66,18,184
4194,85,16,65,17,183
4195,69,16,65,17,167
4196,68,33,67,17,185
4197,65,18,67,17,167
4199,67,14,67,18,166
4200,65,35,67,16,183
4203,66,15,65,18,164
4204,67,35,65,15,182
4205,68,17,65,15,165
4206,67,30,68,16,181
4208,65,35,67,18,185
4209,65,17,67,18,167
4210,65,33,67,17,182
4211,64,18,67,17,166
4213,66,18,66,19,169
4214,67,33,52,16,168
4215,52,33,52,16,153
4217,51,33,68,15,167
4218,66,35,65,18,184
4219,67,16,65,18,166
4221,51,33,66,17,167
4222,68,32,69,16,185
4223,64,17,69,16,166
4225,67,16,68,14,165
4226,66,35,67,16,184
4227,68,18,67,16,169
4228,51,18,67,16,152
4229,67,17,65,18,167
4230,68,34,65,17,184
4231,65,20,65,17,167
4232,67,31,67,17,182
4236,65,33,67,17,182
4237,66,16,67,17,166
4239,66,17,50,16,149
4240,67,33,67,15,182
4243,67,16,68,15,166
4244,50,16,68,15,149
4245,50,34,67,17,168
4246,67,34,66,17,184
4247,65,19,66,17,167
4249,67,18,67,16,168
4250,67,33,67,15,182
4251,52,33,67,15,167
4252,66,34,65,17,182
4253,68,17,65,17,167
4254,67,33,66,16,182
4255,66,17,66,16,165
4256,67,32,67,17,183
4257,50,32,67,17,166
4259,66,17,50,16,149
4260,66,33,67,16,182
4262,67,33,67,16,183
4265,67,17,66,18,168
4267,66,17,68,16,167
4268,50,17,68,16,151
4269,66,17,51,16,150
4270,66,35,66,15,182
4271,68,17,66,15,166
4272,68,32,67,18,185
4274,51,16,67,18,152
4276,66,33,66,18,183
4278,67,32,52,16,167
4280,51,14,52,16,133
4281,50,34,85,15,184
4283,66,16,66,16,164
4284,52,16,66,16,150
4286,68,32,67,18,185
4287,67,15,67,18,167
4288,66,34,84,16,200
4289,65,18,84,16,183
4290,66,33,84,16,199
4293,69,13,69,16,167
4295,68,16,85,15,184
4296,84,16,67,17,184
4297,66,16,67,17,166
4298,69,35,83,15,202
4300,68,32,66,18,184
4301,68,15,66,18,167
4303,51,33,84,16,184
4308,66,34,67,17,184
4309,66,16,67,17,166
4311,65,19,64,18,166
4312,69,32,67,17,185
4315,51,32,52,16,151
4316,64,35,66,18,183
4317,68,17,66,18,169
4318,67,33,67,17,184
4320,52,16,67,17,152
4321,50,33,66,18,167
4323,67,16,66,17,166
4324,67,32,67,17,183
4326,51,15,67,17,150
4327,66,16,67,17,166
4328,66,33,51,17,167
4329,66,16,51,17,150
4331,66,17,65,18,166
4332,67,34,68,18,187
4336,65,37,80,18,200
4337,66,19,80,18,183
4338,68,30,68,17,183
4339,51,30,68,17,166
4340,55,12,68,17,152
4342,65,33,66,17,181
4343,62,18,66,17,163
4345,67,16,67,16,166
4347,69,15,67,16,167
4348,66,34,67,16,183
4349,66,17,67,16,166
4350,67,33,67,16,183
4351,65,17,67,16,165
4354,67,33,70,14,184
4357,67,17,66,18,168
4358,66,37,62,17,182
4360,70,29,68,16,183
4361,54,29,68,16,167
4362,51,15,68,16,150
4363,66,15,51,16,148
4364,62,35,66,17,180
4365,65,18,66,17,166
4366,68,32,67,17,184
4367,66,16,67,17,166
4368,51,16,67,17,151
4370,66,33,66,17,182
4371,67,16,66,17,166
4374,68,31,68,16,183
4376,50,16,68,16,150
4379,66,18,68,15,167
4380,68,32,68,17,185
4381,51,32,68,17,168
4382,67,36,64,17,184
4383,68,18,64,17,167
4385,52,32,66,17,167
4386,68,32,67,17,184
4387,67,15,67,17,166
4389,66,17,68,16,167
4390,66,33,51,17,167
4391,66,16,51,17,150
4392,67,35,84,15,201
4394,68,33,66,18,185
4397,51,33,66,17,167
4398,66,33,69,14,182
4400,66,33,69,14,182
4401,67,15,69,14,165
4404,69,33,64,17,183
4405,51,33,64,17,165
4406,69,30,69,19,187
4407,52,30,69,19,170
4408,63,34,67,16,180
4411,67,18,66,17,168
4412,69,32,68,16,185
4413,69,13,68,16,166
4414,54,13,68,16,151
4415,50,34,66,19,169
4417,64,17,65,17,163
4419,52,32,66,17,167
4420,66,33,68,16,183
4421,68,14,68,16,166
4422,65,33,69,17,184
4424,66,35,65,18,184
4425,82,34,66,16,198
4427,51,34,66,16,167
4428,69,31,67,17,184
4429,69,14,67,17,167
4430,65,35,66,16,182
4431,67,17,66,16,166
4432,66,32,68,16,182
4434,67,34,67,15,183
4435,66,17,67,15,165
4437,66,18,66,18,168
4438,68,33,51,16,168
4439,67,17,51,16,151
4442,66,34,66,18,184
4443,68,16,66,18,168
4444,51,16,66,18,151
4445,86,32,51,18,187
4446,68,32,51,18,169
4448,66,35,65,16,182
4449,67,17,65,16,165
4450,67,34,64,17,182
4451,51,34,64,17,166
4452,51,18,64,17,150
4453,67,15,67,16,165
4454,65,33,67,18,183
4455,65,17,67,18,167
4457,65,17,66,17,165
4458,67,33,67,17,184
4460,67,33,66,18,184
4461,68,15,66,18,167
4465,66,15,52,15,148
4467,67,16,66,17,166
4468,66,33,68,15,182
4469,67,15,68,15,165
4470,52,15,68,15,150
4471,67,15,69,15,166
4472,66,35,65,19,185
4473,65,18,65,19,167
4474,50,18,65,19,152
4475,65,19,65,18,167
4477,52,31,68,17,168
4480,65,34,67,15,181
4481,50,34,67,15,166
4482,52,16,67,15,150
4483,66,17,65,17,165
4484,68,33,67,16,184
4485,66,17,67,16,166
4486,67,32,67,17,183
4487,65,17,67,17,166
4488,65,35,67,15,182
4489,66,18,67,15,166
4490,67,32,68,15,182
4491,68,16,68,15,167
4492,67,35,66,17,185
4493,67,18,66,17,168
4495,66,18,65,17,166
4497,51,33,66,16,166
4498,66,32,68,16,182
4499,68,15,68,16,167
4500,65,34,67,18,184
4501,50,34,67,18,169
4502,66,34,51,17,168
4503,65,18,51,17,151
4504,68,33,83,18,202
4505,67,17,83,18,185
4506,67,35,66,16,184
4507,69,17,66,16,168
4508,51,17,66,16,150
4509,52,32,50,16,150
4510,83,18,66,15,182
4512,66,32,66,17,181
4513,52,32,66,17,167
4517,65,17,68,16,166
4518,66,35,66,17,184
4520,67,33,50,15,165
4521,67,18,50,15,150
4522,68,33,66,18,185
4523,67,17,66,18,168
4524,66,32,52,15,165
4525,68,15,52,15,150
4526,50,15,52,15,132
4527,67,16,85,15,183
4528,66,33,67,18,184
4530,52,15,67,18,152
4533,67,15,51,15,148
4536,67,32,67,18,184
4538,51,15,67,18,151
4540,67,32,85,16,200
4542,67,34,67,15,183
4543,67,16,67,15,165
4545,67,15,67,16,165
4546,67,34,67,16,184
4547,67,16,67,16,166
4548,51,16,67,16,150
4549,64,18,68,16,166
4550,67,34,66,17,184
4551,65,18,66,17,166
4552,67,34,65,18,184
4553,68,18,65,18,169
4554,68,32,66,19,185
4555,68,16,66,19,169
4556,66,33,66,18,183
4557,67,16,66,18,167
4559,67,15,51,18,151
4560,66,33,85,15,199
4561,68,14,85,15,182
4562,66,36,64,18,184
4565,50,32,67,17,166
4566,68,32,69,16,185
4567,67,15,69,16,167
4568,64,35,50,15,164
4569,67,17,50,15,149
4571,84,31,67,17,199
4572,69,31,67,17,184
4573,51,31,67,17,166
4574,50,15,67,17,149
4575,65,18,66,17,166
4576,81,17,68,15,181
4577,65,17,68,15,165
4578,67,34,67,17,185
4581,68,17,65,19,169
4582,68,33,51,16,168
4583,66,18,51,16,151
4584,49,18,51,16,134
4585,67,15,67,19,168
4587,69,16,66,17,168
4588,51,16,66,17,150
4589,66,16,51,16,149
4590,67,34,67,16,184
4591,67,15,67,16,165
4593,50,33,67,18,168
4594,51,16,67,18,152
4595,82,33,50,15,180
4596,67,33,50,15,165
4597,66,17,50,15,148
4599,67,15,84,15,181
4601,67,15,67,19,168
4603,65,18,66,17,166
4605,67,15,69,15,166
4606,52,15,69,15,151
4607,68,16,67,17,168
4608,66,34,67,15,182
4609,67,17,67,15,166
4610,69,33,65,17,184
4611,65,18,65,17,165
4612,67,34,65,18,184
4613,67,17,65,18,167
4614,67,31,68,17,183
4615,67,16,68,17,168
4616,65,34,51,16,166
4621,68,16,66,17,167
4623,65,17,67,17,166
4624,66,33,101,16,216
4625,66,16,101,16,199
4628,67,34,67,15,183
4629,67,17,67,15,166
4630,101,34,67,15,217
4631,84,34,67,15,200
4632,67,34,67,15,183
4633,66,18,67,15,166
4634,67,33,66,17,183
4635,65,18,66,17,166
4636,67,34,67,15,183
4638,67,32,84,17,200
4641,67,18,66,17,168
4642,67,32,83,16,198
4644,84,17,65,17,183
4645,67,17,65,17,166
4646,66,32,99,19,216
4647,83,33,66,19,201
4648,83,16,66,19,184
4649,82,33,52,16,183
4650,65,33,52,16,166
4652,99,35,51,16,201
4653,82,35,51,16,184
4654,66,35,51,16,168
4656,52,16,51,16,135
4657,83,34,65,18,200
4658,68,34,65,18,185
4659,67,16,65,18,166
4660,51,16,65,18,150
4662,66,33,67,18,184
4663,66,15,67,18,166
4664,65,34,51,15,165
4666,67,33,69,16,185
4667,66,16,69,16,167
4668,67,33,68,16,184
4669,67,15,68,16,166
4670,51,15,68,16,150
4671,67,18,83,15,183
4673,67,16,66,16,165
4674,52,16,66,16,150
4675,50,34,84,17,185
4676,66,32,69,14,181
4677,67,15,69,14,165
4678,66,35,66,15,182
4679,66,19,66,15,166
4680,67,34,82,17,200
4682,69,32,67,17,185
4683,53,32,67,17,169
4684,66,33,51,15,165
4686,65,34,67,15,181
4687,68,17,67,15,167
4688,67,32,66,18,183
4689,52,32,66,18,168
4690,51,15,66,18,150
4691,66,18,65,18,167
4692,67,31,52,16,166
4694,66,34,67,17,184
4695,67,16,67,17,167
4696,65,34,67,16,182
4697,68,16,67,16,167
4698,52,16,67,16,151
4701,66,17,66,17,166
4702,67,33,66,18,184
4703,66,17,66,18,167
4704,50,17,66,18,151
4705,67,16,51,16,150
4708,66,34,51,15,166
4710,51,16,51,15,133
4711,67,18,65,17,167
4714,51,15,67,17,150
4716,65,33,53,13,164
4718,51,16,53,13,133
4719,66,16,68,15,165
4721,69,13,67,17,166
4723,67,17,66,17,167
4724,51,17,66,17,151
4725,63,17,51,15,146
4726,67,34,83,18,202
4727,66,17,83,18,184
4728,66,32,69,17,184
4729,68,15,69,17,169
4731,66,19,64,18,167
4732,68,33,65,18,184
4733,66,18,65,18,167
4735,52,31,69,15,167
4737,67,16,66,19,168
4741,51,31,51,16,149
4742,66,34,68,17,185
4743,67,15,68,17,167
4745,67,16,67,16,166
4750,52,15,67,18,152
4753,66,16,68,14,164
4754,51,16,68,14,149
4759,64,19,69,13,165
4760,68,32,67,17,184
4761,50,32,67,17,166
4762,65,37,64,15,181
4763,67,21,64,15,167
4766,67,34,66,15,182
4768,64,32,68,17,181
4770,66,34,67,18,185
4771,67,16,67,18,168
4772,66,34,51,15,166
4773,51,34,51,15,151
4774,68,33,66,18,185
4775,67,16,66,18,167
4776,67,33,66,18,184
4777,52,33,66,18,169
4778,51,15,66,18,150
4779,67,15,68,15,165
4780,66,33,67,17,183
4783,66,17,66,18,167
4784,51,17,66,18,152
4785,65,17,66,18,166
4787,66,17,68,15,166
4788,66,32,68,16,182
4789,69,14,68,16,167
4791,67,18,65,18,168
4792,68,32,66,16,182
4793,65,17,66,16,164
4794,68,33,68,15,184
4795,66,17,68,15,166
4796,65,33,84,21,203
4797,68,15,84,21,188
4799,66,19,70,14,169
4804,70,28,83,19,200
4805,83,33,85,15,216
4806,83,15,85,15,198
4808,61,35,116,16,228
4810,83,19,98,18,218
4811,100,15,67,18,200
4814,100,32,84,17,233
4815,101,16,84,17,218
4816,98,33,51,17,199
4818,67,33,51,17,168
4820,99,34,67,17,217
4821,100,17,67,17,201
4823,66,17,67,17,167
4825,84,34,66,17,201
4826,83,18,66,17,184
4827,84,33,82,18,217
4828,67,33,82,18,200
4829,66,16,82,18,182
4831,67,17,67,17,168
4833,66,16,68,16,166
4834,66,34,66,18,184
4835,66,18,66,18,168
4836,67,34,67,16,184
4837,67,17,67,16,167
4838,51,17,67,16,151
4840,66,35,67,16,184
4841,67,17,67,16,167
4842,67,32,51,17,167
4845,65,19,82,17,183
4847,67,17,66,17,167
4849,52,31,52,15,150
4850,64,35,66,17,182
4853,51,32,68,16,167
4855,68,15,66,17,166
4856,66,34,66,17,183
4857,66,17,66,17,166
4859,65,16,67,17,165
4861,66,17,68,17,168
4862,66,33,52,14,165
4864,67,35,65,18,185
4867,68,14,68,16,166
4868,52,14,68,16,150
4870,65,34,65,17,181
4871,66,16,65,17,164
4872,68,33,66,18,185
4873,51,33,66,18,168
4874,67,32,52,16,167
4877,66,17,68,17,168
4881,51,34,66,15,166
4882,68,32,68,16,184
4883,67,15,68,16,166
4884,51,15,68,16,150
4885,67,15,66,19,167
4887,64,19,67,17,167
4888,68,32,69,16,185
4889,65,16,69,16,166
4890,66,35,66,17,184
4892,51,16,66,17,150
4893,51,34,64,18,167
4894,52,17,64,18,151
4895,66,16,66,18,166
4896,66,32,68,16,182
4898,64,34,66,18,182
4899,66,16,66,18,166
4900,66,34,68,14,182
4902,52,16,68,14,150
4903,66,16,50,19,151
4904,66,36,65,17,184
4906,68,33,66,16,183
4907,66,19,66,16,167
4909,51,32,66,18,167
4911,68,17,67,16,168
4912,66,32,51,16,165
4913,65,16,51,16,148
4914,66,35,65,18,184
4915,67,17,65,18,167
4917,51,32,51,16,150
4918,51,16,51,16,134
4919,67,15,67,17,166
4920,65,34,66,16,181
4921,67,16,66,16,165
4922,51,16,66,16,149
4923,67,15,67,17,166
4924,52,15,67,17,151
4925,66,16,51,17,150
4927,64,18,67,15,164
4930,51,17,67,16,151
4931,52,33,68,16,169
4932,67,34,67,16,184
4933,65,19,67,16,167
4934,67,34,67,15,183
4935,67,18,67,15,167
4937,53,33,67,17,170
4939,51,34,67,15,167
4940,67,33,65,18,183
4942,67,34,64,17,182
4943,68,17,64,17,166
4945,67,16,67,16,166
4946,65,33,67,18,183
4949,66,17,68,16,167
4951,65,17,51,15,148
4952,67,35,66,16,184
4954,51,17,66,16,150
4955,68,15,68,18,169
4956,51,15,68,18,152
4957,67,16,67,17,167
4958,66,33,51,17,167
4960,68,34,67,15,184
4962,67,34,66,15,182
4964,51,17,66,15,149
4965,50,33,82,16,181
4966,67,33,65,20,185
4967,65,18,65,20,168
4968,66,31,54,14,165
4969,50,31,54,14,149
4970,64,34,67,18,183
4972,65,34,68,16,183
4973,50,34,68,16,168
4974,54,14,68,16,152
4976,67,35,52,14,168
4977,65,17,52,14,148
4978,51,17,52,14,134
4980,66,35,67,16,184
4981,69,14,67,16,166
4982,52,14,67,16,149
4985,62,19,64,18,163
4987,52,31,51,18,152
4988,65,33,67,17,182
4989,71,12,67,17,167
4992,51,18,83,16,168
4996,66,33,67,17,183
4997,67,16,67,17,167
4998,52,16,67,17,152
4999,51,32,52,16,151
5000,65,35,82,17,199
5001,66,17,82,17,182
5002,67,33,66,17,183
5004,52,16,66,17,151
5006,66,33,68,16,183
5007,65,17,68,16,166
5010,67,34,65,18,184
5011,51,34,65,18,168
5013,51,32,70,15,168
5014,66,33,67,16,182
5018,70,30,68,16,184
5019,68,15,68,16,167
5020,52,15,68,16,151
5021,65,19,66,17,167
5022,65,33,67,14,179
5024,68,33,65,19,185
5025,52,33,65,19,169
5026,66,34,66,17,183
5027,66,17,66,17,166
5029,65,17,67,17,166
5032,66,32,52,17,167
5034,52,15,52,17,136
5035,65,17,66,17,165
5036,66,35,66,15,182
5038,52,17,66,15,150
5039,52,31,50,17,150
5040,66,35,84,16,201
5041,65,18,84,16,183
5042,66,32,68,17,183
5043,66,17,68,17,168
5044,50,17,68,17,152
5045,67,19,65,16,167
5048,68,33,67,15,183
5049,51,33,67,15,166
5050,65,35,64,17,181
5053,66,17,67,15,165
5054,67,32,67,18,184
5055,51,32,67,18,168
5056,64,35,65,18,182
5060,67,33,67,18,185
5061,68,15,67,18,168
5062,65,35,65,17,182
5064,51,17,65,17,150
5065,50,32,50,17,149
5066,67,33,84,16,200
5067,67,15,84,16,182
5068,65,34,66,17,182
5070,50,17,66,17,150
5073,67,16,68,16,167
5076,65,35,66,17,183
5077,67,17,66,17,167
5078,51,17,66,17,151
5079,51,32,67,17,167
5082,66,33,66,19,184
5083,67,16,66,19,168
5084,67,33,67,16,183
5085,66,16,67,16,165
5086,50,16,67,16,149
5087,66,16,68,18,168
5088,66,34,52,14,166
5095,68,16,67,18,169
5096,66,33,66,22,187
5098,51,16,66,22,155
5099,66,17,67,15,165
5102,66,35,65,18,184
5103,71,13,65,18,167
5104,54,13,65,18,150
5105,64,18,66,18,166
5108,65,34,67,17,183
5109,68,16,67,17,168
5110,66,33,51,17,167
5112,67,34,67,16,184
5114,67,34,66,16,183
5115,66,17,66,16,165
5116,51,17,66,16,150
5119,66,17,68,16,167
5120,66,33,51,16,166
5121,65,17,51,16,149
5122,66,35,65,19,185
5123,67,18,65,19,169
5124,68,32,52,15,167
5125,52,32,52,15,151
5126,51,16,52,15,134
5127,67,16,66,17,166
5128,65,34,68,16,183
5129,68,15,68,16,167
5131,67,15,52,16,150
5132,51,15,52,16,134
5137,67,17,51,17,152
5138,65,33,68,16,182
5139,67,15,68,16,166
5140,51,15,68,16,150
5141,68,17,66,15,166
5144,68,33,66,16,183
5145,66,17,66,16,165
5146,66,34,66,17,183
5148,67,32,67,17,183
5149,51,32,67,17,167
5150,51,15,67,17,150
5151,51,34,65,19,169
5152,66,33,67,17,183
5153,66,16,67,17,166
5154,67,32,52,16,167
5157,67,16,66,17,166
5158,51,16,66,17,150
5159,67,16,67,15,165
5160,52,16,67,15,150
5161,65,17,67,17,166
5162,66,34,68,14,182
5163,66,17,68,14,165
5164,67,33,68,15,183
5165,51,33,68,15,167
5167,67,18,64,19,168
5168,68,33,65,17,183
5169,53,33,65,17,168
5172,64,34,67,16,181
5176,51,17,67,16,151
5177,64,18,50,16,148
5178,67,34,66,15,182
5179,66,18,66,15,165
5181,68,16,68,15,167
5182,50,16,68,15,149
5183,50,34,66,17,167
5184,66,34,66,16,182
5185,65,19,66,16,166
5187,51,32,68,17,168
5188,66,34,51,16,167
5190,66,34,65,19,184
5191,51,34,65,19,169
5192,68,33,67,16,184
5193,68,16,67,16,167
5196,65,35,66,16,182
5197,67,16,66,16,165
5198,51,16,66,16,149
5199,66,16,67,17,166
5201,66,16,50,16,148
5202,66,33,67,17,183
5203,66,17,67,17,167
5205,66,16,67,18,167
5206,50,16,67,18,151
5207,67,17,67,16,167
5208,67,33,68,16,184
5209,67,16,68,16,167
5210,51,16,68,16,151
5211,68,16,66,18,168
5212,67,34,65,18,184
5215,66,16,68,15,165
5218,65,35,65,16,181
5219,67,17,65,16,165
5220,51,17,65,16,149
5221,65,17,68,15,165
5222,50,17,68,15,150
5223,66,16,67,16,165
5224,65,35,66,17,183
5225,66,19,66,17,168
5227,66,17,66,19,168
5230,66,32,84,16,198
5232,66,35,65,18,184
5233,69,16,65,18,168
5237,65,16,68,15,164
5239,68,17,67,15,167
5240,52,17,67,15,151
5241,51,33,68,15,167
5242,68,34,66,16,184
5244,67,34,64,18,183
5245,51,34,64,18,167
5246,68,32,50,16,166
5247,53,32,50,16,151
5248,66,32,68,16,182
5249,67,16,68,16,167
5251,67,16,68,15,166
5252,50,16,68,15,149
5253,68,16,82,17,183
5254,68,34,65,17,184
5256,68,31,69,15,183
5257,65,16,69,15,165
5258,82,17,67,18,184
5259,66,17,67,18,168
5260,65,35,65,17,182
5261,85,32,68,16,201
5262,69,32,68,16,185
5263,52,32,68,16,168
5266,65,35,65,18,183
5267,67,18,65,18,168
5268,68,32,67,17,184
5269,66,16,67,17,166
5271,68,15,68,17,168
5272,65,34,67,17,183
5273,67,16,67,17,167
5274,67,34,66,17,184
5275,66,17,66,17,166
5279,67,16,67,18,168
5280,66,34,65,17,182
5281,66,17,65,17,165
5285,68,14,68,17,167
5286,65,35,67,16,183
5287,67,18,67,16,168
5288,67,33,50,15,165
5289,64,18,50,15,147
5291,68,17,82,18,185
5292,67,31,51,18,167
5293,52,31,51,18,152
5295,67,16,66,16,165
5297,66,18,65,17,166
5298,51,18,65,17,151
5299,50,32,50,17,149
5302,65,34,66,17,182
5303,68,17,66,17,168
5304,50,17,66,17,150
5305,51,33,67,17,168
5306,67,33,67,17,184
5307,67,16,67,17,167
5308,66,34,67,17,184
5314,50,17,66,17,150
5315,67,17,66,17,167
5316,68,32,67,15,182
5317,66,17,67,15,165
5318,66,34,67,17,184
5319,66,17,67,17,167
5321,68,16,66,17,167
5322,51,16,66,17,150
5323,65,19,65,18,167
5324,67,32,51,16,166
5325,67,15,51,16,149
5327,68,16,67,19,170
5329,66,16,68,16,166
5331,50,33,67,18,168
5332,67,35,66,15,183
5333,68,16,66,15,165
5334,52,16,66,15,149
5338,66,33,66,16,181
5339,50,33,66,16,165
5340,67,33,68,16,184
5342,51,15,68,16,150
5343,67,17,68,16,168
5345,64,19,66,16,165
5346,68,33,66,16,183
5347,52,33,66,16,167
5349,52,33,66,17,168
5350,66,33,66,18,183
5351,66,17,66,18,167
5353,66,17,66,18,167
5354,66,33,66,17,182
5355,83,33,69,15,200
5356,66,33,69,15,183
5357,68,15,69,15,167
5358,51,15,69,15,150
5359,67,15,68,17,167
5360,51,15,68,17,151
5361,65,19,65,16,165
5362,69,32,66,18,185
5363,66,17,66,18,167
5365,68,16,51,15,150
5367,66,17,66,19,168
5368,66,33,52,16,167
5369,67,15,52,16,150
5370,51,15,52,16,134
5371,68,15,68,15,166
5373,67,16,66,17,166
5374,52,16,66,17,151
5375,66,17,50,16,149
5376,68,33,67,17,185
5378,66,33,51,16,166
5380,50,16,51,16,133
5381,69,16,66,17,168
5383,67,16,66,18,167
5384,51,16,66,18,151
5385,66,16,51,16,149
5387,66,16,67,18,167
5388,66,34,51,16,167
5390,51,16,51,16,134
5391,50,33,67,16,166
5394,51,16,67,16,150
5395,67,15,68,15,165
5397,65,18,65,18,166
5399,65,18,66,16,165
5401,52,31,67,18,168
5403,67,17,67,16,167
5406,67,35,67,16,185
5407,84,34,66,17,201
5408,67,34,66,17,184
5409,51,34,66,17,168
5412,67,33,83,17,200
5413,51,33,83,17,184
5414,66,33,100,17,216
5415,85,33,67,17,202
5416,66,33,67,17,183
5417,65,18,67,17,167
5418,66,34,99,16,215
5421,85,34,66,16,201
5422,67,34,66,16,183
5423,116,34,67,15,232
5424,99,34,67,15,215
5427,65,18,67,15,165
5428,66,32,101,17,216
5429,82,35,100,16,233
5432,67,32,68,16,183
5433,66,17,68,16,167
5434,101,34,82,18,235
5435,99,17,82,18,216
5437,85,33,67,16,201
5438,68,33,67,16,184
5439,52,33,67,16,168
5440,100,34,66,17,217
5441,83,34,66,17,200
5443,66,18,66,17,167
5444,67,32,66,19,184
5446,83,17,66,18,184
5447,67,17,66,18,168
5448,66,32,52,15,165
5449,50,32,52,15,149
5450,66,34,67,18,185
5451,68,15,67,18,168
5452,51,15,67,18,151
5453,67,15,52,17,151
5454,52,15,52,17,136
5455,66,16,68,16,166
5456,67,35,64,18,184
5457,67,17,64,18,166
5458,52,17,64,18,151
5459,66,18,65,18,167
5460,68,31,52,16,167
5461,66,15,52,16,149
5462,64,34,85,15,198
5463,67,16,85,15,183
5464,65,34,66,18,183
5465,67,16,66,18,167
5466,52,16,66,18,152
5468,67,33,83,17,200
5469,82,34,66,18,200
5470,66,34,66,18,184
5471,67,16,66,18,167
5472,51,16,66,18,151
5475,65,17,68,16,166
5476,66,34,67,17,184
5477,67,16,67,17,167
5478,66,34,66,16,182
5479,67,18,66,16,167
5480,50,18,66,16,150
5482,67,33,66,18,184
5483,68,16,66,18,168
5484,66,33,51,17,167
5485,66,17,51,17,151
5487,65,17,68,17,167
5489,50,35,67,20,172
5490,51,17,67,20,155
5491,52,33,54,11,150
5492,68,34,64,17,183
5493,67,17,64,17,165
5494,67,31,67,17,182
5495,51,31,67,17,166
5497,65,16,68,16,165
5498,64,34,68,16,182
5500,67,34,66,17,184
5502,68,34,67,15,184
5503,67,18,67,15,167
5504,68,32,67,18,185
5505,67,16,67,18,168
5506,66,35,65,18,184
5507,67,18,65,18,168
5508,67,32,67,16,182
5511,68,15,67,16,166
5512,65,34,66,16,181
5513,68,16,66,16,166
5514,51,16,66,16,149
5518,66,33,68,17,184
5519,66,17,68,17,168
5520,66,34,66,17,183
5522,67,34,66,16,183
5523,68,17,66,16,167
5524,68,32,69,14,183
5526,66,34,67,16,183
5531,52,32,66,17,167
5533,51,32,69,16,168
5534,64,34,68,17,183
5535,69,15,68,17,169
5536,66,35,50,16,167
5537,67,18,50,16,151
5538,69,33,82,18,202
5539,66,17,82,18,183
5540,68,33,67,16,184
5541,51,33,67,16,167
5543,65,18,67,17,167
5544,66,34,66,16,182
5547,52,33,67,15,167
5548,67,33,84,16,200
5551,66,18,66,17,167
5553,65,19,66,15,165
5555,68,16,67,16,167
5556,66,34,67,15,182
5557,51,34,67,15,167
5558,66,33,66,17,182
5559,65,18,66,17,166
5560,67,34,66,17,184
5561,66,18,66,17,167
5562,67,32,51,15,165
5563,67,17,51,15,150
5564,66,34,65,19,184
5567,51,32,67,17,167
5568,51,15,67,17,150
5570,65,34,50,18,167
5572,67,34,67,16,184
5573,65,17,67,16,165
5575,65,18,67,16,166
5576,50,18,67,16,151
5579,67,18,67,16,168
5580,67,33,99,16,215
5581,67,17,99,16,199
5582,83,18,100,15,216
5583,85,31,69,15,200
5584,67,31,69,15,182
5592,100,33,68,16,217
5594,65,33,68,16,182
5595,66,17,68,16,167
5596,66,33,67,19,185
5598,84,17,65,17,183
5599,68,17,65,17,167
5600,68,32,68,16,184
5601,82,33,51,17,183
5602,67,33,51,17,168
5603,68,14,51,17,150
5604,65,35,67,16,183
5605,66,18,67,16,167
5609,67,18,65,16,166
5610,67,32,68,16,183
5611,67,16,68,16,167
5613,68,15,51,17,151
5614,65,35,65,16,181
5615,65,19,65,16,165
5616,49,19,65,16,149
5617,66,17,65,19,167
5618,51,17,65,19,152
5619,52,32,52,16,152
5620,65,33,69,16,183
5621,65,17,69,16,167
5622,65,35,65,19,184
5623,68,16,65,19,168
5625,52,34,65,17,168
5626,69,31,51,17,168
5627,50,31,51,17,149
5628,65,34,68,15,182
5629,68,15,68,15,166
5630,65,34,67,16,182
5631,66,17,67,16,166
5632,51,17,67,16,151
5633,65,18,66,17,166
5634,68,33,66,16,183
5635,66,18,66,16,166
5637,67,17,65,17,166
5638,66,33,68,16,183
5639,51,33,68,16,168
5640,50,16,68,16,150
5641,50,32,52,15,149
5642,65,36,65,18,184
5643,65,19,65,18,167
5644,68,31,66,20,185
5645,52,31,66,20,169
5646,52,15,66,20,153
5647,50,34,66,20,170
5648,65,32,54,14,165
5650,52,14,54,14,134
5651,66,14,69,15,164
5652,52,14,69,15,150
5653,68,14,67,16,165
5654,54,14,67,16,151
5655,66,17,66,18,167
5656,69,32,52,15,168
5659,65,18,65,17,165
5661,69,15,68,16,168
5663,51,32,68,16,167
5664,65,36,65,16,182
5666,68,32,66,17,183
5667,51,32,66,17,166
5668,52,16,66,17,151
5669,67,17,67,17,168
5671,65,17,68,16,166
5673,67,17,66,17,167
5674,67,34,66,17,184
5675,68,17,66,17,168
5677,67,16,51,16,150
5678,66,34,66,17,183
5679,66,17,66,17,166
5680,66,33,50,16,165
5682,51,16,50,16,133
5684,66,33,67,17,183
5686,50,16,67,17,150
5687,67,16,67,17,167
5689,66,17,51,16,150
5690,50,17,51,16,134
5691,66,17,66,16,165
5692,67,33,68,14,182
5693,68,16,68,14,166
5695,50,33,66,17,166
5697,49,35,66,18,168
5698,49,19,66,18,152
5700,66,35,67,17,185
5701,50,35,67,17,169
5702,66,33,67,16,182
5703,52,33,67,16,168
5706,67,33,65,17,182
5707,66,16,65,17,164
5708,51,16,65,17,149
5710,65,33,52,17,167
5711,70,11,52,17,150
5712,54,11,52,17,134
5715,63,17,65,16,161
5716,52,17,65,16,150
5717,52,31,67,16,166
5718,67,34,67,17,185
5721,83,34,67,16,200
5723,50,34,67,16,167
5724,67,33,68,15,183
5726,67,34,66,18,185
5727,68,17,66,18,169
5728,50,17,66,18,151
5730,68,32,68,15,183
5731,51,32,68,15,166
5733,68,15,69,15,167
5734,65,35,64,18,182
5736,68,34,65,16,183
5737,65,19,65,16,165
5739,67,15,69,17,168
5741,67,17,67,16,167
5742,65,34,66,16,181
5743,50,34,66,16,166
5744,69,33,66,18,186
5745,51,33,66,18,168
5747,51,33,51,16,151
5748,66,33,67,15,181
5749,65,17,67,15,164
5750,66,34,73,7,180
5751,68,16,73,7,164
5752,51,16,73,7,147
5753,51,33,65,19,168
5754,67,40,61,15,183
5755,64,25,61,15,165
5758,65,36,65,17,183
5759,69,17,65,17,168
5760,61,34,64,17,176
5761,54,34,64,17,169
5762,51,19,64,17,151
5763,51,31,68,17,167
5765,67,16,52,16,151
5766,64,35,67,15,181
5767,67,18,67,15,167
5769,51,33,67,16,167
5770,52,16,67,16,151
5771,67,18,49,17,151
5772,67,33,83,15,198
5773,65,18,83,15,181
5774,67,33,65,17,182
5775,51,33,65,17,166
5776,49,17,65,17,148
5777,51,33,85,17,186
5778,83,15,70,18,186
5779,67,15,70,18,170
5781,66,18,65,19,168
5782,67,35,63,18,183
5783,68,17,63,18,166
5784,53,17,63,18,151
5785,53,30,85,17,185
5786,65,33,52,17,167
5788,63,35,85,16,199
5789,63,17,85,16,181
5790,85,17,84,16,202
5791,66,17,84,16,183
5793,51,33,116,18,218
5794,67,34,100,17,218
5795,84,33,67,17,201
5796,84,16,67,17,184
5797,67,16,67,17,167
5798,99,35,99,16,249
5799,98,18,99,16,231
5803,52,32,67,16,167
5804,102,32,83,17,234
5805,100,17,83,17,217
5806,99,34,66,17,216
5807,82,34,66,17,199
5809,115,34,66,18,233
5813,67,17,66,18,168
5814,66,32,84,16,198
5815,83,34,66,17,200
5816,84,16,66,17,183
5817,67,16,66,17,166
5819,67,16,68,14,165
5820,68,32,68,17,185
5821,66,16,68,17,167
5825,52,32,68,15,167
5826,50,18,68,15,151
5827,68,16,50,17,151
5828,65,35,66,16,182
5832,50,17,68,17,152
5833,67,16,66,16,165
5834,66,34,65,16,181
5835,67,18,65,16,166
5836,68,32,66,17,183
5838,66,33,50,17,166
5840,65,33,69,16,183
5841,64,17,69,16,166
5842,66,34,68,14,182
5844,50,17,68,14,149
5847,68,17,66,16,167
5848,51,17,66,16,150
5849,52,32,67,15,166
5850,65,34,68,16,183
5852,66,33,65,20,184
5853,52,33,65,20,170
5854,67,35,65,16,183
5855,65,20,65,16,166
5856,68,30,68,16,182
5857,52,30,68,16,166
5859,50,35,66,16,167
5860,65,33,66,16,180
5862,68,33,66,18,185
5863,64,17,66,18,165
5864,66,33,67,18,184
5865,66,17,67,18,168
5866,66,33,68,17,184
5867,66,17,68,17,168
5868,66,34,68,15,183
5869,68,16,68,15,167
5870,67,34,67,17,185
5871,69,16,67,17,169
5872,52,16,67,17,152
5873,67,17,65,17,166
5874,51,17,65,17,150
5875,65,18,67,16,166
5876,67,32,51,16,166
5877,67,15,51,16,149
5880,67,32,67,17,183
5881,66,16,67,17,166
5882,51,16,67,17,151
5884,67,32,67,16,182
5885,67,16,67,16,166
5887,68,16,67,17,168
5888,65,34,67,16,182
5890,67,33,67,15,182
5892,67,34,66,17,184
5895,51,33,70,14,168
5896,67,33,51,21,172
5897,65,18,51,21,155
5898,66,37,85,16,204
5899,67,20,85,16,188
5900,70,35,66,15,186
5901,69,21,66,15,171
5902,51,21,66,15,153
5903,55,29,64,19,167
5904,64,37,79,18,198
5906,66,27,70,14,177
5908,64,35,65,19,183
5909,62,16,65,19,162
5910,62,35,66,15,178
5911,64,18,66,15,163
5915,67,17,65,18,167
5916,66,31,52,16,165
5917,67,16,52,16,151
5918,51,16,52,16,135
5919,67,15,84,17,183
5920,65,34,67,17,183
5921,68,16,67,17,168
5922,52,16,67,17,152
5923,64,19,68,16,167
5924,68,33,67,16,184
5925,66,17,67,16,166
5927,52,35,64,16,167
5928,68,32,66,16,182
5930,51,16,66,16,149
5931,50,32,66,18,166
5932,64,34,66,16,180
5934,66,32,69,14,181
5935,66,16,69,14,165
5937,68,16,67,16,167
5939,66,19,65,17,167
5941,51,32,67,16,166
5942,67,33,66,18,184
5943,67,17,66,18,168
5944,65,34,70,15,184
5945,68,17,70,15,170
5946,67,32,69,17,185
5947,67,16,69,17,169
5948,50,16,69,17,152
5949,67,20,63,18,168
5950,70,31,64,17,182
5951,69,16,64,17,166
5953,51,32,67,16,166
5954,63,32,68,18,181
5955,66,14,68,18,166
5956,64,35,67,17,183
5958,67,33,67,16,183
5960,51,17,67,16,151
5962,67,33,66,16,182
5963,68,16,66,16,166
5965,65,17,67,16,165
5966,66,33,66,18,183
5967,67,15,66,18,166
5970,67,32,67,17,183
5971,65,16,67,17,165
5972,66,35,65,18,184
5973,68,17,65,18,168
5974,50,17,65,18,150
5975,51,32,81,20,184
5977,66,16,68,18,168
5978,65,34,67,17,183
5979,67,16,67,17,167
5980,81,20,67,18,186
5981,64,20,67,18,169
5982,68,33,83,18,202
5983,68,15,83,18,184
5984,67,34,67,16,184
5988,83,18,66,17,184
5990,67,34,99,16,216
5991,65,18,99,16,198
5992,83,17,83,17,200
5995,50,34,66,17,167
5998,83,17,67,16,183
