序号,发送->接收,接收->转发,转发->接收,接收->处理,总计
1,62,34,68,16,180
2,58,33,51,15,157
3,50,33,51,15,149
5,84,31,67,22,204
6,68,31,67,22,188
7,51,31,67,22,171
9,86,29,66,18,199
11,65,17,66,18,166
12,67,33,51,17,168
13,72,11,51,17,151
14,51,11,51,17,130
15,68,15,84,16,183
16,66,35,65,18,184
17,62,17,65,18,162
18,51,17,65,18,151
19,82,33,67,16,198
22,65,36,64,17,182
23,50,36,64,17,167
24,51,18,64,17,150
25,52,31,68,17,168
26,67,33,67,18,185
27,65,17,67,18,167
30,50,18,82,16,166
33,68,17,66,18,169
34,82,16,84,17,199
35,65,16,84,17,182
37,66,17,66,16,165
39,51,32,68,16,167
40,84,17,68,16,185
43,64,18,50,21,153
44,68,34,55,14,171
45,67,18,55,14,154
46,68,37,63,16,184
47,68,21,63,16,168
49,55,32,81,15,183
51,53,31,65,17,166
52,63,34,65,17,179
53,61,18,65,17,161
54,81,15,51,17,164
56,65,34,67,17,183
58,65,34,83,15,197
60,51,17,83,15,166
61,84,34,67,16,201
62,67,34,67,16,184
63,67,17,67,16,167
64,83,15,52,15,165
65,66,15,52,15,148
67,66,18,65,18,167
68,67,31,52,16,166
69,67,15,52,16,150
70,52,15,52,16,135
71,83,34,67,17,201
72,65,34,67,17,183
73,67,16,67,17,167
75,66,17,67,17,167
76,68,33,65,18,184
77,66,17,65,18,166
79,67,17,82,16,182
81,68,14,67,17,166
82,51,14,67,17,149
83,66,17,83,18,184
84,82,16,51,18,167
88,64,37,81,18,200
89,67,18,81,18,184
90,51,18,81,18,168
92,71,31,83,18,203
93,66,17,83,18,184
94,65,34,67,15,181
96,65,33,68,16,182
97,66,18,68,16,168
98,83,18,66,16,183
100,67,34,82,18,201
101,67,19,82,18,186
102,68,32,68,15,183
103,68,16,68,15,167
104,66,33,66,17,182
105,67,17,66,17,167
106,82,18,64,19,183
108,68,31,68,17,184
109,67,16,68,17,168
111,66,16,66,19,167
112,64,35,82,18,199
113,68,16,82,18,184
114,68,31,69,17,185
115,68,14,69,17,168
116,52,14,69,17,152
117,66,16,51,17,150
118,82,18,66,17,183
120,69,34,65,18,186
122,51,17,65,18,151
124,66,33,68,15,182
125,66,16,68,15,165
126,65,35,82,17,199
128,85,16,66,17,184
129,68,16,66,17,167
130,68,33,66,17,184
131,65,18,66,17,166
132,82,17,68,16,183
134,66,33,83,18,200
135,51,33,83,18,185
136,66,35,66,17,184
138,68,31,52,15,166
140,83,18,66,17,184
142,66,32,51,16,165
143,67,15,51,16,149
144,52,15,51,16,134
146,66,33,67,18,184
148,51,16,67,18,152
149,84,32,66,16,198
151,67,16,66,16,165
152,67,34,66,18,185
153,51,34,66,18,169
154,50,16,66,18,150
157,64,18,85,16,183
158,66,35,66,17,184
159,51,35,66,17,169
160,52,17,66,17,152
161,53,33,82,16,184
162,85,16,65,17,183
163,67,16,65,17,165
164,66,33,67,16,182
165,52,33,67,16,168
166,82,16,69,16,183
168,65,35,82,16,198
169,65,18,82,16,181
170,67,34,64,18,183
171,67,18,64,18,167
172,69,32,66,16,183
173,68,16,66,16,166
174,82,16,68,15,181
175,66,16,68,15,165
177,66,16,67,16,165
178,66,34,83,16,199
180,68,33,66,19,186
181,65,18,66,19,168
182,67,34,84,16,201
183,67,18,84,16,185
184,83,16,68,17,184
185,68,16,68,17,169
188,67,33,84,16,200
189,84,32,68,16,200
192,65,35,82,17,199
193,66,17,82,17,182
195,67,16,66,17,166
196,68,34,65,18,185
197,66,18,65,18,167
198,67,32,66,19,184
199,82,33,52,16,183
200,66,33,52,16,167
203,68,15,68,17,168
204,66,35,50,17,168
205,68,16,50,17,151
206,52,16,50,17,135
207,67,16,67,17,167
208,68,34,83,15,200
209,66,17,83,15,181
210,50,17,83,15,165
212,67,31,86,16,200
213,67,14,86,16,183
215,82,36,64,18,200
216,65,36,64,18,183
217,65,19,64,18,166
218,86,16,67,17,186
220,68,32,52,15,167
221,51,32,52,15,150
225,68,15,68,15,166
226,52,15,68,15,150
228,65,35,67,17,184
229,66,17,67,17,167
230,68,33,65,18,184
231,51,33,65,18,167
232,68,34,66,16,184
233,66,18,66,16,166
234,67,31,85,16,199
236,51,14,85,16,166
237,67,17,66,18,168
238,66,32,52,14,164
239,65,16,52,14,147
240,67,34,67,16,184
242,66,32,67,19,184
243,68,14,67,19,168
245,67,16,67,16,166
246,67,32,83,21,203
248,51,16,83,21,171
249,67,16,69,15,167
250,67,32,52,16,167
252,67,37,63,18,185
253,64,21,63,18,166
258,63,35,82,18,198
259,66,17,82,18,183
260,50,17,82,18,167
261,68,15,68,16,167
262,52,15,68,16,151
265,65,18,66,16,165
266,68,33,67,16,184
267,52,33,67,16,168
268,51,17,67,16,151
269,51,33,67,16,167
270,66,34,65,16,181
271,66,18,65,16,165
272,67,33,82,17,199
274,67,32,67,16,182
275,67,16,67,16,166
276,65,34,66,17,182
277,65,18,66,17,166
279,66,17,67,16,166
281,51,33,84,16,184
283,67,17,66,17,167
284,50,17,66,17,150
287,67,16,67,17,167
288,66,35,65,18,184
289,67,18,65,18,168
290,68,32,84,17,201
292,67,33,68,15,183
293,50,33,68,15,166
294,65,34,83,18,200
297,67,17,67,15,166
298,68,34,65,16,183
299,50,34,65,16,165
300,83,18,67,16,184
301,66,18,67,16,167
302,67,32,68,16,183
304,65,35,82,18,200
307,68,17,67,14,166
309,52,33,65,18,168
311,66,18,65,17,166
312,67,31,83,18,199
313,65,17,83,18,183
314,65,34,67,18,184
315,67,16,67,18,168
316,65,33,52,15,165
317,51,33,52,15,151
318,67,34,67,16,184
319,65,18,67,16,166
321,68,15,67,18,168
322,52,15,67,18,152
324,67,33,50,16,166
325,65,17,50,16,148
327,69,16,67,16,168
329,51,32,51,16,150
330,50,16,51,16,133
332,67,32,68,16,183
334,51,16,68,16,151
335,50,34,83,16,183
336,66,34,65,17,182
337,68,16,65,17,166
338,52,16,65,17,150
339,66,16,83,17,182
341,65,16,67,16,164
342,65,34,66,17,182
343,66,17,66,17,166
345,83,33,67,18,201
346,67,33,67,18,185
347,66,17,67,18,168
348,66,35,82,17,200
350,50,18,82,17,167
351,52,32,67,16,167
353,68,16,66,16,166
354,82,17,66,18,183
355,65,17,66,18,166
356,67,33,51,16,167
357,65,17,51,16,149
360,66,34,67,16,183
361,68,16,67,16,167
362,51,16,67,16,150
365,67,16,66,17,166
367,50,33,66,18,167
369,66,16,67,17,166
370,66,33,83,17,199
371,67,16,83,17,183
373,67,16,66,17,166
375,67,16,66,17,166
377,65,17,67,16,165
378,66,33,68,16,183
379,66,16,68,16,166
380,66,34,84,16,200
381,67,17,84,16,184
384,68,32,68,16,184
386,84,16,68,16,184
389,67,17,50,16,150
390,51,17,50,16,134
391,66,18,83,17,184
392,68,32,68,15,183
393,51,32,68,15,166
394,50,16,68,15,149
395,68,15,82,19,184
396,83,17,66,16,182
397,67,17,66,16,166
399,50,33,66,16,165
400,82,19,66,17,184
401,64,19,66,17,166
402,66,33,84,16,199
403,51,33,84,16,184
404,66,33,67,17,183
406,66,33,68,16,183
407,67,16,68,16,167
408,84,16,67,16,183
409,68,16,67,16,167
410,67,34,82,16,199
413,66,17,65,18,166
414,67,33,84,16,200
415,66,17,84,16,183
416,82,16,68,16,182
417,66,16,68,16,166
419,67,18,66,15,166
420,84,16,68,16,184
421,68,16,68,16,168
424,66,34,81,17,198
425,65,19,81,17,182
426,68,33,65,18,184
427,52,33,65,18,168
428,67,36,63,16,182
429,69,19,63,16,167
430,81,17,68,16,182
431,65,17,68,16,166
432,65,34,67,16,182
434,63,34,66,17,180
435,67,18,66,17,168
436,68,33,82,18,201
437,66,17,82,18,183
438,67,33,67,17,184
439,67,17,67,17,168
440,66,32,52,16,166
442,82,18,66,16,182
443,66,18,66,16,166
444,67,33,92,12,204
445,67,16,92,12,187
447,51,33,59,12,155
448,66,33,70,19,188
449,65,17,70,19,171
450,92,12,65,17,186
451,75,12,65,17,169
452,59,12,65,17,153
453,55,32,85,16,188
454,70,33,68,17,188
458,85,16,67,17,185
459,66,16,67,17,166
460,68,30,70,16,184
461,51,30,70,16,167
463,83,33,67,17,200
464,67,33,67,17,184
465,67,16,67,17,167
466,54,16,67,17,154
467,65,19,82,17,183
468,85,15,67,17,184
469,68,15,67,17,167
472,82,17,68,15,182
473,65,17,68,15,165
474,67,34,64,18,183
475,67,17,64,18,166
476,52,17,64,18,151
478,68,30,53,14,165
481,68,17,65,19,169
483,68,14,52,17,151
485,67,15,69,15,166
486,65,36,85,15,201
487,66,17,85,15,183
488,52,17,85,15,169
489,51,33,67,16,167
490,69,32,84,17,202
491,65,17,84,17,183
492,65,35,66,15,181
493,70,15,66,15,166
494,67,31,68,15,181
495,52,31,68,15,166
496,66,35,67,15,183
498,66,33,66,18,183
499,65,18,66,18,167
500,68,34,65,18,185
501,65,19,65,18,167
502,67,32,51,16,166
503,67,17,51,16,151
504,66,33,67,17,183
505,51,33,67,17,168
507,68,16,67,16,167
508,51,16,67,16,150
509,82,34,51,15,182
511,66,17,51,15,149
514,66,34,67,17,184
515,68,15,67,17,167
517,67,18,67,14,166
518,69,32,82,18,201
524,67,33,66,17,183
525,65,18,66,17,166
526,65,34,66,17,182
527,66,19,66,17,168
529,67,17,67,16,167
530,66,34,84,16,200
531,68,17,84,16,185
533,68,16,67,16,167
534,67,35,83,18,203
535,66,19,83,18,186
536,84,16,69,14,183
537,67,16,69,14,166
538,67,34,67,16,184
540,83,18,66,15,182
541,67,18,66,15,166
542,69,32,83,16,200
544,67,34,65,16,182
545,66,18,65,16,165
546,66,31,66,18,181
547,67,16,66,18,167
549,67,16,66,16,165
551,50,32,70,16,168
552,66,34,52,16,168
554,66,36,80,19,201
556,70,32,67,14,183
557,52,32,67,14,165
559,52,34,65,18,169
560,80,19,66,15,180
561,64,19,66,15,164
562,67,32,83,17,199
563,52,32,83,17,184
566,66,33,69,13,181
567,52,33,69,13,167
568,67,33,67,16,183
570,66,36,65,16,183
571,51,36,65,16,168
572,69,31,84,15,199
573,53,31,84,15,183
575,67,18,65,18,168
576,65,31,52,16,164
577,52,31,52,16,151
578,84,15,66,19,184
579,68,15,66,19,168
580,65,34,67,16,182
581,67,16,67,16,166
583,66,15,69,15,165
584,66,35,83,17,201
586,67,34,66,16,183
588,69,33,82,17,201
589,65,18,82,17,182
592,66,34,67,16,183
593,51,34,67,16,168
594,82,17,51,17,167
595,66,17,51,17,151
597,64,21,82,16,183
598,67,33,65,17,182
599,52,33,65,17,167
600,51,17,65,17,150
601,54,32,66,17,169
602,65,33,67,17,182
603,66,16,67,17,166
604,65,33,51,16,165
606,66,34,83,18,201
607,66,17,83,18,184
608,67,33,68,17,185
609,67,16,68,17,168
613,66,18,66,17,167
615,50,34,66,17,167
616,51,17,66,17,151
617,52,32,51,16,151
618,66,34,83,16,199
621,67,16,66,17,166
624,83,16,68,16,183
625,66,16,68,16,166
626,66,36,64,18,184
627,51,36,64,18,169
628,68,32,66,17,183
629,52,32,66,17,167
630,68,32,67,17,184
631,67,16,67,17,167
633,67,16,82,18,183
634,50,16,82,18,166
637,66,16,68,16,166
638,66,34,82,18,200
640,67,34,66,17,184
641,50,34,66,17,167
643,52,32,51,17,152
644,66,34,66,17,183
645,66,18,66,17,167
648,51,17,65,18,151
650,66,33,69,16,184
651,66,16,69,16,167
654,51,17,83,16,167
655,51,34,65,17,167
656,69,33,66,16,184
657,51,33,66,16,166
659,66,16,70,13,165
660,65,34,66,16,181
661,66,17,66,16,165
662,66,36,64,17,183
663,66,20,64,17,167
664,70,30,51,17,168
666,66,34,67,15,182
667,66,18,67,15,166
668,64,34,83,16,197
669,68,17,83,16,184
670,51,17,83,16,167
671,52,33,66,16,167
672,67,33,65,17,182
673,50,33,65,17,165
674,66,33,67,16,182
675,83,32,51,17,183
676,66,32,51,17,166
677,51,32,51,17,151
678,65,35,84,15,199
679,65,18,84,15,182
680,67,33,66,18,184
681,67,17,66,18,168
684,66,33,67,16,182
685,68,15,67,16,166
686,66,34,67,16,183
687,68,16,67,16,167
688,51,16,67,16,150
694,50,17,67,14,148
695,68,17,67,15,167
696,67,33,82,17,199
697,51,33,82,17,183
698,67,34,65,16,182
700,67,32,66,18,183
701,51,32,66,18,167
703,68,17,51,17,153
704,65,33,67,16,181
705,66,17,67,16,166
706,66,35,67,16,184
707,68,17,67,16,168
711,65,19,67,14,165
712,67,32,68,16,183
713,51,32,68,16,167
714,67,35,82,16,200
715,69,17,82,16,184
716,67,33,65,18,183
717,51,33,65,18,167
718,68,33,66,16,183
720,66,32,84,16,198
721,68,16,84,16,184
722,65,34,66,18,183
723,67,16,66,18,167
725,50,33,51,17,151
726,84,16,66,18,184
728,66,35,65,16,182
729,68,17,65,16,166
730,51,17,65,16,149
731,51,31,84,18,184
732,66,34,68,17,185
733,66,16,68,17,167
736,84,18,65,16,183
737,66,18,65,16,165
738,68,33,65,19,185
740,67,32,52,15,166
743,64,17,68,15,164
744,65,34,67,16,182
745,68,15,67,16,166
747,51,34,83,18,186
748,68,33,68,14,183
749,64,18,68,14,164
750,67,34,66,15,182
751,66,18,66,15,165
752,67,34,66,16,183
753,68,18,66,16,168
754,68,32,50,16,166
755,52,32,50,16,150
756,66,34,83,17,200
758,66,32,68,16,182
759,68,16,68,16,168
760,50,16,68,16,150
762,83,17,82,17,199
763,84,33,66,16,199
764,68,33,66,16,183
765,51,33,66,16,166
767,67,16,66,18,167
771,65,17,68,16,166
772,66,34,67,16,183
773,68,16,67,16,167
774,51,16,67,16,150
775,51,34,83,16,184
776,68,33,66,17,184
777,66,17,66,17,166
778,67,33,50,17,167
779,49,33,50,17,149
780,83,16,66,19,184
781,67,16,66,19,168
782,66,34,68,16,184
783,50,34,68,16,168
785,82,36,81,17,216
786,66,36,81,17,200
787,68,17,81,17,183
788,68,31,67,16,182
790,52,15,67,16,150
791,65,17,82,18,182
792,65,33,67,16,181
793,65,17,67,16,165
794,67,33,67,17,184
795,66,17,67,17,167
797,84,33,68,15,200
798,67,33,68,15,183
799,51,33,68,15,167
801,68,16,83,18,185
802,66,35,66,17,184
804,52,16,66,17,151
805,51,32,51,15,149
806,67,34,67,16,184
809,51,32,51,17,151
810,51,15,51,17,134
811,67,18,67,15,167
812,67,33,83,17,200
813,66,17,83,17,183
815,51,34,66,17,168
816,67,32,67,18,184
817,66,17,67,18,168
818,66,34,84,17,201
819,68,17,84,17,186
820,66,33,51,17,167
822,67,33,83,18,201
823,68,15,83,18,184
824,51,15,83,18,167
825,67,17,66,15,165
826,51,17,66,15,149
828,68,33,82,19,202
829,83,33,68,14,198
831,51,33,68,14,166
832,66,33,85,15,199
833,51,33,85,15,184
834,66,35,65,17,183
835,67,19,65,17,168
836,68,32,67,17,184
837,52,32,67,17,168
838,85,15,68,15,183
839,69,15,68,15,167
842,67,34,64,18,183
844,68,31,51,17,167
847,65,16,68,17,166
848,64,35,67,16,182
849,67,17,67,16,167
850,51,17,67,16,151
851,51,33,66,19,169
852,68,34,83,16,201
853,67,17,83,16,183
855,66,16,67,17,166
856,50,16,67,17,150
857,68,16,82,17,183
858,67,32,67,16,182
859,67,16,67,16,166
860,67,34,66,17,184
862,66,33,84,17,200
863,66,17,84,17,184
864,67,33,68,15,183
866,66,35,66,17,184
867,67,18,66,17,168
868,84,17,66,16,183
869,68,17,66,16,167
871,51,33,66,17,167
872,66,33,69,14,182
875,67,17,83,17,184
876,66,36,64,18,184
877,66,19,64,18,167
879,53,30,84,27,194
881,66,17,77,9,169
882,64,34,68,17,183
883,68,16,68,17,169
886,77,25,66,17,185
889,52,34,83,16,185
890,59,32,67,19,177
893,66,16,53,17,152
894,83,16,83,18,200
895,82,36,65,16,199
897,69,17,65,16,167
901,64,18,66,16,164
902,65,33,66,17,181
903,51,33,66,17,167
904,82,17,85,15,199
906,66,33,67,18,184
907,66,17,67,18,168
908,66,32,53,17,168
911,69,15,68,16,168
912,67,35,66,16,184
913,50,35,66,16,167
914,53,17,66,16,152
915,64,19,65,17,165
917,66,17,82,18,183
918,66,32,68,15,181
919,68,16,68,15,167
920,65,33,84,18,200
922,82,18,67,17,184
924,68,32,52,16,168
925,51,32,52,16,151
926,67,35,66,17,185
928,67,33,82,17,199
929,52,33,82,17,184
930,52,16,82,17,167
931,68,16,66,18,168
935,65,17,67,16,165
936,66,35,64,19,184
937,67,17,64,19,167
938,68,32,83,17,200
939,52,32,83,17,184
942,64,35,84,15,198
943,68,16,84,15,183
946,68,34,67,16,185
948,84,15,68,15,182
949,68,15,68,15,166
950,66,35,83,17,201
951,50,35,83,17,185
953,66,17,67,16,166
954,68,34,82,17,201
956,67,33,66,16,182
957,67,17,66,16,166
958,67,33,66,17,183
960,82,17,83,16,198
962,66,33,66,16,181
963,66,17,66,16,165
964,66,33,83,17,199
965,67,16,83,17,183
967,67,16,67,18,168
969,65,18,51,17,151
970,67,33,67,16,183
975,52,32,67,16,167
976,67,33,67,16,183
977,65,17,67,16,165
978,65,34,66,16,181
979,67,16,66,16,165
982,67,33,51,17,168
983,65,17,51,17,150
986,68,33,83,16,200
987,52,33,83,16,184
988,51,17,83,16,167
989,52,33,66,18,169
991,66,17,65,18,166
993,66,16,67,16,165
995,68,14,51,17,150
997,66,17,69,13,165
999,65,17,84,16,182
1000,51,17,84,16,168
1001,66,20,64,17,167
1002,69,31,67,16,183
1003,66,18,67,16,167
1004,67,33,83,18,201
1005,84,34,67,16,201
1006,64,34,67,16,181
1007,51,34,67,16,168
1008,67,32,85,17,201
1009,66,16,85,17,184
1011,66,18,67,16,167
1012,67,33,65,19,184
1013,51,33,65,19,168
1014,68,34,65,16,183
1017,67,15,83,19,184
1018,65,34,68,17,184
1019,67,15,68,17,167
1020,65,33,52,16,166
1021,65,17,52,16,150
1025,52,33,67,16,168
1026,52,16,67,16,151
1030,67,33,67,16,183
1031,68,17,67,16,168
1033,67,14,52,17,150
1034,50,14,52,17,133
1035,67,17,66,16,166
1036,50,17,66,16,149
1038,52,17,66,16,151
1039,65,18,83,17,183
1040,66,33,67,17,183
1042,66,32,52,15,165
1044,65,35,66,16,182
1046,67,32,67,18,184
1047,51,32,67,18,168
1048,52,15,67,18,152
1051,65,17,67,18,167
1052,67,33,52,15,167
1054,51,15,52,15,133
1055,67,17,84,16,184
1056,67,33,67,17,184
1057,67,15,67,17,166
1058,52,15,67,17,151
1059,67,17,66,17,167
1060,67,33,83,17,200
1061,82,33,67,16,198
1062,67,33,67,16,183
1063,50,33,67,16,166
1065,66,17,85,15,183
1066,83,17,67,17,184
1067,66,17,67,17,167
1069,50,33,67,16,166
1070,85,15,67,17,184
1071,69,15,67,17,168
1072,52,15,67,17,151
1073,68,16,51,15,150
1074,67,34,83,16,200
1075,64,18,83,16,181
1076,67,32,67,17,183
1077,67,15,67,17,166
1081,66,16,52,15,149
1082,67,34,83,16,200
1083,66,17,83,16,182
1084,67,33,66,17,183
1086,52,15,66,17,150
1087,50,33,84,18,185
1088,66,33,69,15,183
1089,65,16,69,15,165
1090,66,35,67,16,184
1095,52,33,82,18,185
1096,67,33,67,16,183
1097,67,17,67,16,167
1098,66,32,68,16,182
1100,65,35,66,17,183
1101,66,18,66,17,167
1102,67,33,50,16,166
1103,66,17,50,16,149
1105,67,17,84,16,184
1106,66,33,67,16,182
1109,67,16,67,17,167
1111,67,16,67,17,167
1112,67,33,51,15,166
1113,50,33,51,15,149
1114,67,34,67,16,184
1117,68,15,83,17,183
1118,51,15,83,17,166
1119,66,18,65,18,167
1120,67,32,67,17,183
1121,66,16,67,17,166
1122,67,33,67,17,184
1124,65,34,66,17,182
1125,67,16,66,17,166
1126,51,16,66,17,150
1129,66,16,67,17,166
1131,66,16,67,18,167
1132,66,34,66,19,185
1133,67,16,66,19,168
1134,67,33,67,16,183
1135,50,33,67,16,166
1136,67,33,85,16,201
1137,67,15,85,16,183
1138,51,15,85,16,167
1140,52,15,67,18,152
1141,65,18,67,15,165
1143,66,16,83,17,182
1144,67,34,66,16,183
1147,65,17,68,16,166
1148,66,34,50,17,167
1150,66,34,83,16,199
1151,67,18,83,16,184
1155,51,32,67,19,169
1156,65,34,67,16,182
1159,65,16,84,15,180
1160,51,16,84,15,166
1161,68,15,65,18,166
1162,52,15,65,18,150
1163,66,17,85,16,184
1166,65,34,67,18,184
1167,67,16,67,18,168
1168,66,35,66,16,183
1169,68,16,66,16,166
1170,53,16,66,16,151
1172,67,34,67,17,185
1173,66,16,67,17,166
1175,51,32,52,15,150
1176,50,16,52,15,133
1177,67,16,67,16,166
1178,67,32,51,17,167
1180,52,15,51,17,135
1182,67,33,66,16,182
1183,66,17,66,16,165
1186,65,34,67,17,183
1188,66,34,66,17,183
1189,50,34,66,17,167
1192,67,33,66,18,184
1193,51,33,66,18,168
1194,66,33,84,17,200
1196,66,33,68,17,184
1197,66,16,68,17,167
1198,66,34,68,17,185
1199,67,16,68,17,168
1200,67,34,51,17,169
1202,68,34,66,17,185
1204,51,17,66,17,151
1206,51,17,82,16,166
1207,51,32,66,17,166
1210,82,16,67,17,182
1212,66,34,67,16,183
1213,66,17,67,16,166
1214,67,33,83,16,199
1216,67,34,65,17,183
1218,67,32,84,17,200
1219,67,16,84,17,184
1220,66,33,68,16,183
1221,66,16,68,16,166
1222,65,35,66,17,183
1224,84,17,82,18,201
1225,67,17,82,18,184
1226,68,33,67,17,185
1227,51,33,67,17,168
1228,66,33,85,16,200
1229,67,16,85,16,184
1230,66,34,67,17,184
1233,67,17,66,16,166
1234,68,33,65,17,183
1236,67,33,83,16,199
1237,50,33,83,16,182
1238,66,32,67,17,182
1239,65,16,67,17,165
1241,65,18,67,16,166
1243,67,16,67,17,167
1245,67,18,65,17,167
1246,67,32,84,16,199
1247,67,16,84,16,183
1249,67,16,67,17,167
1250,65,33,68,15,181
1251,66,16,68,15,165
1254,67,34,66,17,184
1255,67,17,66,17,167
1256,68,34,65,16,183
1258,68,32,68,15,183
1260,66,33,83,20,202
1261,51,33,83,20,187
1263,66,19,68,13,166
1264,68,33,67,16,184
1266,68,35,64,17,184
1267,67,20,64,17,168
1269,53,32,84,14,183
1270,67,32,66,18,183
1273,51,33,51,16,151
1274,65,33,67,18,183
1275,68,14,67,18,167
1276,66,34,51,16,167
1277,67,16,51,16,150
1278,51,16,51,16,134
1279,81,34,83,16,214
1280,67,34,83,16,200
1282,51,16,83,16,166
1283,51,33,66,17,167
1284,67,34,84,16,201
1286,83,16,68,16,183
1289,66,17,67,16,166
1293,51,33,68,16,168
1294,67,34,83,17,201
1295,65,18,83,17,183
1296,67,34,66,16,183
1297,67,18,66,16,167
1298,68,31,51,16,166
1299,52,31,51,16,150
1301,67,17,66,16,166
1303,50,32,85,16,183
1305,83,33,50,17,183
1307,66,17,50,17,150
1308,67,34,66,16,183
1310,67,33,66,18,184
1313,82,33,68,17,200
1314,66,33,68,17,184
1315,66,17,68,17,168
1316,66,49,69,17,201
1317,67,31,69,17,184
1321,50,34,65,16,165
1322,69,17,83,16,185
1323,64,17,83,16,180
1324,67,32,67,16,182
1325,66,16,67,16,165
1327,65,19,65,17,166
1328,83,16,68,16,183
1329,67,16,68,16,167
1331,51,33,51,17,152
1332,65,35,67,16,183
1333,66,18,67,16,167
1334,68,33,82,18,201
1335,52,33,82,18,185
1336,51,17,82,18,168
1337,69,16,66,17,168
1338,67,32,51,16,166
1339,51,32,51,16,150
1340,50,16,51,16,133
1343,67,16,66,18,167
1344,51,16,66,18,151
1345,51,33,68,16,168
1346,66,33,68,15,182
1348,66,35,83,16,200
1349,67,17,83,16,183
1350,51,17,83,16,167
1351,52,33,66,16,167
1352,51,17,66,16,150
1353,65,17,66,17,165
1356,66,32,68,16,182
1357,67,16,68,16,167
1358,66,33,69,17,185
1359,65,16,69,17,167
1360,65,35,51,16,167
1361,68,16,51,16,151
1363,51,34,66,16,167
1364,69,33,82,19,203
1365,67,16,82,19,184
1366,51,16,82,19,168
1369,65,16,52,15,148
1370,65,36,81,16,198
1371,66,19,81,16,182
1372,68,31,66,18,183
1373,52,31,66,18,167
1375,68,16,67,17,168
1376,65,32,52,16,165
1379,66,17,66,16,165
1380,67,33,68,14,182
1381,51,33,68,14,166
1382,52,16,68,14,150
1384,66,35,66,15,182
1385,65,19,66,15,165
1386,68,32,83,17,200
1387,65,18,83,17,183
1388,67,34,66,19,186
1389,51,34,66,19,170
1390,66,33,52,17,168
1391,52,33,52,17,154
1392,83,17,68,15,183
1394,66,36,64,17,183
1395,51,36,64,17,168
1396,52,17,64,17,150
1397,53,32,65,15,165
1398,68,32,84,16,200
1400,64,33,67,17,181
1402,65,34,84,16,199
1404,84,16,67,17,184
1405,67,16,67,17,167
1406,67,33,51,17,168
1407,52,33,51,17,153
1409,83,34,66,17,200
1413,66,16,51,17,150
1414,66,34,82,19,201
1416,66,34,67,16,183
1417,67,17,67,16,167
1419,51,32,51,17,151
1420,66,35,82,17,200
1422,67,33,66,16,182
1423,51,33,66,16,166
1425,52,31,85,16,184
1426,64,35,66,18,183
1427,66,17,66,18,167
1430,69,32,68,17,186
1431,67,16,68,17,168
1434,65,35,82,16,198
1435,66,18,82,16,182
1436,68,33,65,19,185
1437,67,16,65,19,167
1438,52,16,65,19,152
1439,51,32,68,15,166
1440,82,16,68,16,182
1441,65,16,68,16,165
1442,65,35,84,16,200
1443,68,16,84,16,184
1446,68,32,51,17,168
1447,65,16,51,17,149
1448,84,16,86,14,200
1449,69,16,86,14,185
1451,51,33,67,17,168
1453,83,33,84,16,216
1456,67,33,67,17,184
1457,51,33,67,17,168
1458,66,34,82,18,200
1459,64,17,82,18,181
1460,67,33,67,15,182
1461,67,16,67,15,165
1462,67,32,68,16,183
1463,67,15,68,16,166
1465,65,18,82,16,181
1466,67,33,65,17,182
1467,50,33,65,17,165
1469,67,18,83,16,184
1471,67,16,68,16,167
1472,65,34,68,17,184
1476,68,34,83,17,202
1477,51,34,83,17,185
1479,67,16,67,16,166
1480,67,33,83,16,199
1481,51,33,83,16,183
1482,66,34,65,16,181
1483,66,17,65,16,164
1484,67,33,66,17,183
1486,67,32,51,16,166
1487,66,16,51,16,149
1488,65,34,83,16,198
1491,67,16,66,18,167
1492,51,16,66,18,151
1494,83,16,68,16,183
1495,66,16,68,16,166
1496,66,35,66,16,183
1498,51,17,66,16,150
1500,52,16,83,16,167
1501,66,17,66,18,167
1502,66,33,51,17,167
1504,66,33,69,16,184
1505,67,16,69,16,168
1508,51,17,65,17,150
1509,67,18,81,18,184
1510,69,31,68,17,185
1511,67,15,68,17,167
1512,50,15,68,17,150
1513,66,17,51,19,153
1514,81,18,83,16,198
1515,65,18,83,16,182
1516,68,36,63,17,184
1518,51,19,63,17,150
1519,54,30,50,17,151
1520,66,33,83,18,200
1521,66,16,83,18,183
1522,63,34,67,16,180
1525,66,17,83,17,183
1526,83,18,66,16,183
1527,66,18,66,16,166
1528,67,33,66,18,184
1529,51,33,66,18,168
1531,67,17,51,16,151
1532,66,33,67,16,182
1533,66,17,67,16,166
1535,68,16,84,14,182
1536,51,16,84,14,165
1538,67,35,65,18,185
1540,68,30,68,18,184
1541,67,14,68,18,167
1542,65,35,67,16,183
1543,49,35,67,16,167
1544,65,33,84,15,197
1545,67,15,84,15,181
1546,53,15,84,15,167
1547,67,16,65,17,165
1548,51,16,65,17,149
1549,65,18,65,18,166
1550,68,31,52,17,168
1552,65,34,67,17,183
1553,66,17,67,17,167
1554,65,35,65,18,183
1556,52,17,65,18,152
1557,52,32,67,16,167
1558,67,33,50,18,168
1559,66,16,50,18,150
1560,65,34,66,17,182
1561,67,16,66,17,166
1562,67,34,82,16,199
1564,50,18,82,16,166
1565,50,32,66,17,165
1567,67,17,83,16,183
1569,66,16,67,19,168
1570,66,36,66,17,185
1573,67,16,69,15,167
1574,51,16,69,15,151
1575,69,16,81,19,185
1576,66,34,66,17,183
1577,68,17,66,17,168
1578,52,17,66,17,152
1580,66,34,66,16,182
1581,64,19,66,16,165
1583,51,34,64,17,166
1586,66,32,68,17,183
1587,65,16,68,17,166
1588,64,34,85,16,199
1589,65,17,85,16,183
1590,66,34,67,17,184
1591,68,16,67,17,168
1592,68,33,67,17,185
1593,51,33,67,17,168
1594,67,34,66,16,183
1595,67,16,66,16,165
1596,67,33,84,15,199
1598,67,33,66,17,183
1599,66,16,66,17,165
1600,66,33,84,17,200
1602,66,33,68,16,183
1604,66,35,67,16,184
1607,66,17,84,16,183
1608,68,34,66,17,185
1609,51,34,66,17,168
1610,67,32,51,17,167
1611,67,16,51,17,151
1614,66,34,66,16,182
1616,51,17,66,16,150
1619,66,17,65,17,165
1621,66,17,83,18,184
1623,66,16,69,15,166
1624,65,34,68,16,183
1625,66,17,68,16,167
1626,83,18,66,16,183
1627,67,18,66,16,167
1629,52,33,83,16,184
1630,68,33,66,17,184
1632,66,32,51,17,166
1633,51,32,51,17,151
1634,83,16,83,17,199
1635,67,16,83,17,183
1636,66,34,66,17,183
1641,83,37,63,18,201
1642,66,37,63,18,184
1643,66,20,63,18,167
1644,71,31,83,16,201
1645,54,31,83,16,184
1646,68,32,67,16,183
1647,67,16,67,16,166
1648,63,33,67,18,181
1651,67,16,84,16,183
1652,67,33,67,17,184
1653,65,17,67,17,166
1654,67,33,83,18,201
1655,67,15,83,18,183
1657,68,16,67,16,167
1658,67,34,66,17,184
1659,66,17,66,17,166
1660,83,18,66,17,184
1661,83,33,66,18,200
1662,67,33,66,18,184
1664,66,33,51,15,165
1665,68,16,51,15,150
1667,67,16,84,17,184
1668,66,33,68,17,184
1670,51,15,68,17,151
1671,66,18,65,17,166
1672,84,17,84,15,200
1674,68,32,67,17,184
1675,51,32,67,17,167
1676,65,33,68,17,183
1677,66,16,68,17,167
1679,67,15,68,16,166
1680,67,34,66,18,185
1681,67,17,66,18,168
1682,68,34,82,19,203
1683,66,17,82,19,184
1684,68,32,69,15,184
1685,51,32,69,15,167
1686,66,34,66,18,184
1689,66,19,81,17,183
1691,66,16,67,18,167
1693,68,17,65,17,167
1694,66,32,68,16,182
1695,66,17,68,16,167
1696,67,33,84,17,201
1697,67,15,84,17,183
1698,65,35,66,17,183
1700,68,32,67,17,184
1701,66,16,67,17,166
1702,84,17,65,19,185
1703,67,17,65,19,168
1705,67,16,51,15,149
1707,67,15,68,16,166
1708,50,15,68,16,149
1709,67,15,84,17,183
1710,51,15,84,17,167
1711,66,17,67,17,167
1712,68,34,66,17,185
1713,65,18,66,17,166
1714,50,18,66,17,151
1715,84,33,67,16,200
1716,67,33,67,16,183
1718,66,34,82,16,198
1721,65,18,65,19,167
1722,67,33,68,16,184
1724,82,16,52,17,167
1727,68,17,83,16,184
1728,68,33,66,17,184
1729,52,33,66,17,168
1731,83,33,67,17,200
1732,66,33,67,17,183
1733,67,16,67,17,167
1734,66,33,67,19,185
1735,66,16,67,19,168
1736,66,34,52,14,166
1737,65,18,52,14,149
1738,67,33,83,17,200
1739,67,16,83,17,183
1740,67,33,67,18,185
1741,51,33,67,18,169
1742,52,14,67,18,151
1743,67,16,71,16,170
1744,67,33,54,17,171
1746,67,38,66,16,187
1748,71,33,82,17,203
1749,71,17,82,17,187
1751,53,33,66,17,169
1752,66,33,83,16,198
1753,66,17,83,16,182
1754,82,17,66,17,182
1756,66,33,68,16,183
1757,67,16,68,16,167
1758,83,16,68,17,184
1759,67,16,68,17,168
1760,66,35,82,17,200
1761,49,35,82,17,183
1764,68,33,66,18,185
1765,51,33,66,18,168
1766,66,33,51,16,166
1767,66,17,51,16,150
1768,66,33,67,17,183
1770,66,34,85,15,200
1771,68,16,85,15,184
1772,51,16,85,15,167
1774,67,33,84,16,200
1776,66,34,66,17,183
1777,69,15,66,17,167
1778,67,33,66,18,184
1779,50,33,66,18,167
1780,67,33,68,16,184
1781,65,16,68,16,165
1782,66,33,84,18,201
1783,50,33,84,18,185
1785,67,17,67,14,165
1788,68,34,66,16,184
1789,66,18,66,16,166
1790,67,33,66,17,183
1791,65,19,66,17,167
1794,66,33,83,17,199
1795,52,33,83,17,185
1796,66,34,66,16,182
1797,51,34,66,16,167
1798,67,33,83,17,200
1799,51,33,83,17,184
1800,83,17,67,17,184
1803,51,34,66,17,168
1804,67,33,80,20,200
1805,67,17,80,20,184
1807,51,33,67,16,167
1808,66,34,84,17,201
1810,80,20,68,15,183
1811,63,20,68,15,166
1812,67,32,67,17,183
1813,66,16,67,17,166
1814,84,17,82,16,199
1817,52,31,67,16,166
1819,65,16,84,16,181
1821,67,16,66,17,166
1822,67,33,68,16,184
1823,66,17,68,16,167
1825,66,16,51,17,150
1826,66,35,66,16,183
1827,50,35,66,16,167
1828,68,33,83,16,200
1829,51,33,83,16,183
1833,66,16,52,15,149
1834,83,16,68,17,184
1835,66,16,68,17,167
1837,50,33,52,16,151
1839,84,33,83,17,217
1840,68,33,83,17,201
1842,52,16,83,17,168
1845,65,16,68,17,166
1846,83,17,67,17,184
1847,66,17,67,17,167
1848,52,17,67,17,153
1849,51,33,51,16,151
1850,68,34,84,16,202
1851,67,17,84,16,184
1852,67,33,67,17,184
1853,51,33,67,17,168
1854,51,16,67,17,151
1857,67,16,66,17,166
1858,51,16,66,17,150
1860,66,33,66,18,183
1861,66,16,66,18,166
1862,66,32,52,16,166
1863,66,15,52,16,149
1864,65,34,67,18,184
1866,66,34,66,18,184
1867,67,16,66,18,167
1868,52,16,66,18,152
1869,66,17,83,17,183
1870,67,33,67,17,184
1873,68,15,51,16,150
1874,66,34,83,16,199
1876,67,33,66,18,184
1877,66,16,66,18,166
1878,51,16,66,18,151
1879,65,18,67,16,166
1880,66,33,84,18,201
1881,82,34,68,15,199
1882,66,34,68,15,183
1883,51,34,68,15,168
1885,66,18,84,15,183
1886,68,34,65,17,184
1887,66,18,65,17,166
1888,68,33,66,18,185
1891,68,15,52,16,151
1893,50,34,82,18,184
1894,66,34,66,16,182
1897,51,33,65,18,167
1898,82,18,66,18,184
1899,64,18,66,18,166
1900,66,32,69,16,183
1901,51,32,69,16,168
1902,65,34,51,17,167
1903,50,34,51,17,152
1904,66,35,83,17,201
1905,68,17,83,17,185
1906,69,33,67,16,185
1907,67,17,67,16,167
1911,67,17,66,17,167
1912,67,32,51,15,165
1913,52,32,51,15,150
1914,51,16,51,15,133
1915,83,32,67,17,199
1916,66,32,67,17,182
1919,84,32,68,16,200
1922,51,16,68,16,151
1923,51,33,68,16,168
1924,65,35,83,17,200
1925,66,18,83,17,184
1926,68,33,67,17,185
1927,51,33,67,17,168
1928,68,34,66,16,184
1929,51,34,66,16,167
1930,83,17,66,17,183
1932,67,33,66,17,183
1935,66,17,84,17,184
1936,66,33,68,16,183
1939,67,16,51,17,151
1940,50,16,51,17,134
1942,68,33,66,16,183
1943,51,33,66,16,166
1944,51,17,66,16,150
1946,81,18,84,16,199
1947,83,33,51,16,183
1948,66,33,51,16,166
1951,51,33,67,16,167
1954,51,16,67,16,150
1955,67,16,66,19,168
1956,67,34,51,15,167
1957,65,18,51,15,149
1958,67,32,85,17,201
1959,66,16,85,17,184
1960,66,34,68,17,185
1961,69,15,68,17,169
1963,67,16,52,16,151
1964,85,17,66,16,184
1966,68,33,82,18,201
1967,51,33,82,18,184
1968,52,16,82,18,168
1969,83,33,84,17,217
1973,83,32,67,17,199
1976,66,35,65,17,183
1978,67,32,85,16,200
1979,52,32,85,16,185
1980,67,33,68,17,185
1982,65,35,82,17,199
1983,49,35,82,17,183
1984,68,33,66,16,183
1985,68,16,66,16,166
1987,68,17,66,16,167
1989,82,34,67,14,197
1991,65,18,67,14,164
1992,66,33,83,16,198
1993,51,33,83,16,183
1994,50,17,83,16,166
1995,67,18,65,19,169
2000,65,35,82,17,199
2001,70,16,82,17,185
2002,52,16,82,17,167
2003,51,33,66,17,167
2005,65,16,85,17,183
2006,82,17,68,16,183
2007,67,17,68,16,168
2008,66,33,67,18,184
2013,51,32,66,19,168
2014,67,34,51,15,167
2015,67,16,51,15,149
2016,82,16,68,16,182
2018,66,34,67,17,184
2019,67,15,67,17,166
2020,51,15,67,17,150
2021,84,33,66,16,199
2022,68,33,66,16,183
2023,65,17,66,16,164
2025,67,15,69,16,167
2026,65,34,84,16,199
2027,67,16,84,16,183
2028,66,35,65,17,183
2029,65,19,65,17,166
2030,69,33,65,17,184
2031,67,17,65,17,166
2032,51,17,65,17,150
2033,68,16,84,16,184
2034,65,33,67,16,181
2035,66,16,67,16,165
2037,66,18,83,16,183
2039,67,16,67,15,165
2041,50,35,66,16,167
2042,83,16,83,17,199
2043,67,16,83,17,183
2044,67,34,66,16,183
2045,51,34,66,16,167
2046,66,33,49,19,167
2047,66,17,49,19,151
2048,67,33,83,18,201
2049,68,17,83,18,186
2050,66,35,66,15,182
2052,49,19,66,15,149
2054,66,35,83,16,200
2055,85,32,67,16,200
2056,66,32,67,16,181
2057,50,32,67,16,165
2058,67,33,50,17,167
2059,50,33,50,17,150
2060,83,16,67,15,181
2061,68,16,67,15,166
2062,67,33,66,18,184
2063,66,17,66,18,167
2065,83,32,68,16,199
2066,67,32,68,16,183
2068,66,34,83,18,201
2069,65,16,83,18,182
2070,66,34,67,17,184
2072,68,33,51,17,169
2074,67,34,68,14,183
2077,51,34,64,18,167
2079,52,34,83,15,184
2080,68,30,68,17,183
2081,51,30,68,17,166
2082,64,36,66,16,182
2083,66,18,66,16,166
2085,69,15,68,16,168
2086,53,15,68,16,152
2087,50,34,50,16,150
2088,66,34,81,17,198
2089,65,18,81,17,181
2091,51,32,66,18,167
2092,50,16,66,18,150
2093,67,17,82,19,185
2095,65,17,69,16,167
2098,67,34,82,16,199
2099,67,19,82,16,184
2100,69,33,65,16,183
2101,51,33,65,16,165
2102,67,33,65,19,184
2103,52,33,65,19,169
2104,66,32,67,17,182
2106,65,33,67,16,181
2108,65,34,85,16,200
2109,68,15,85,16,184
2110,52,15,85,16,168
2111,51,33,68,16,168
2112,51,16,68,16,151
2113,64,17,51,17,149
2114,85,16,83,17,201
2115,68,16,83,17,184
2116,68,33,67,15,183
2119,83,33,82,16,214
2120,67,33,82,16,198
2121,67,17,82,16,182
2122,50,17,82,16,165
2124,67,32,83,16,198
2125,67,16,83,16,182
2126,66,32,67,17,182
2127,67,16,67,17,167
2128,64,34,67,19,184
2129,67,15,67,19,168
2130,66,33,53,16,168
2131,67,16,53,16,152
2132,67,34,85,16,202
2133,65,17,85,16,183
2134,67,35,66,16,184
2136,53,16,66,16,151
2137,52,34,83,16,185
2138,69,32,67,16,184
2139,66,16,67,16,165
2140,66,34,66,17,183
2141,52,34,66,17,169
2142,66,33,82,17,198
2144,67,33,66,17,183
2145,51,33,66,17,167
2146,66,33,50,17,166
2147,66,16,50,17,149
2148,82,17,67,16,182
2150,66,34,66,16,182
2151,66,17,66,16,165
2153,51,33,82,19,185
2155,66,17,68,16,167
2157,65,17,51,17,150
2158,66,35,82,16,199
2159,66,19,82,16,183
2160,68,33,65,17,183
2162,51,17,65,17,150
2165,66,16,83,18,183
2166,65,33,68,17,183
2169,66,17,51,17,151
2171,66,18,54,17,155
2172,68,34,69,18,189
2173,68,17,69,18,172
2174,51,17,69,18,155
2175,52,20,67,33,172
2178,69,18,66,16,169
2179,67,33,66,18,184
2180,50,33,66,18,167
2181,68,49,67,16,200
2182,51,49,67,16,183
2183,66,16,67,16,165
2185,66,18,66,17,167
2186,51,18,66,17,152
2187,67,16,51,32,166
2188,67,34,83,16,200
2189,66,18,83,16,183
2190,66,17,66,16,165
2191,67,50,66,16,199
2192,51,50,66,16,183
2195,66,16,67,18,167
2196,67,18,67,16,168
2198,66,33,83,17,199
2199,66,17,83,17,183
2201,67,48,51,16,182
2203,51,32,51,16,150
2205,65,17,68,32,182
2206,66,33,67,16,182
2207,50,33,67,16,166
2211,67,16,84,17,184
2212,67,34,67,15,183
2213,64,18,67,15,164
2214,66,34,65,16,181
2215,50,34,65,16,165
2216,68,33,66,17,184
2217,68,17,66,17,168
2218,67,32,51,33,183
2219,66,17,51,33,167
2221,65,18,83,16,182
2222,66,17,66,16,165
2223,51,17,66,16,150
2224,51,49,85,32,217
2225,68,16,85,32,201
2228,65,35,66,17,183
2229,49,35,66,17,167
2230,68,17,66,16,167
2233,67,17,66,19,169
2234,66,33,52,16,167
2236,50,16,52,16,134
2237,68,34,65,17,184
2238,51,34,65,17,167
2240,52,33,65,17,167
2241,83,33,82,18,216
2243,65,17,82,18,182
2245,65,17,67,16,165
2246,66,33,68,16,183
2247,66,17,68,16,167
2248,66,34,67,15,182
2249,66,18,67,15,166
2250,67,34,66,34,201
2251,67,18,66,34,185
2252,68,16,84,32,200
2253,52,16,84,32,184
2255,66,18,66,16,166
2256,66,34,83,32,215
2257,84,32,66,17,199
2259,52,32,66,17,167
2261,66,18,66,21,171
2265,67,17,68,32,184
2266,66,21,63,16,166
2268,55,47,66,17,185
2270,50,18,66,17,151
2273,50,34,82,19,185
2274,66,33,68,32,199
2275,67,16,68,32,183
2276,67,33,67,16,183
2277,68,16,67,16,167
2278,66,35,81,18,200
2279,65,19,81,18,183
2280,68,32,67,34,201
2281,51,32,67,34,184
2282,67,34,67,32,200
2283,51,34,67,32,184
2284,66,33,66,16,181
2285,67,18,66,16,167
2286,67,34,81,18,200
2287,51,34,81,18,184
2289,52,32,67,17,168
2290,66,33,51,16,166
2291,51,33,51,16,151
2292,65,34,68,16,183
2293,65,18,68,16,167
2294,67,33,51,32,183
2296,51,16,51,32,150
2298,68,16,65,17,166
2299,51,16,65,17,149
2300,51,49,66,18,184
2302,65,33,51,33,182
2303,65,17,51,33,166
2305,68,15,68,35,186
2306,66,18,85,30,199
2307,68,50,65,17,200
2308,51,50,65,17,183
2309,66,17,65,17,165
2311,85,30,52,32,199
2314,65,34,67,17,183
2315,66,17,67,17,167
2316,64,18,66,17,165
2317,67,49,66,18,200
2318,52,49,66,18,185
2319,67,17,66,18,168
2320,67,34,66,17,184
2321,66,17,66,17,166
2322,67,17,66,17,167
2323,51,17,66,17,151
2324,66,18,83,16,183
2325,67,50,68,16,201
2326,66,34,68,16,184
2327,66,17,68,16,167
2330,67,35,66,16,184
2331,66,19,66,16,167
2333,67,50,65,19,201
2335,67,18,65,19,169
2336,66,16,68,33,183
2337,66,49,52,16,183
2338,50,49,52,16,167
2340,65,19,65,17,166
2341,68,33,65,18,184
2342,51,33,65,18,167
2343,68,49,82,20,219
2344,52,49,82,20,203
2345,65,17,82,20,184
2347,49,34,68,30,181
2348,67,17,51,30,165
2349,68,51,82,17,218
2350,51,51,82,17,201
2353,51,30,69,33,183
2356,63,19,67,16,165
2357,67,50,65,19,201
2358,69,33,65,19,186
2360,69,17,67,17,170
2362,66,17,85,30,198
2364,65,19,65,16,165
2365,67,34,64,17,182
2366,51,34,64,17,166
2367,68,47,68,32,215
2368,70,30,68,32,200
2369,65,16,68,32,181
2371,64,17,66,17,164
2372,64,17,66,17,164
2373,67,49,66,18,200
2374,68,32,66,18,184
2375,67,16,66,18,167
2377,66,17,66,16,165
2378,66,18,64,19,167
2379,82,34,67,17,200
2381,67,16,67,17,167
2382,50,16,67,17,150
2383,64,19,65,19,167
2384,50,19,65,19,153
2385,51,32,52,33,168
2388,65,19,66,32,182
2389,69,33,65,17,184
2390,52,33,65,17,167
2391,68,33,83,15,199
2393,66,49,67,17,199
2394,51,49,67,17,184
2395,65,17,67,17,166
2397,83,33,85,31,232
2398,67,33,85,31,216
2399,66,18,85,31,200
2400,67,34,82,16,199
2401,67,17,82,16,182
2402,50,17,82,16,165
2403,52,33,65,19,169
2404,67,18,66,17,168
2405,68,47,86,16,217
2407,66,16,86,16,184
2408,65,19,67,16,167
2409,66,49,85,15,215
2410,51,49,85,15,200
2412,68,18,82,32,200
2414,66,16,82,19,183
2415,51,16,82,19,168
2416,85,47,70,15,217
2417,67,47,70,15,199
2418,66,32,70,15,183
2419,82,19,66,17,184
2420,66,19,66,17,168
2422,51,34,66,16,167
2425,66,34,65,19,184
2426,66,17,65,19,167
2427,66,48,67,18,199
2428,65,32,67,18,182
2429,50,32,67,18,167
2430,65,36,82,16,199
2431,65,19,82,16,182
2432,68,31,67,18,184
2434,67,18,67,17,169
2435,68,49,66,18,201
2439,49,18,66,17,150
2440,50,34,65,17,166
2441,51,17,65,17,150
2442,52,49,82,16,199
2444,66,33,65,17,181
2445,65,17,65,17,164
2446,68,17,65,19,169
2450,65,36,66,32,199
2451,65,19,66,32,182
2452,68,17,65,16,166
2453,52,17,65,16,150
2454,53,32,66,18,169
2456,66,32,68,16,182
2457,65,16,68,16,165
2458,65,35,67,17,184
2460,67,17,67,17,168
2461,51,17,67,17,152
2462,68,16,69,32,185
2463,67,35,66,16,184
2465,67,34,65,33,199
2469,66,33,65,16,180
2470,65,17,65,16,163
2473,66,48,70,31,215
2474,66,32,70,31,199
2477,65,17,67,16,165
2478,66,36,65,15,182
2479,67,19,65,15,166
2480,70,31,66,18,185
2481,68,16,66,18,168
2482,67,34,50,17,168
2483,66,18,50,17,151
2484,65,32,68,34,199
2485,65,17,68,34,184
2486,66,18,66,18,168
2487,50,18,66,18,152
2488,50,34,66,17,167
2489,52,17,66,17,152
2491,66,18,65,18,167
2492,67,16,67,33,183
2493,66,34,66,16,182
2495,51,17,66,16,150
2496,65,18,67,34,184
2497,67,49,52,16,184
2502,66,19,81,17,183
2503,68,32,66,16,182
2505,50,16,66,16,148
2508,65,33,70,30,198
2510,65,35,65,19,184
2511,82,35,63,19,199
2512,68,35,63,19,185
2514,70,30,52,17,169
2515,53,30,52,17,152
2516,65,19,66,34,184
2518,63,19,67,17,166
2519,68,33,51,33,185
2520,52,33,51,33,169
2523,67,50,65,17,199
2524,50,50,65,17,182
2525,51,33,65,17,166
2526,69,17,65,17,168
2527,67,33,83,32,215
2531,65,17,66,17,165
2532,66,34,84,34,218
2534,68,32,67,19,186
2536,66,33,53,32,184
2537,66,16,53,32,167
2538,84,34,65,32,215
2540,52,34,65,32,183
2541,69,32,65,17,183
2542,53,32,65,17,167
2543,66,33,83,33,215
2544,51,33,83,33,200
2547,65,17,67,18,167
2549,83,33,84,16,216
2550,67,33,84,16,200
2552,67,18,66,16,167
2553,50,18,66,16,150
2554,66,33,68,16,183
2555,66,16,68,16,166
2556,50,16,68,16,150
2557,66,16,66,16,164
2559,67,49,84,16,216
2560,51,49,84,16,200
2561,66,16,84,16,182
2562,66,35,65,18,184
2563,65,19,65,18,167
2564,67,32,67,16,182
2566,67,33,85,16,201
2567,68,16,85,16,185
2572,69,16,69,14,168
2573,67,33,67,33,200
2574,67,17,67,33,184
2575,51,17,67,33,168
2577,69,31,65,17,182
2578,53,31,65,17,166
2579,67,33,84,16,200
2581,64,49,51,17,181
2583,65,17,51,17,150
2584,67,35,82,16,200
2586,68,16,66,16,166
2587,52,16,66,16,150
2588,51,50,65,18,184
2590,82,16,68,32,198
2591,66,16,68,32,182
2592,65,33,67,17,182
2593,82,35,83,16,216
2594,65,35,83,16,199
2595,67,17,83,16,183
2596,51,17,83,16,167
2597,67,16,67,17,167
2600,68,31,67,17,183
2602,67,33,67,16,183
2603,67,16,67,16,166
2605,83,33,71,25,212
2606,67,33,71,25,196
2607,67,16,71,25,179
2608,67,33,63,21,184
2609,67,17,63,21,168
2611,67,45,71,16,199
2612,51,45,71,16,183
2614,63,37,83,18,201
2615,66,16,83,18,183
2617,51,19,64,18,152
2618,56,48,67,18,189
2620,83,18,66,17,184
2621,64,18,66,17,165
2624,51,34,65,18,168
2625,69,48,52,16,185
2626,66,33,52,16,167
2627,66,16,52,16,150
2629,65,18,83,33,199
2630,68,17,66,33,184
2631,51,17,66,33,167
2633,51,32,51,32,166
2634,65,18,65,17,165
2635,66,33,67,32,198
2636,65,18,67,32,182
2637,67,49,85,16,217
2638,51,49,85,16,201
2639,65,17,85,16,183
2642,51,49,51,17,168
2644,67,18,83,14,182
2645,67,33,64,19,183
2646,67,17,64,19,167
2648,51,50,65,19,185
2649,83,33,51,31,198
2650,67,33,51,31,182
2652,66,32,67,17,182
2653,67,15,67,17,166
2654,65,19,65,17,166
2655,70,48,83,17,218
2656,51,48,83,17,199
2657,65,17,83,17,182
2658,67,34,66,18,185
2660,66,33,68,32,199
2661,51,33,68,32,184
2662,67,33,67,18,185
2663,66,17,67,18,168
2664,66,18,67,33,184
2666,68,32,51,17,168
2667,68,16,51,17,152
2669,67,33,67,33,200
2670,65,18,67,33,183
2673,83,17,82,17,199
2674,68,17,82,17,184
2675,50,17,82,17,166
2676,83,49,84,33,249
2677,68,49,84,33,234
2680,66,33,68,16,183
2681,66,16,68,16,166
2682,65,18,66,17,166
2683,68,33,67,32,200
2685,67,50,65,18,200
2686,51,50,65,18,184
2687,66,17,65,18,166
2688,66,17,66,17,166
2691,66,16,84,18,184
2692,65,35,67,17,184
2693,66,17,67,17,167
2694,67,33,67,17,184
2696,68,34,50,33,185
2697,66,18,50,33,167
2698,67,17,66,17,167
2699,51,17,66,17,151
2700,67,17,83,16,183
2701,68,50,84,16,218
2702,50,50,84,16,200
2703,66,17,84,16,183
2704,67,17,67,16,167
2705,67,48,85,16,216
2706,68,32,85,16,201
2709,67,50,65,18,200
2710,51,50,65,18,184
2712,85,16,51,33,185
2713,82,17,67,17,183
2714,66,17,67,17,167
2715,51,17,67,17,152
2717,67,50,65,17,199
2718,51,50,65,17,183
2719,67,17,65,17,166
2720,68,16,66,16,166
2722,52,49,86,32,219
2724,65,33,53,32,183
2725,66,16,53,32,167
2727,50,33,52,33,168
2728,66,20,65,16,167
2730,53,32,82,19,186
2735,82,19,64,19,184
2737,68,34,64,18,184
2738,52,34,64,18,168
2739,69,49,83,16,217
2740,53,49,83,16,201
2742,69,33,66,18,186
2743,64,18,66,18,166
2744,67,32,52,16,167
2745,52,32,52,16,152
2747,68,34,64,18,184
2748,66,18,64,18,166
2750,52,33,66,32,183
2752,82,18,66,17,183
2753,64,18,66,17,165
2754,66,17,66,16,165
2755,66,49,84,16,215
2757,67,17,84,16,184
2758,66,33,67,17,183
2759,66,16,67,17,166
2760,66,34,83,17,200
2761,67,17,83,17,184
2763,67,16,67,18,168
2764,67,33,52,32,184
2766,83,17,65,19,184
2767,83,18,81,18,200
2771,67,15,68,18,168
2774,66,34,68,16,184
2775,67,16,68,16,167
2776,52,16,68,16,152
2777,67,50,50,32,199
2778,52,50,50,32,184
2779,51,33,50,32,166
2780,68,16,66,17,167
2781,66,34,66,16,182
2782,65,18,66,16,165
2783,68,49,68,17,202
2784,50,49,68,17,184
2785,66,17,68,17,168
2786,67,33,66,18,184
2787,66,16,66,18,166
2788,67,35,83,32,217
2789,50,35,83,32,200
2793,68,16,85,32,201
2794,83,48,68,17,216
2795,66,48,68,17,199
2797,66,16,68,17,167
2798,85,49,84,32,250
2799,67,49,84,32,232
2800,67,34,84,32,217
2802,68,17,83,16,184
2803,66,48,86,31,231
2804,51,48,86,31,216
2805,66,16,86,31,199
2806,84,48,67,18,217
2809,67,16,67,18,168
2810,86,48,67,17,218
2811,83,32,67,17,199
2812,67,32,67,17,183
2814,67,18,66,16,167
2815,66,49,84,17,216
2816,50,49,84,17,200
2817,52,32,84,17,185
2818,67,33,68,17,185
2821,67,18,66,16,167
2822,68,33,82,18,201
2823,84,17,65,18,184
2825,51,17,65,18,151
2827,66,17,67,16,166
2828,82,18,67,33,200
2831,51,17,83,17,168
2832,51,50,66,16,183
2833,67,18,66,16,167
2834,67,33,65,19,184
2836,67,17,67,34,185
2837,51,17,67,34,169
2838,66,32,53,16,167
2839,66,16,53,16,151
2841,67,34,66,33,200
2842,51,34,66,33,184
2843,69,32,67,33,201
2844,53,32,67,33,185
2845,50,16,67,33,166
2846,67,18,66,33,184
2847,66,33,66,16,181
2848,65,18,66,16,165
2849,67,33,65,18,183
2850,51,33,65,18,167
2851,66,49,68,16,199
2852,51,49,68,16,184
2853,66,16,68,16,166
2855,65,18,83,17,183
2856,67,34,66,17,184
2857,67,17,66,17,167
2859,52,16,67,16,151
2860,50,50,84,20,204
2862,66,33,71,28,198
2863,67,16,71,28,182
2865,67,17,65,17,166
2866,67,17,65,19,168
2867,67,48,68,34,217
2869,54,28,68,34,184
2870,65,36,66,32,199
2871,65,19,66,32,182
2873,52,17,81,17,167
2874,53,49,65,16,183
2876,66,32,84,32,214
2877,81,33,67,16,197
2878,66,33,67,16,182
2879,66,16,67,16,165
2880,65,35,84,16,200
2882,68,16,68,16,168
2883,67,49,68,16,200
2886,65,19,65,17,166
2887,68,33,82,17,200
2888,68,17,82,17,184
2890,52,49,84,33,218
2892,66,17,67,33,183
2896,84,49,82,18,233
2900,51,16,82,18,167
2901,67,49,83,16,215
2903,66,17,83,16,182
2904,82,18,66,17,183
2906,67,34,66,16,183
2907,50,34,66,16,166
2909,68,16,68,33,185
2910,66,34,67,17,184
2911,50,34,67,17,168
2912,49,17,67,17,150
2913,66,18,66,16,166
2914,68,33,83,17,201
2915,84,33,67,15,199
2917,51,33,67,15,166
2918,66,33,67,18,184
2920,66,34,83,18,201
2922,67,33,68,32,200
2923,66,18,68,32,184
2924,67,18,65,17,167
2925,68,50,83,32,233
2927,68,18,83,32,201
2928,68,32,66,17,183
2929,50,32,66,17,165
2930,66,34,66,16,182
2931,66,18,66,16,166
2932,66,17,65,18,166
2933,68,49,66,18,201
2934,51,49,66,18,184
2935,67,17,66,18,168
2936,66,34,83,17,200
2938,68,32,68,17,185
2941,68,17,67,16,168
2942,67,16,67,17,167
2943,67,34,66,34,201
2944,51,34,66,34,185
2946,67,16,67,17,167
2947,67,33,83,16,199
2948,67,16,83,16,182
2949,66,34,65,17,182
2952,50,34,83,31,198
2955,65,17,66,17,165
2957,83,31,68,17,199
2958,68,31,68,17,184
2959,52,31,68,17,168
2960,66,34,67,16,183
2961,66,17,67,16,166
2962,65,34,66,16,181
2963,67,17,66,16,166
2964,68,33,84,17,202
2965,51,33,84,17,185
2966,67,33,68,17,185
2968,66,34,51,33,184
2969,65,18,51,33,167
2972,68,17,81,18,184
2974,51,33,82,17,183
2975,67,48,86,33,234
2976,82,16,86,33,217
2977,81,34,52,33,200
2978,66,34,52,33,185
2980,65,34,66,18,183
2981,67,17,66,18,168
2982,51,17,66,18,152
2983,68,33,82,16,199
2984,52,33,82,16,183
2985,68,33,83,33,217
2987,66,49,67,16,198
2989,65,17,67,16,165
2990,67,34,84,32,217
2991,65,18,84,32,199
2994,67,33,66,17,183
2995,67,17,66,17,167
2996,66,18,65,16,165
2997,68,48,67,18,201
2998,67,32,67,18,184
3000,66,33,52,33,184
3001,65,16,52,33,166
3003,68,33,67,31,199
3006,52,33,65,17,167
3007,66,34,81,18,199
3009,67,48,51,17,183
3010,52,48,51,17,168
3011,65,17,51,17,150
3012,66,33,84,18,201
3014,66,18,84,33,201
3015,68,49,68,17,202
3016,51,49,68,17,185
3019,84,33,66,17,200
3020,67,33,66,17,183
3022,68,17,66,16,167
3023,51,17,66,16,150
3024,66,17,66,18,167
3026,66,33,67,17,183
3027,66,16,67,17,166
3028,66,35,65,17,183
3029,66,18,65,17,166
3031,67,49,84,17,217
3032,67,33,84,17,201
3033,67,16,84,17,184
3035,66,16,68,15,165
3036,66,35,83,17,201
3037,66,18,83,17,184
3038,84,17,67,32,200
3040,68,33,66,16,183
3041,66,18,66,16,166
3043,67,49,103,16,235
3044,67,32,103,16,218
3045,52,32,103,16,203
3047,65,17,70,16,168
3048,65,46,74,17,202
3050,79,8,83,17,187
3051,87,16,68,17,188
3052,70,16,68,17,171
3053,69,34,51,16,170
3054,74,34,67,17,192
3056,67,17,67,17,168
3058,50,33,68,16,167
3061,67,34,82,17,200
3062,67,17,82,17,183
3063,51,17,82,17,167
3064,51,32,83,18,184
3065,50,16,83,18,167
3066,65,18,67,16,166
3068,66,17,66,20,169
3071,67,32,67,17,183
3072,67,16,67,17,167
3073,66,34,82,18,200
3074,70,14,82,18,184
3075,52,14,82,18,166
3076,67,16,67,17,167
3078,64,16,51,16,147
3079,50,16,51,16,133
3082,67,16,83,16,182
3083,51,16,83,16,166
3084,51,33,66,17,167
3085,66,33,84,17,200
3086,66,16,84,17,183
3088,67,16,68,16,167
3089,66,34,67,17,184
3090,66,17,67,17,167
3093,68,33,68,16,185
3094,51,33,68,16,168
3095,67,33,51,16,167
3097,50,16,51,16,133
3098,67,18,83,16,184
3099,68,32,67,16,183
3100,67,16,67,16,166
3101,51,16,67,16,150
3103,83,16,81,19,199
3104,83,33,67,17,200
3105,67,33,67,17,184
3106,66,17,67,17,167
3107,50,17,67,17,151
3108,84,32,67,17,200
3109,68,32,67,17,184
3110,65,19,67,17,168
3111,67,33,68,16,184
3112,68,16,68,16,168
3113,81,18,83,17,199
3114,68,18,83,17,186
3116,50,34,66,17,167
3117,68,33,66,17,184
3118,52,33,66,17,168
3119,67,33,82,18,200
3121,66,33,67,17,183
3122,50,33,67,17,167
3123,66,32,52,17,167
3125,65,35,83,17,200
3126,83,34,66,17,200
3127,67,34,66,17,184
3128,50,34,66,17,167
3129,52,17,66,17,152
3130,52,31,52,17,152
3132,66,17,67,16,166
3133,66,34,65,16,181
3134,51,34,65,16,166
3136,51,33,82,16,182
3138,66,16,66,18,166
3139,65,34,84,15,198
3140,66,18,84,15,183
3142,66,16,67,17,166
3146,68,15,52,16,151
3147,67,34,67,15,183
3149,63,34,82,18,197
3150,67,16,82,18,183
3151,52,16,82,18,168
3152,51,33,67,17,168
3153,67,32,52,15,166
3155,82,18,66,17,183
3157,67,32,51,17,167
3158,52,32,51,17,152
3159,52,15,51,17,135
3161,66,34,66,17,183
3164,66,16,51,17,150
3165,83,17,67,18,185
3167,66,34,68,16,184
3168,50,34,68,16,168
3169,51,17,68,16,152
3170,51,33,83,16,183
3172,68,17,64,17,166
3175,68,31,70,13,182
3176,65,16,70,13,164
3177,64,34,66,17,181
3178,65,17,66,17,165
3180,66,20,80,17,183
3182,53,30,67,18,168
3183,66,34,51,17,168
3184,67,17,51,17,152
3185,64,33,68,17,182
3187,67,35,65,18,185
3188,50,35,65,18,168
3189,51,17,65,18,151
3192,67,15,67,18,167
3193,65,33,52,16,166
3196,82,34,66,17,199
3199,52,16,66,17,151
3201,68,32,50,16,166
3202,65,17,50,16,148
3203,66,33,67,16,182
3204,68,16,67,16,167
3206,67,16,68,16,167
3207,50,16,68,16,150
3208,67,16,67,16,166
3211,68,33,82,19,202
3212,66,17,82,19,184
3214,51,33,68,14,166
3216,66,18,83,16,183
3217,82,19,65,17,183
3218,66,19,65,17,167
3219,68,32,66,18,184
3220,52,32,66,18,168
3221,83,16,68,16,183
3222,68,16,68,16,168
3224,51,33,51,16,151
3225,66,35,83,16,200
3226,67,17,83,16,183
3227,68,32,67,17,184
3228,51,32,67,17,167
3229,51,16,67,17,151
3231,83,16,67,17,183
3232,67,16,67,17,167
3233,67,33,66,17,183
3234,67,16,66,17,166
3235,66,34,66,18,184
3236,65,18,66,18,167
3238,67,15,52,17,151
3239,51,15,52,17,135
3241,66,35,66,16,183
3242,67,17,66,16,166
3243,52,17,66,16,151
3244,52,33,81,19,185
3245,68,33,67,16,184
3247,66,32,51,17,166
3249,81,19,82,17,199
3250,65,19,82,17,183
3252,51,33,66,17,167
3256,83,34,66,17,200
3258,66,17,66,17,166
3259,68,34,83,16,201
3262,67,16,67,17,167
3263,66,33,51,16,166
3265,65,34,66,17,182
3267,67,33,84,16,200
3269,51,16,84,16,167
3270,66,16,67,17,166
3271,66,35,81,19,201
3272,66,18,81,19,184
3273,68,32,68,17,185
3274,67,16,68,17,168
3275,67,33,52,16,168
3277,65,35,65,18,183
3278,84,33,83,16,216
3279,68,33,83,16,200
3280,51,33,83,16,183
3281,52,16,83,16,167
3282,52,32,67,17,168
3283,65,33,67,19,184
3284,66,15,67,19,167
3286,67,16,52,13,148
3287,67,33,66,17,183
3288,66,16,66,17,165
3289,67,32,51,17,167
3290,68,13,51,17,149
3291,52,13,51,17,133
3293,66,34,67,16,183
3294,64,17,67,16,164
3295,51,17,67,16,151
3296,65,16,67,17,165
3297,67,34,50,16,167
3298,68,16,50,16,150
3299,67,33,68,16,184
3300,66,17,68,16,167
3301,67,33,51,17,168
3304,68,17,82,16,183
3306,67,17,65,17,166
3307,51,17,65,17,150
3309,82,16,67,18,183
3310,66,16,67,18,167
3311,65,33,68,16,182
3312,65,16,68,16,165
3314,67,16,84,16,183
3315,51,16,84,16,167
3316,68,16,66,17,167
3317,52,16,66,17,151
3318,66,17,67,16,166
3319,67,33,68,16,184
3321,66,34,66,16,182
3322,50,34,66,16,166
3324,66,18,83,16,183
3326,51,32,67,16,166
3327,66,34,66,18,184
3328,66,18,66,18,168
3330,67,16,51,15,149
3331,51,16,51,15,133
3332,51,33,84,16,184
3333,66,33,67,17,183
3334,67,15,67,17,166
3335,51,15,67,17,150
3336,50,35,65,17,167
3342,66,18,66,18,168
3343,84,16,52,15,167
3344,67,16,52,15,150
3345,67,34,84,16,201
3346,50,34,84,16,184
3348,68,15,67,17,167
3349,52,15,67,17,151
3350,65,18,67,16,166
3352,66,16,66,18,166
3353,51,16,66,18,151
3354,51,34,83,20,188
3355,67,32,71,12,182
3356,66,16,71,12,165
3357,66,35,82,16,199
3358,67,17,82,16,182
3360,67,20,62,17,166
3362,53,31,64,18,166
3364,66,16,51,16,149
3366,50,33,68,16,167
3367,64,34,84,16,198
3368,67,16,84,16,183
3369,51,16,84,16,167
3370,84,33,50,16,183
3371,68,33,50,16,167
3372,66,17,50,16,149
3373,84,16,66,17,183
3374,66,16,66,17,165
3376,67,16,84,17,184
3377,50,16,84,17,167
3378,82,34,83,18,217
3379,66,34,83,18,201
3381,67,34,67,16,184
3383,68,33,67,16,184
3384,67,17,67,16,167
3385,67,34,87,13,201
3386,84,33,67,17,201
3387,67,33,67,17,184
3388,51,33,67,17,168
3393,54,13,84,16,167
3396,62,17,68,16,163
3397,84,16,83,17,200
3398,67,16,83,17,183
3399,68,34,66,17,185
3400,68,17,66,17,168
3401,68,32,51,15,166
3402,66,16,51,15,148
3403,50,16,51,15,132
3404,66,17,66,18,167
3406,67,15,52,16,150
3407,51,15,52,16,134
3408,83,34,66,17,200
3409,66,34,66,17,183
3410,67,16,66,17,166
3411,52,16,66,17,151
3413,66,34,68,16,184
3415,66,33,51,17,167
3417,51,16,51,17,135
3419,68,33,67,15,183
3420,67,17,67,15,166
3421,51,17,67,15,150
3422,51,33,66,16,166
3423,66,34,81,19,200
3424,67,17,81,19,184
3425,67,32,68,16,183
3427,66,33,68,16,183
3428,65,17,68,16,166
3430,66,19,66,17,168
3431,68,33,83,17,201
3432,52,33,83,17,185
3434,68,17,67,17,169
3435,66,34,67,16,183
3436,67,17,67,16,167
3438,67,17,67,15,166
3439,67,34,81,18,200
3441,50,17,81,18,166
3442,67,17,66,17,167
3443,50,17,66,17,150
3444,65,17,84,16,182
3445,65,34,66,17,182
3447,66,34,65,17,182
3448,68,17,65,17,167
3450,68,16,66,18,168
3451,66,33,51,14,164
3452,66,16,51,14,147
3453,65,33,84,17,199
3454,66,16,84,17,183
3455,66,32,69,16,183
3456,67,14,69,16,166
3458,66,18,67,16,167
3459,68,33,66,17,184
3460,66,17,66,17,166
3461,69,34,83,15,201
3462,51,34,83,15,183
3463,67,32,66,18,183
3464,67,16,66,18,167
3465,66,35,66,16,183
3466,67,18,66,16,167
3467,67,31,85,16,199
3468,67,15,85,16,183
3469,66,35,66,17,184
3470,67,17,66,17,167
3473,67,34,83,17,201
3474,67,16,83,17,183
3475,66,33,67,18,184
3477,67,33,52,16,168
3478,66,16,52,16,150
3479,66,34,65,19,184
3480,66,17,65,19,167
3484,51,31,69,20,171
3485,65,36,53,13,167
3489,66,33,68,17,184
3490,50,33,68,17,168
3491,53,13,68,17,151
3492,84,33,66,16,199
3493,68,33,66,16,183
3494,65,16,66,16,163
3495,52,16,66,16,150
3496,51,32,67,18,168
3498,82,33,67,17,199
3500,65,17,67,17,166
3502,67,15,67,17,166
3505,67,33,50,18,168
3506,66,16,50,18,150
3508,65,17,83,16,181
3509,67,34,65,18,184
3510,66,18,65,18,167
3511,50,18,65,18,151
3513,66,33,69,16,184
3515,65,35,83,15,198
3520,67,16,66,17,166
3524,66,16,68,16,166
3527,51,16,68,16,151
3529,68,33,50,16,167
3530,67,17,50,16,150
3532,66,18,66,16,166
3533,67,32,66,17,182
3534,51,32,66,17,166
3537,66,32,51,16,165
3538,66,16,51,16,149
3541,67,32,68,17,184
3542,51,32,68,17,168
3543,51,16,68,17,152
3545,83,17,65,17,182
3546,67,17,65,17,166
3547,68,33,83,16,200
3550,66,16,67,18,167
3551,65,33,52,15,165
3553,83,16,67,17,183
3554,67,16,67,17,167
3555,67,33,67,17,184
3556,68,15,67,17,167
3557,52,15,67,17,151
3558,83,33,68,15,199
3559,67,33,68,15,183
3560,66,16,68,15,165
3561,51,16,68,15,150
3563,83,18,82,17,200
3564,84,33,66,16,199
3565,68,33,66,16,183
3566,51,33,66,16,166
3567,68,33,66,16,183
3568,51,33,66,16,166
3569,66,33,84,16,199
3570,67,17,84,16,184
3571,66,33,67,16,182
3572,66,17,67,16,166
3573,66,33,85,16,200
3574,66,17,85,16,184
3575,84,16,67,16,183
3576,68,16,67,16,167
3577,67,33,67,18,185
3578,67,17,67,18,169
3579,67,34,67,15,183
3582,51,33,84,16,184
3583,67,34,66,16,183
3584,67,16,66,16,165
3586,51,34,81,17,183
3587,68,32,66,17,183
3588,66,16,66,17,165
3589,66,34,66,18,184
3590,51,34,66,18,169
3594,67,17,67,16,167
3595,66,34,84,16,200
3596,69,16,84,16,185
3597,52,16,84,16,168
3598,66,18,67,16,167
3599,67,33,68,16,184
3600,65,17,68,16,166
3601,84,16,83,17,200
3602,69,16,83,17,185
3603,67,34,66,16,183
3607,66,34,66,16,182
3608,67,17,66,16,166
3609,66,33,68,15,182
3610,50,33,68,15,166
3612,67,16,67,16,166
3613,66,35,83,15,199
3615,68,32,66,18,184
3619,64,34,56,12,166
3620,68,15,56,12,151
3621,66,33,67,17,183
3622,68,15,67,17,167
3624,71,12,82,17,182
3625,56,12,82,17,167
3627,67,34,82,19,202
3629,82,17,68,16,183
3630,67,17,68,16,168
3632,66,18,67,16,167
3633,67,34,65,16,182
3635,68,33,82,18,201
3636,52,33,82,18,185
3637,67,32,68,17,184
3638,52,32,68,17,169
3640,65,18,51,16,150
3641,66,34,65,17,182
3643,68,33,65,18,184
3644,52,33,65,18,168
3645,51,16,65,18,150
3647,65,33,85,16,199
3649,65,34,67,17,183
3650,67,16,67,17,167
3651,51,16,67,17,151
3652,67,17,81,19,184
3655,67,34,65,18,184
3657,67,33,83,16,199
3658,83,32,67,17,199
3660,66,16,67,17,166
3661,65,35,82,17,199
3663,67,32,67,17,183
3664,67,16,67,17,167
3665,67,33,51,17,168
3666,66,16,51,17,150
3667,65,34,66,18,183
3668,66,17,66,18,167
3669,67,34,83,16,200
3670,67,17,83,16,183
3671,51,17,83,16,167
3672,51,32,67,17,167
3676,66,16,67,17,166
3678,66,18,66,17,167
3679,67,32,68,16,183
3680,67,16,68,16,167
3681,67,34,82,18,201
3682,50,34,82,18,184
3683,66,34,66,17,183
3684,67,17,66,17,167
3686,51,32,51,15,149
3688,65,18,66,17,166
3689,66,32,51,17,166
3690,67,15,51,17,150
3691,51,15,51,17,134
3692,84,34,51,15,184
3693,66,34,51,15,166
3696,51,34,82,17,184
3701,67,32,51,17,167
3702,82,33,84,17,216
3703,67,33,84,17,201
3704,66,17,84,17,184
3705,65,35,66,15,181
3707,51,17,66,15,149
3708,52,32,68,15,167
3713,68,32,83,16,199
3714,66,17,83,16,182
3715,66,33,66,17,182
3716,67,17,66,17,167
3717,65,35,65,18,183
3718,66,19,65,18,168
3722,67,17,68,14,166
3723,65,34,83,16,198
3724,68,16,83,16,183
3726,51,34,65,17,167
3727,68,33,83,16,200
3729,83,16,67,16,182
3731,65,33,68,17,183
3733,65,34,84,16,199
3735,67,34,66,16,183
3737,68,34,82,17,201
3739,68,32,67,17,184
3740,68,16,67,17,168
3742,65,17,51,17,150
3743,82,17,84,16,199
3744,83,34,66,17,200
3745,67,34,66,17,184
3746,51,34,66,17,168
3749,66,34,67,17,184
3752,50,33,51,16,150
3756,67,16,83,17,183
3758,66,17,67,16,166
3759,66,34,84,16,200
3760,67,16,84,16,183
3761,67,33,67,17,184
3762,67,17,67,17,168
3763,67,34,67,16,184
3764,65,18,67,16,166
3765,67,33,66,17,183
3766,68,16,66,17,167
3767,67,34,83,15,199
3768,51,34,83,15,183
3769,67,32,66,17,182
3773,67,31,67,19,184
3774,67,15,67,19,168
3778,82,34,83,17,216
3780,69,15,83,17,184
3782,83,35,66,15,199
3783,67,35,66,15,183
3784,64,19,66,15,164
3786,65,17,66,18,166
3788,68,17,50,15,150
3789,66,32,83,18,199
3790,66,17,83,18,184
3792,67,15,68,16,166
3793,50,15,68,16,149
3794,67,17,85,16,185
3795,67,34,67,17,185
3796,65,18,67,17,167
3798,51,36,64,16,167
3799,70,31,66,16,183
3800,69,16,66,16,167
3801,67,33,84,16,200
3802,68,16,84,16,184
3803,64,33,67,16,180
3804,65,17,67,16,165
3805,66,33,50,17,166
3806,65,17,50,17,149
3807,84,16,66,18,184
3808,68,16,66,18,168
3809,67,33,51,17,168
3810,67,17,51,17,152
3812,82,35,65,18,200
3813,66,35,65,18,184
3814,68,17,65,18,168
3815,51,17,65,18,151
3816,52,34,82,16,184
3817,51,18,82,16,167
3821,65,33,85,16,199
3822,68,16,85,16,185
3823,67,33,68,15,183
3825,66,33,84,16,199
3827,66,35,65,22,188
3828,68,16,65,22,171
3830,51,33,54,13,151
3832,65,16,67,17,165
3833,65,35,83,16,199
3834,50,35,83,16,184
3836,51,32,67,17,167
3837,67,33,51,17,168
3838,62,16,51,17,146
3839,83,16,67,16,182
3841,67,34,65,20,186
3843,51,17,65,20,153
3844,50,33,66,17,166
3846,66,16,69,16,167
3847,65,34,51,16,166
3849,52,14,51,16,133
3853,51,16,66,17,150
3854,67,18,82,16,183
3855,67,31,67,18,183
3856,66,16,67,18,167
3857,66,34,51,15,166
3859,82,16,68,15,181
3860,67,16,68,15,166
3861,67,33,67,18,185
3865,68,32,83,17,200
3867,67,33,67,17,184
3868,50,33,67,17,167
3869,50,15,67,17,149
3870,68,18,81,18,185
3871,69,31,68,16,184
3873,67,33,67,17,184
3875,81,18,84,16,199
3876,67,18,84,16,185
3877,68,32,68,16,184
3879,67,35,82,16,200
3880,67,18,82,16,183
3881,67,33,65,17,182
3882,68,16,65,17,166
3884,51,34,66,16,167
3885,67,31,67,18,183
3887,65,35,66,18,184
3888,66,18,66,18,168
3889,66,32,68,16,182
3890,51,32,68,16,167
3891,67,34,83,22,206
3892,50,34,83,22,189
3894,50,34,71,17,172
3895,52,16,71,17,156
3897,69,36,82,18,205
3898,65,22,82,18,187
3899,71,34,66,17,188
3900,55,34,66,17,172
3901,53,17,66,17,153
3902,56,32,68,16,172
3903,66,34,50,17,167
3904,65,18,50,17,150
3905,66,34,82,21,203
3907,68,33,70,14,185
3911,67,36,63,16,182
3912,66,21,63,16,166
3913,70,29,66,16,181
3914,53,29,66,16,164
3915,65,34,67,16,182
3916,84,32,51,17,184
3918,65,16,51,17,149
3919,66,35,67,17,185
3921,67,33,83,17,200
3924,52,34,66,17,169
3925,67,33,67,16,183
3927,83,17,83,18,201
3928,65,17,83,18,183
3929,66,34,67,17,184
3930,49,34,67,17,167
3931,67,31,53,15,166
3932,51,31,53,15,150
3933,83,18,81,17,199
3934,66,18,81,17,182
3935,67,32,66,17,182
3936,51,32,66,17,166
3937,53,15,66,17,151
3939,81,17,84,18,200
3940,81,35,67,17,200
3941,66,35,67,17,185
3942,50,35,67,17,169
3943,67,33,51,16,167
3945,84,18,65,17,184
3946,67,18,65,17,167
3947,67,33,68,15,183
3949,51,16,68,15,150
3950,51,32,51,16,150
3951,65,36,82,16,199
3952,65,19,82,16,182
3953,68,31,67,16,182
3955,51,16,67,16,150
3956,50,34,67,17,168
3957,82,16,68,16,182
3959,67,34,66,16,183
3961,67,34,65,17,183
3962,67,17,65,17,166
3963,51,17,65,17,150
3964,52,32,83,16,183
3965,66,33,66,19,184
3966,65,17,66,19,167
3967,65,34,51,16,166
3969,67,32,67,18,184
3972,68,16,50,17,151
3974,67,16,67,16,166
3976,66,17,82,16,181
3977,50,17,82,16,165
3978,51,32,66,17,166
3979,67,33,68,16,184
3980,65,17,68,16,166
3981,82,16,68,17,183
3982,65,16,68,17,166
3984,50,35,81,19,185
3986,67,17,67,17,168
3987,51,17,67,17,152
3990,65,19,67,15,166
3991,67,34,64,18,183
3994,53,33,83,16,185
3995,67,31,68,16,182
3997,64,35,83,17,199
3999,83,16,67,16,182
4000,68,16,67,16,167
4001,68,34,66,16,184
4002,66,18,66,16,166
4003,67,33,68,16,184
4004,66,17,68,16,167
4005,50,17,68,16,151
4006,51,33,84,15,183
4008,66,19,64,17,166
4009,68,32,83,16,199
4010,52,32,83,16,183
4011,67,32,67,17,183
4013,64,35,66,16,181
4015,67,32,68,17,184
4020,66,18,66,17,167
4021,68,32,51,17,168
4022,51,32,51,17,151
4024,66,18,68,15,167
4026,66,17,66,16,165
4027,51,17,66,16,150
4029,68,32,68,15,183
4031,66,33,82,18,199
4032,52,33,82,18,185
4033,65,35,65,16,181
4035,68,33,65,18,184
4036,52,33,65,18,168
4038,66,18,84,17,185
4040,66,17,68,17,168
4041,65,33,52,16,166
4042,69,15,52,16,152
4043,51,15,52,16,134
4045,68,33,66,16,183
4046,67,16,66,16,165
4047,52,16,66,16,150
4048,84,32,67,17,200
4049,67,32,67,17,183
4050,66,16,67,17,166
4051,66,33,51,20,170
4052,50,33,51,20,154
4053,65,34,84,16,199
4054,65,18,84,16,183
4055,67,37,63,17,184
4056,51,37,63,17,168
4058,55,28,52,17,152
4060,67,16,84,15,182
4061,63,34,65,17,179
4062,51,34,65,17,167
4063,52,17,65,17,151
4064,50,32,84,16,182
4065,84,15,67,17,183
4066,67,15,67,17,166
4068,67,17,66,18,168
4071,67,33,68,17,185
4072,67,16,68,17,168
4076,66,18,82,18,184
4077,50,18,82,18,168
4079,51,17,66,15,149
4081,66,34,51,15,166
4083,66,32,67,21,186
4085,66,34,54,13,167
4086,69,15,54,13,151
4087,51,15,54,13,133
4089,67,34,67,17,185
4093,68,33,65,18,184
4095,67,32,68,17,184
4096,67,15,68,17,167
4097,82,16,84,19,201
4099,65,35,68,14,182
4100,66,17,68,14,165
4101,68,33,66,18,185
4103,68,35,66,15,184
4104,66,19,66,15,166
4105,68,31,83,18,200
4106,51,31,83,18,183
4107,66,35,66,17,184
4108,68,17,66,17,168
4109,66,32,51,15,164
4110,52,32,51,15,150
4111,83,18,66,17,184
4112,65,18,66,17,166
4113,66,32,51,17,166
4115,51,15,51,17,134
4116,84,34,66,16,200
4117,66,34,66,16,182
4118,66,17,66,16,165
4120,82,34,68,17,201
4122,67,16,68,17,168
4123,66,33,52,16,167
4124,50,33,52,16,151
4126,84,33,66,16,199
4127,68,33,66,16,183
4128,52,33,66,16,167
4129,52,16,66,16,150
4130,51,33,82,18,184
4131,66,33,67,18,184
4132,65,17,67,18,167
4133,66,33,52,16,167
4134,66,17,52,16,151
4135,82,18,84,16,200
4136,84,34,66,17,201
4137,67,34,66,17,184
4138,51,34,66,17,168
4141,65,35,83,16,199
4143,66,34,65,17,182
4145,52,17,65,17,151
4147,66,33,84,17,200
4148,82,33,68,16,199
4149,65,33,68,16,182
4150,66,16,68,16,166
4151,66,33,51,19,169
4154,67,17,66,16,166
4155,68,35,64,18,185
4157,51,19,64,18,152
4159,66,33,83,17,199
4160,66,17,83,17,183
4162,67,15,67,17,166
4163,51,15,67,17,150
4164,50,35,82,18,185
4165,68,32,68,17,185
4166,65,17,68,17,167
4167,67,33,68,17,185
4168,67,16,68,17,168
4169,65,35,83,16,199
4170,85,33,66,17,201
4171,68,33,66,17,184
4174,51,32,69,15,167
4175,65,34,67,16,182
4177,66,35,65,17,183
4179,69,32,66,19,186
4180,66,17,66,19,168
4181,67,33,52,16,168
4183,65,33,67,16,181
4184,67,16,67,16,166
4185,66,35,66,16,183
4187,52,16,66,16,150
4190,64,18,51,16,149
4191,66,34,83,15,198
4192,66,18,83,15,182
4194,69,16,65,17,167
4195,51,16,65,17,149
4196,51,33,83,17,184
4197,83,15,68,18,184
4199,65,35,51,14,165
4200,65,18,51,14,148
4203,68,32,68,17,185
4204,51,32,68,17,168
4205,51,14,68,17,150
4206,83,34,67,17,201
4208,82,33,51,17,183
4209,68,33,51,17,169
4210,51,33,51,17,152
4211,67,34,65,18,184
4213,67,34,66,16,183
4214,67,17,66,16,166
4215,51,17,66,16,150
4217,65,35,84,16,200
4218,66,17,84,16,183
4219,66,32,68,17,183
4221,51,16,68,17,152
4222,66,16,52,15,149
4223,84,16,67,16,183
4225,68,32,68,17,185
4226,51,32,68,17,168
4227,52,15,68,17,152
4228,83,33,67,16,199
4229,67,33,67,16,183
4230,50,33,67,16,166
4231,51,17,67,16,151
4232,68,15,68,17,168
4236,50,33,82,17,182
4237,68,32,67,17,184
4239,65,35,82,18,200
4240,66,18,82,18,184
4243,67,33,52,16,168
4244,50,33,52,16,151
4245,82,18,82,17,199
4246,85,33,66,17,201
4247,68,33,66,17,184
4249,52,16,66,17,151
4250,51,33,83,16,183
4251,66,33,66,17,182
4252,82,33,50,16,181
4253,66,33,50,16,165
4254,67,16,50,16,149
4255,66,33,52,17,168
4256,67,16,52,17,152
4257,66,33,67,16,182
4259,50,16,67,16,149
4260,68,17,66,16,167
4262,52,31,51,17,151
4265,66,33,65,18,182
4267,51,17,65,18,151
4268,52,34,81,19,186
4269,67,31,69,17,184
4270,66,16,69,17,168
4271,65,35,51,16,167
4272,66,17,51,16,150
4274,66,19,81,19,185
4276,51,33,67,14,165
4278,52,33,67,16,168
4280,83,33,65,19,200
4281,67,33,65,19,184
4283,67,33,51,16,167
4284,52,33,51,16,152
4286,67,17,68,17,169
4287,65,35,66,17,183
4288,68,16,66,17,167
4289,51,16,66,17,150
4290,52,33,82,16,183
4293,66,33,51,17,167
4295,82,16,69,16,183
4296,65,16,69,16,166
4297,65,36,65,19,185
4298,67,17,65,19,168
4300,52,33,67,17,169
4301,52,17,67,17,153
4303,65,35,66,16,182
4308,66,16,67,15,164
4309,66,32,69,17,184
4311,65,35,51,14,165
4312,83,34,84,16,217
4315,69,31,69,16,185
4316,67,14,69,16,166
4317,51,14,69,16,150
4318,69,15,67,16,167
4320,67,16,66,16,165
4321,53,16,66,16,151
4323,51,16,89,14,170
4324,64,18,69,15,166
4326,66,16,52,18,152
4327,50,16,52,18,136
4328,73,14,81,19,187
4329,69,33,67,16,185
4331,52,18,67,16,153
4332,63,17,66,16,162
4336,67,16,66,17,166
4337,66,33,50,17,166
4338,51,33,50,17,151
4339,65,33,69,16,183
4340,66,16,69,16,167
4342,67,17,51,17,152
4343,50,17,51,17,135
4345,69,33,67,15,184
4347,51,17,67,15,150
4348,51,32,66,19,168
4349,65,35,83,22,205
4350,65,19,83,22,189
4351,67,31,74,29,201
4354,69,15,69,15,168
4357,52,22,65,13,152
4358,55,29,83,16,183
4360,51,36,63,14,164
4361,65,31,81,17,194
4362,58,31,81,17,187
4363,67,32,66,17,182
4364,68,16,66,17,167
4365,63,33,66,17,179
4366,64,19,66,17,166
4367,65,33,71,13,182
4368,82,33,51,17,183
4370,52,33,51,17,153
4371,66,38,63,16,183
4374,54,30,66,16,166
4376,51,33,65,19,168
4379,66,32,67,16,181
4380,65,16,67,16,164
4381,65,34,83,17,199
4382,68,15,83,17,183
4383,51,15,83,17,166
4385,67,34,68,16,185
4386,64,18,68,16,166
4387,67,33,51,15,166
4389,67,35,82,16,200
4390,51,35,82,16,184
4391,68,31,67,18,184
4392,52,31,67,18,168
4394,50,33,68,17,168
4397,51,16,51,17,135
4398,67,16,66,18,167
4400,67,17,81,18,183
4401,51,17,81,18,167
4404,67,16,84,15,182
4405,66,33,66,18,183
4406,65,18,66,18,167
4407,67,34,63,20,184
4408,66,17,63,20,166
4411,51,15,67,19,152
4412,67,13,55,14,149
4413,63,36,68,14,181
4414,66,16,68,14,164
4415,51,16,68,14,149
4417,55,14,83,17,169
4419,68,32,66,17,183
4420,63,18,66,17,164
4421,67,33,84,18,202
4422,65,17,84,18,184
4424,68,16,69,16,169
4425,66,33,86,15,200
4427,66,36,65,18,185
4428,67,18,65,18,168
4429,69,33,67,15,184
4430,52,33,67,15,167
4431,69,32,68,17,186
4432,68,15,68,17,168
4434,67,17,83,16,183
4435,67,33,66,18,184
4437,68,34,50,14,166
4438,67,17,50,14,148
4439,50,17,50,14,131
4442,67,14,52,15,148
4443,50,14,52,15,131
4444,82,33,84,16,215
4445,66,33,84,16,199
4446,66,15,84,16,181
4448,82,34,83,16,215
4449,67,34,83,16,200
4450,66,17,83,16,182
4451,51,17,83,16,167
4452,65,16,67,16,164
4453,66,33,50,19,168
4454,66,16,50,19,151
4455,65,34,84,17,200
4457,67,35,66,16,184
4458,66,19,66,16,167
4460,66,18,84,16,184
4461,68,33,67,16,184
4465,65,35,83,16,199
4467,51,16,83,16,166
4468,67,17,66,17,167
4469,68,32,51,16,167
4470,65,16,51,16,148
4471,65,34,69,15,183
4472,67,16,69,15,167
4473,66,33,51,17,167
4474,50,33,51,17,151
4475,51,16,51,17,135
4477,69,32,83,17,201
4480,65,16,68,16,165
4481,64,35,81,18,198
4482,65,19,81,18,183
4483,83,17,66,18,184
4484,67,17,66,18,168
4485,68,32,52,15,167
4486,52,32,52,15,151
4487,65,34,83,18,200
4488,65,18,83,18,184
4489,66,33,68,16,183
4490,68,15,68,16,167
4491,52,15,68,16,151
4492,67,18,50,17,152
4493,67,34,82,16,199
4495,68,33,65,19,185
4497,50,17,65,19,151
4498,51,33,51,15,150
4499,66,32,84,16,198
4500,82,34,66,16,198
4501,65,34,66,16,181
4502,67,15,66,16,164
4503,51,15,66,16,148
4504,50,33,68,17,168
4505,67,33,52,17,169
4506,65,16,52,17,150
4507,66,35,65,18,184
4508,50,35,65,18,168
4509,68,34,81,19,202
4510,51,34,81,19,185
4512,53,31,69,16,169
4513,65,34,51,16,166
4517,50,19,83,17,169
4518,67,16,68,16,167
4520,68,15,52,18,153
4521,64,36,64,19,183
4522,67,17,64,19,167
4523,51,17,64,19,151
4524,51,34,82,16,183
4525,52,18,82,16,168
4526,51,30,52,16,149
4527,64,36,65,16,181
4528,67,17,65,16,165
4530,67,16,69,16,168
4533,65,36,64,16,181
4536,53,32,82,17,184
4538,52,32,67,16,167
4540,64,18,67,15,164
4542,65,17,83,17,182
4543,50,17,83,17,167
4545,67,32,52,17,168
4546,66,17,52,17,152
4547,66,34,83,16,199
4548,84,35,64,17,200
4549,66,35,64,17,182
4550,51,35,64,17,167
4551,52,17,64,17,150
4552,52,32,67,15,166
4553,67,32,68,16,183
4554,81,35,84,16,216
4555,64,35,84,16,199
4556,50,35,84,16,185
4557,67,33,67,15,182
4559,68,32,68,15,183
4560,51,32,68,15,166
4561,65,35,67,15,182
4562,69,16,67,15,167
4565,68,34,66,15,183
4566,64,19,66,15,164
4567,67,31,84,16,198
4568,67,16,84,16,183
4569,65,35,65,18,183
4571,66,33,67,17,183
4572,51,33,67,17,168
4573,68,32,52,14,166
4574,67,16,52,14,149
4575,65,35,82,17,199
4576,68,17,82,17,184
4577,67,31,68,18,184
4578,51,31,68,18,168
4581,65,34,68,15,182
4582,65,17,68,15,165
4583,68,33,69,15,185
4584,67,15,69,15,166
4585,52,15,69,15,151
4587,68,34,81,17,200
4588,50,34,81,17,182
4589,69,34,64,17,184
4590,66,19,64,17,166
4591,68,31,84,17,200
4593,65,33,51,17,166
4594,66,17,51,17,151
4595,64,34,67,16,181
4596,66,17,67,16,166
4597,67,34,82,21,204
4599,51,17,82,21,171
4601,67,32,55,13,167
4603,82,21,79,18,200
4605,70,30,67,15,182
4606,54,30,67,15,166
4607,55,13,67,15,150
4608,51,32,85,16,184
4609,62,35,66,16,179
4610,80,32,84,16,212
4611,67,32,84,16,199
4612,52,32,84,16,184
4613,85,16,66,17,184
4614,68,16,66,17,167
4615,66,33,67,16,182
4616,51,33,67,16,167
4621,67,32,85,16,200
4623,66,35,66,17,184
4624,68,16,66,17,167
4625,51,16,66,17,150
4628,66,16,67,17,166
4629,66,33,83,16,198
4630,51,33,83,16,183
4631,51,16,83,16,166
4632,65,18,65,17,165
4633,67,33,84,15,199
4634,67,16,84,15,182
4635,51,16,84,15,166
4636,67,16,67,18,168
4638,65,17,51,17,150
4641,67,35,65,17,184
4642,68,17,65,17,167
4644,50,32,85,16,183
4645,67,33,68,16,184
4646,66,16,68,16,166
4647,65,34,67,16,182
4648,63,17,67,16,163
4649,85,16,66,16,183
4650,68,16,66,16,166
4652,51,33,66,17,167
4653,67,33,50,16,166
4654,65,17,50,16,148
4656,66,17,68,16,167
4657,66,33,51,16,166
4658,50,33,51,16,150
4659,50,16,51,16,133
4660,69,16,67,15,167
4662,51,32,69,16,168
4663,51,16,69,16,152
4664,83,34,65,16,198
4666,66,19,65,16,166
4667,69,32,83,25,209
4668,51,32,83,25,191
4669,50,16,83,25,174
4670,68,16,75,26,185
4671,65,34,67,16,182
4673,67,41,74,18,200
4674,91,26,66,16,199
4675,75,26,66,16,183
4676,59,26,66,16,167
4677,67,32,68,19,186
4678,51,32,68,19,170
4679,74,18,53,13,158
4680,65,18,53,13,149
4682,50,34,65,18,167
4683,68,32,68,15,183
4684,71,13,68,15,167
4686,68,15,84,18,185
4687,65,35,67,16,183
4688,64,17,67,16,164
4689,51,17,67,16,151
4690,65,17,68,15,165
4691,67,35,67,15,184
4692,66,18,67,15,166
4694,52,33,49,17,151
4695,68,34,81,18,201
4696,66,19,81,18,184
4697,67,32,67,16,182
4698,51,32,67,16,166
4701,65,34,67,16,182
4702,66,18,67,16,167
4703,67,33,50,16,166
4704,66,17,50,16,149
4705,83,18,83,16,200
4708,51,32,67,16,166
4710,85,32,66,18,201
4711,83,16,66,18,183
4714,66,17,51,17,151
4716,65,17,67,16,165
4718,68,17,65,16,166
4719,51,17,65,16,149
4721,67,33,51,16,167
4723,65,34,66,16,181
4724,65,18,66,16,165
4725,67,33,68,16,184
4726,51,33,68,16,168
4727,51,16,68,16,151
4728,51,33,51,17,152
4729,66,35,83,16,200
4731,68,33,66,16,183
4732,67,17,66,16,166
4733,51,17,66,16,150
4735,66,33,67,16,182
4737,66,33,68,14,181
4741,67,34,65,18,184
4742,67,18,65,18,168
4743,68,32,83,18,201
4745,66,33,68,17,184
4750,67,18,82,16,183
4753,51,16,65,19,151
4754,51,33,51,16,151
4759,51,16,67,15,149
4760,51,34,66,20,171
4761,51,18,66,20,155
4762,66,17,53,14,150
4763,67,33,84,15,199
4766,70,14,65,17,166
4768,52,32,50,16,150
4770,64,15,68,16,163
4771,65,33,51,16,165
4772,49,33,51,16,149
4773,50,16,51,16,133
4774,83,32,68,16,199
4775,68,32,68,16,184
4776,51,32,68,16,167
4777,51,16,68,16,151
4778,84,33,67,17,201
4779,67,33,67,17,184
4780,67,17,67,17,168
4783,84,16,83,16,199
4784,84,33,66,17,200
4785,67,33,66,17,183
4787,52,16,66,17,151
4788,81,34,67,16,198
4789,83,16,67,16,182
4791,66,33,66,18,183
4792,50,33,66,18,167
4793,67,34,67,17,185
4794,65,18,67,17,167
4795,67,32,52,17,168
4796,66,16,52,17,151
4797,66,35,67,16,184
4799,67,34,83,16,200
4804,66,15,52,15,148
4805,49,15,52,15,131
4806,84,32,68,16,200
4808,67,15,68,16,166
4810,83,33,66,18,200
4811,67,33,66,18,184
4814,67,18,67,16,168
4815,83,16,85,15,199
4816,67,16,85,15,183
4818,50,35,65,16,166
4820,51,32,83,18,184
4821,67,33,68,14,182
4823,65,33,68,15,181
4825,66,35,65,17,183
4826,65,18,65,17,165
4827,68,33,82,18,201
4828,52,33,82,18,185
4829,68,32,68,16,184
4831,65,34,83,18,200
4833,82,18,67,17,184
4834,67,18,67,17,169
4835,68,33,66,17,184
4836,51,33,66,17,167
4837,83,18,83,16,200
4838,67,18,83,16,184
4840,51,32,67,17,167
4841,51,15,67,17,150
4842,67,17,83,16,183
4845,67,34,66,16,183
4847,67,32,68,15,182
4849,66,34,84,17,201
4850,66,17,84,17,184
4853,68,32,83,18,201
4855,84,17,66,17,184
4856,68,17,66,17,168
4857,67,32,51,16,166
4859,67,34,66,17,184
4861,66,33,84,16,199
4862,50,33,84,16,183
4864,51,33,67,17,168
4867,84,16,67,17,184
4868,66,16,67,17,166
4870,67,17,66,16,166
4871,84,16,82,18,200
4872,67,16,82,18,183
4873,67,33,67,17,184
4874,50,33,67,17,167
4877,82,18,66,18,184
4881,85,15,51,16,167
4882,69,15,51,16,151
4883,51,15,51,16,133
4884,67,15,67,18,167
4885,52,15,67,18,152
4887,51,16,51,17,135
4888,82,35,65,18,200
4889,67,35,65,18,185
4890,67,17,65,18,167
4892,52,31,52,17,152
4893,66,34,84,17,201
4894,66,16,84,17,183
4895,65,35,66,16,182
4896,68,17,66,16,167
4898,51,31,84,17,183
4899,84,17,66,17,184
4900,66,17,66,17,166
4902,51,33,66,18,168
4903,84,17,68,16,185
4904,83,33,84,16,216
4906,50,33,84,16,183
4907,66,35,65,17,183
4909,68,32,83,18,201
4911,67,33,68,15,183
4912,66,16,68,15,165
4913,65,34,67,16,182
4914,66,17,67,16,166
4915,83,18,83,15,199
4917,68,33,65,17,183
4918,51,33,65,17,166
4919,67,33,82,19,201
4920,67,17,82,19,185
4921,66,32,69,16,183
4922,68,15,69,16,168
4923,65,34,68,16,183
4924,66,17,68,16,167
4925,66,35,66,16,183
4927,69,33,64,19,185
4930,68,17,50,16,151
4931,66,31,69,16,182
4932,66,15,69,16,166
4933,64,35,67,16,182
4934,67,16,67,16,166
4935,50,16,67,16,149
4937,69,33,50,17,169
4939,67,34,82,18,201
4940,67,18,82,18,185
4942,67,17,67,16,167
4943,50,17,67,16,150
4945,82,18,65,18,183
4946,66,18,65,18,167
4949,51,17,66,18,152
4951,65,34,83,17,199
4952,67,16,83,17,183
4954,67,16,66,16,165
4955,52,16,66,16,150
4956,66,16,68,17,167
4957,66,34,51,16,167
4958,65,17,51,16,149
4960,66,18,83,19,186
4962,68,16,69,13,166
4964,51,32,84,18,185
4965,83,19,65,15,182
4966,66,19,65,15,165
4967,69,31,67,17,184
4968,52,31,67,17,167
4969,68,34,65,18,185
4970,66,18,65,18,167
4972,52,33,82,18,185
4973,67,32,68,16,183
4974,51,32,68,16,167
4976,68,16,84,16,184
4977,66,34,66,17,183
4978,65,18,66,17,166
4980,66,16,51,16,149
4981,66,34,83,16,199
4982,84,33,66,17,200
4985,51,16,66,17,150
4987,66,33,68,17,184
4988,66,16,68,17,167
4989,66,34,68,15,183
4992,66,18,67,16,167
4996,52,33,67,20,172
4997,67,33,54,14,168
4998,50,33,54,14,151
4999,66,34,67,16,183
5000,67,18,67,16,168
5001,67,34,65,16,182
5002,51,34,65,16,166
5004,52,33,83,15,183
5006,63,16,66,17,162
5007,65,33,84,17,199
5010,67,15,68,17,167
5011,66,34,67,17,184
5013,84,17,66,16,183
5014,66,17,66,16,165
5018,67,16,66,17,166
5019,50,16,66,17,149
5020,65,17,83,18,183
5021,66,33,68,17,184
5022,67,15,68,17,167
5024,50,34,66,18,168
5025,67,34,83,16,200
5026,83,32,67,17,199
5027,68,32,67,17,184
5029,66,34,67,16,183
5032,66,16,66,21,169
5034,66,17,53,14,150
5035,67,32,67,17,183
5036,66,16,67,17,166
5038,70,14,82,18,184
5039,53,14,82,18,167
5040,51,32,50,18,151
5041,67,34,83,17,201
5042,63,17,83,17,180
5043,66,34,66,16,182
5044,66,18,66,16,166
5045,50,18,66,16,150
5048,84,34,83,16,217
5049,66,34,83,16,199
5050,65,18,83,16,182
5053,51,16,66,16,149
5054,67,18,65,19,169
5055,83,16,52,14,165
5056,66,16,52,14,148
5060,68,14,52,16,150
5061,52,14,52,16,134
5062,84,34,82,18,218
5064,66,16,82,18,182
5065,52,16,82,18,168
5066,50,33,67,16,166
5067,67,33,66,15,181
5068,66,16,66,15,163
5070,84,32,68,17,201
5073,66,35,83,17,201
5076,68,16,67,17,168
5077,68,33,67,16,184
5078,53,33,67,16,169
5079,66,34,66,16,182
5082,50,33,83,16,182
5083,67,33,66,18,184
5084,50,33,66,18,167
5085,66,33,51,16,166
5086,65,17,51,16,149
5087,66,33,68,16,183
5088,67,16,68,16,167
5095,66,35,66,16,183
5096,68,17,66,16,167
5098,51,32,67,16,166
5099,67,34,66,33,200
5102,50,33,66,20,169
5103,67,33,53,17,170
5104,65,17,53,17,152
5105,66,33,70,15,184
5108,70,17,84,16,187
5109,53,17,84,16,170
5110,70,33,67,16,186
5112,50,33,67,16,166
5114,84,33,82,19,218
5115,67,33,82,19,201
5116,52,33,82,19,186
5119,66,32,68,18,184
5120,51,32,68,18,169
5121,65,36,66,17,184
5122,66,19,66,17,168
5123,68,32,67,16,183
5124,52,32,67,16,167
5125,51,17,67,16,151
5126,51,34,82,16,183
5127,66,33,65,17,181
5128,51,33,65,17,166
5129,67,33,83,17,200
5131,82,16,68,17,183
5132,65,16,68,17,166
5137,68,33,66,19,186
5138,51,33,66,19,169
5139,66,33,52,16,167
5140,67,16,52,16,151
5141,84,15,68,17,184
5144,68,16,66,18,168
5145,52,16,66,18,152
5146,83,33,51,16,183
5148,66,16,51,16,149
5149,66,33,85,15,199
5150,68,15,85,15,183
5151,51,15,85,15,166
5152,67,16,66,17,166
5153,51,16,66,17,150
5154,65,17,66,19,167
5157,66,33,68,15,182
5158,67,16,68,15,166
5159,66,33,68,17,184
5160,67,14,68,17,166
5161,52,14,68,17,151
5162,66,18,82,18,184
5163,68,33,67,17,185
5164,64,18,67,17,166
5165,68,34,66,17,185
5167,82,18,67,15,182
5168,67,18,67,15,167
5169,67,33,66,16,182
5172,68,17,83,15,183
5176,65,17,50,18,150
5177,65,33,68,16,182
5178,68,15,68,16,167
5179,66,35,70,31,202
5181,50,18,70,31,169
5182,50,33,68,15,166
5183,68,37,80,16,201
5184,67,21,80,16,184
5185,70,31,65,17,183
5187,68,31,67,16,182
5188,52,31,67,16,166
5190,67,16,67,16,166
5191,65,33,84,17,199
5192,67,16,84,17,184
5193,51,16,84,17,168
5196,66,16,52,17,151
5197,84,17,83,17,201
5198,68,17,83,17,185
5199,67,34,66,15,182
5201,52,17,66,15,150
5202,51,33,67,15,166
5203,67,33,66,18,184
5205,66,34,66,17,183
5206,64,19,66,17,166
5207,67,32,51,16,166
5208,66,17,51,16,150
5209,49,17,51,16,133
5210,69,16,67,16,168
5211,66,33,67,16,182
5212,68,16,67,16,167
5215,67,33,66,20,186
5218,67,17,66,17,167
5219,66,33,66,18,183
5220,67,16,66,18,167
5221,50,16,66,18,150
5222,70,13,68,16,167
5223,53,13,68,16,150
5224,66,16,67,19,168
5225,66,35,83,17,201
5227,51,17,83,17,168
5230,68,14,67,16,165
5232,67,17,67,16,167
5233,51,17,67,16,151
5237,67,32,68,16,183
5239,67,33,85,16,201
5240,68,16,85,16,185
5241,65,35,66,17,183
5242,67,17,66,17,167
5244,51,32,51,15,149
5245,67,34,67,16,184
5246,67,16,67,16,166
5247,66,32,67,16,181
5248,50,32,67,16,165
5249,51,15,67,16,149
5251,67,32,68,16,183
5252,66,16,68,16,166
5253,51,16,68,16,151
5254,50,34,67,14,165
5256,66,18,66,16,166
5257,68,33,84,15,200
5258,52,33,84,15,184
5259,67,33,66,17,183
5260,65,19,66,17,167
5261,66,34,83,16,199
5262,66,18,83,16,183
5263,67,32,67,16,182
5266,50,33,50,18,151
5267,83,16,67,16,182
5268,82,34,83,17,216
5269,67,34,83,17,201
5271,50,18,83,17,168
5272,50,33,67,16,166
5273,67,32,83,19,201
5274,51,32,83,19,185
5275,83,17,67,16,183
5279,68,34,83,16,201
5280,84,32,67,17,200
5281,67,32,67,17,183
5285,67,32,68,16,183
5286,67,16,68,16,167
5287,67,33,51,17,168
5288,51,33,51,17,152
5289,81,19,65,17,182
5291,68,33,81,17,199
5292,51,33,81,17,182
5293,51,17,81,17,166
5295,65,33,85,15,198
5297,65,33,67,17,182
5298,65,17,67,17,166
5299,66,35,65,17,183
5302,69,15,84,18,186
5303,67,33,69,16,185
5304,67,16,69,16,168
5305,65,34,51,15,165
5306,65,17,51,15,148
5307,50,17,51,15,133
5308,67,18,83,16,184
5314,83,34,83,17,217
5315,68,34,83,17,202
5316,66,17,83,17,183
5317,67,33,67,16,183
5318,66,17,67,16,166
5319,50,17,67,16,150
5321,65,35,65,18,183
5322,67,17,65,18,167
5323,67,33,83,16,199
5324,66,17,83,16,182
5325,51,17,83,16,167
5327,65,34,82,18,199
5329,50,16,82,18,166
5331,67,34,51,15,167
5332,65,18,51,15,149
5333,67,33,66,18,184
5334,65,18,66,18,167
5338,68,16,68,15,167
5339,66,35,82,16,199
5340,66,17,82,16,181
5342,51,33,65,17,166
5343,52,16,65,17,150
5345,82,16,52,17,167
5346,81,34,66,18,199
5347,65,34,66,18,183
5349,67,35,83,17,202
5350,68,17,83,17,185
5351,52,17,83,17,169
5353,66,34,68,16,184
5354,66,16,68,16,166
5355,65,35,66,16,182
5356,67,17,66,16,166
5357,52,17,66,16,151
5358,67,17,84,16,184
5359,68,33,67,16,184
5360,66,17,67,16,166
5361,66,32,51,18,167
5362,66,16,51,18,151
5363,84,16,65,17,182
5365,67,34,66,16,183
5367,51,18,66,16,151
5368,81,35,66,17,199
5369,65,35,66,17,183
5370,66,18,66,17,167
5371,66,32,85,15,198
5373,85,16,66,17,184
5374,68,16,66,17,167
5375,66,31,52,17,166
5376,50,31,52,17,150
5378,67,15,66,18,166
5380,66,17,83,16,182
5381,52,17,83,16,168
5383,66,35,65,17,183
5384,67,17,65,17,166
5385,50,17,65,17,149
5387,67,33,52,17,169
5388,66,16,52,17,151
5390,66,16,85,16,183
5391,66,36,65,16,183
5394,52,32,84,17,185
5395,68,33,68,16,185
5397,65,33,51,16,165
5399,66,35,65,17,183
5401,68,32,83,16,199
5403,51,16,83,16,166
5406,66,17,51,16,150
5407,50,17,51,16,134
5408,66,16,69,15,166
5409,66,35,67,15,183
5412,51,34,66,17,168
5413,69,33,82,18,202
5414,65,18,82,18,183
5415,67,33,67,17,184
5416,51,33,67,17,168
5417,66,33,82,19,200
5418,51,33,82,19,185
5421,67,33,67,16,183
5422,50,33,67,16,166
5423,67,34,83,16,200
5424,66,19,83,16,184
5427,67,32,85,16,200
5428,52,32,85,16,185
5429,83,16,67,16,182
5432,67,16,67,16,166
5433,85,16,66,16,183
5434,67,16,66,16,165
5435,51,16,66,16,149
5437,67,33,68,16,184
5438,65,17,68,16,166
5439,66,34,82,18,200
5440,66,18,82,18,184
5441,83,18,66,16,183
5443,68,32,67,16,183
5444,52,32,67,16,167
5446,84,33,67,16,200
5447,66,33,67,16,182
5448,66,17,67,16,166
5449,67,33,84,16,200
5450,51,33,84,16,184
5451,66,34,66,16,182
5452,68,16,66,16,166
5453,67,31,51,17,166
5454,51,31,51,17,150
5455,84,16,83,18,201
5456,82,33,68,17,200
5457,66,33,68,17,184
5458,66,17,68,17,168
5459,51,17,68,17,153
5460,83,34,84,16,217
5461,67,34,84,16,201
5462,67,18,84,16,185
5463,68,32,68,17,185
5464,51,32,68,17,168
5465,51,15,68,17,151
5466,67,16,52,17,152
5468,67,16,83,17,183
5469,68,34,66,17,185
5470,51,34,66,17,168
5471,52,17,66,17,152
5472,82,34,66,17,199
5475,66,34,65,17,182
5476,51,34,65,17,167
5477,68,32,84,17,201
5478,67,16,84,17,184
5479,66,33,68,16,183
5480,66,16,68,16,166
5482,66,17,84,16,183
5483,67,34,66,17,184
5484,67,17,66,17,167
5485,68,32,74,31,205
5487,66,34,71,30,201
5489,66,40,61,19,186
5490,67,23,61,19,170
5491,74,31,81,16,202
5492,68,19,81,16,184
5493,71,30,67,15,183
5494,54,30,67,15,166
5495,61,34,68,15,178
5497,81,16,67,18,182
5498,67,16,67,18,168
5500,63,20,67,31,181
5502,51,32,66,17,166
5503,67,35,82,17,201
5504,52,35,82,17,186
5505,67,31,68,17,183
5506,52,31,68,17,168
5507,66,35,66,18,185
5508,65,18,66,18,167
5511,68,33,69,16,186
5512,51,33,69,16,169
5513,66,34,51,32,183
5514,68,16,51,32,167
5518,67,48,67,17,199
5519,51,48,67,17,183
5520,67,16,67,17,167
5522,83,32,51,33,199
5523,67,32,51,33,183
5524,51,32,51,33,167
5526,67,16,51,16,150
5531,51,16,51,33,151
5533,51,33,67,32,183
5534,67,50,70,16,203
5535,51,50,70,16,187
5536,66,17,70,16,169
5537,67,49,70,18,204
5538,50,49,70,18,187
5539,85,4,84,16,189
5540,66,4,84,16,170
5541,70,16,67,17,170
5543,70,34,67,16,187
5544,66,34,67,16,183
5547,67,17,65,18,167
5548,83,18,67,16,184
5551,66,16,51,16,149
5553,68,17,83,16,184
5555,67,16,67,17,167
5556,51,16,67,17,151
5557,66,18,66,16,166
5558,67,32,84,16,199
5559,67,16,84,16,183
5560,67,34,66,17,184
5561,67,17,66,17,167
5562,66,34,85,12,197
5563,66,18,85,12,181
5564,68,32,65,18,183
5567,50,34,66,16,166
5568,85,12,69,16,182
5570,65,35,50,16,166
5572,66,34,83,16,199
5573,63,18,83,16,180
5575,51,32,67,17,167
5576,50,16,67,17,150
5579,67,16,67,18,168
5580,67,34,51,15,167
5581,66,17,51,15,149
5582,49,17,51,15,132
5583,66,17,67,16,166
5584,67,33,68,16,184
5592,50,16,68,16,150
5594,65,35,83,17,200
5595,67,17,83,17,184
5596,51,17,83,17,168
5598,51,16,68,17,152
5599,66,16,52,16,150
5600,65,35,67,16,183
5601,67,17,67,16,167
5602,68,33,83,16,200
5603,51,33,83,16,183
5604,52,16,83,16,167
5605,50,34,65,16,165
5609,67,16,68,15,166
5610,65,35,66,16,182
5611,65,19,66,16,166
5613,67,17,66,16,166
5614,51,17,66,16,150
5615,52,33,67,16,168
5616,66,33,50,17,166
5617,50,33,50,17,150
5618,66,34,82,18,200
5619,67,18,82,18,185
5620,67,33,67,15,182
5621,67,17,67,15,166
5622,50,17,67,15,149
5623,51,33,66,16,166
5625,84,32,68,17,201
5626,67,32,68,17,184
5627,50,32,68,17,167
5628,66,34,82,19,201
5629,50,34,82,19,185
5630,66,34,67,16,183
5631,67,18,67,16,168
5632,68,33,65,18,184
5633,52,33,65,18,168
5634,67,34,81,18,200
5635,66,19,81,18,184
5637,50,31,68,16,165
5638,65,34,84,16,199
5639,68,16,84,16,184
5640,81,18,66,17,182
5641,65,18,66,17,166
5642,68,34,66,16,184
5643,50,34,66,16,166
5644,84,16,67,18,185
5645,68,16,67,18,169
5646,66,34,67,17,184
5647,50,34,67,17,168
5648,66,33,67,16,182
5650,67,34,83,17,201
5651,68,16,83,17,184
5652,51,16,83,17,167
5653,51,33,67,16,167
5654,51,16,67,16,150
5655,65,17,50,16,148
5656,66,34,82,19,201
5659,51,32,69,16,168
5661,83,35,83,16,217
5663,66,19,83,16,184
5664,69,33,50,16,168
5666,51,17,50,16,134
5667,52,33,66,18,169
5668,83,16,51,16,166
5669,67,16,51,16,150
5671,50,33,66,18,167
5673,67,16,82,18,183
5674,51,16,82,18,167
5675,50,32,68,17,167
5677,66,17,65,17,165
5678,67,33,66,16,182
5679,66,18,66,16,166
5680,68,32,50,18,168
5682,65,34,67,17,183
5684,66,34,66,17,183
5686,50,18,66,17,151
5687,68,16,67,16,167
5689,51,33,67,17,168
5690,50,16,67,17,150
5691,66,17,82,18,183
5692,67,33,67,16,183
5693,66,17,67,16,166
5695,67,17,82,18,184
5697,66,18,67,16,167
5698,67,33,67,16,183
5700,66,34,67,15,182
5701,67,18,67,15,167
5702,67,33,83,16,199
5703,51,33,83,16,183
5706,67,31,68,16,182
5707,51,31,68,16,166
5708,83,16,66,18,183
5710,65,34,67,16,182
5711,66,18,67,16,167
5712,68,32,51,17,168
5715,68,17,82,18,185
5716,67,33,67,15,182
5717,67,17,67,15,166
5718,51,17,67,15,150
5721,66,18,66,17,167
5723,65,18,66,16,165
5724,50,18,66,16,150
5726,66,33,66,17,182
5727,51,33,66,17,167
5728,66,33,50,17,166
5730,84,15,66,18,183
5731,67,15,66,18,166
5733,67,17,68,16,168
5734,50,17,68,16,151
5736,66,36,66,16,184
5737,67,18,66,16,167
5739,66,17,82,18,183
5741,51,33,67,15,166
5742,66,33,66,16,181
5743,66,17,66,16,165
5744,66,34,67,17,184
5745,65,18,67,17,167
5747,51,32,52,15,150
5748,66,35,83,17,201
5749,66,19,83,17,185
5750,67,32,68,17,184
5751,52,32,68,17,169
5752,52,15,68,17,152
5753,51,35,66,16,168
5754,67,33,66,16,182
5755,66,17,66,16,165
5758,66,33,67,15,181
5759,66,17,67,15,165
5760,66,34,66,16,182
5761,65,18,66,16,165
5762,67,33,84,15,199
5763,66,18,84,15,183
5765,51,33,66,17,167
5766,66,33,66,17,182
5767,67,17,66,17,167
5769,69,15,85,16,185
5770,66,33,68,16,183
5771,67,16,68,16,167
5772,66,33,51,17,167
5773,65,16,51,17,149
5774,66,35,66,16,183
5775,68,16,66,16,166
5776,68,33,66,16,183
5777,51,33,66,16,166
5778,51,17,66,16,150
5779,65,17,84,16,182
5781,66,17,67,17,167
5782,66,33,84,18,201
5783,66,17,84,18,185
5784,84,16,68,15,183
5785,68,16,68,15,167
5786,67,33,68,16,184
5788,84,18,66,16,184
5789,66,18,66,16,166
5790,68,33,83,16,200
5791,51,33,83,16,183
5793,51,33,66,17,167
5794,66,32,51,16,165
5795,51,32,51,16,150
5796,65,34,68,14,181
5797,67,16,68,14,165
5798,66,33,67,16,182
5799,67,16,67,16,166
5803,65,18,67,16,166
5804,67,33,86,14,200
5805,66,17,86,14,183
5806,81,18,66,17,182
5807,67,18,66,17,168
5809,51,32,51,17,151
5813,50,34,66,17,167
5814,51,17,66,17,151
5815,81,33,66,17,197
5816,67,33,66,17,183
5817,83,33,67,16,199
5819,66,16,67,16,165
5820,66,33,67,18,184
5821,67,16,67,18,168
5825,66,17,84,16,183
5826,67,34,66,17,184
5827,68,16,66,17,167
5828,67,34,65,18,184
5832,66,33,67,16,182
5833,66,16,67,16,165
5834,65,35,83,16,199
5835,67,17,83,16,183
5836,51,17,83,16,167
5838,67,33,51,17,168
5840,65,34,66,17,182
5841,66,16,66,17,165
5842,67,34,67,16,184
5844,51,17,67,16,151
5847,66,18,82,16,182
5848,67,33,65,18,183
5849,50,33,65,18,166
5850,51,17,65,18,151
5852,66,32,69,16,183
5853,66,16,69,16,167
5854,65,35,83,17,200
5855,67,17,83,17,184
5856,67,34,66,17,184
5857,51,34,66,17,168
5859,67,16,68,16,167
5860,66,34,66,17,183
5862,66,34,65,17,182
5863,67,17,65,17,166
5864,68,32,67,16,183
5865,67,16,67,16,166
5866,66,33,84,16,199
5867,66,16,84,16,182
5868,65,34,66,17,182
5869,66,17,66,17,166
5870,67,33,84,17,201
5871,50,33,84,17,184
5872,67,33,68,16,184
5873,67,16,68,16,167
5874,66,33,51,17,167
5875,67,16,51,17,151
5876,66,35,66,16,183
5877,84,33,82,16,215
5880,51,17,82,16,166
5881,83,33,68,16,200
5882,66,33,68,16,183
5884,66,32,52,16,166
5885,65,16,52,16,149
5887,66,19,66,16,167
5888,68,32,67,16,183
5890,52,16,67,16,151
5892,66,33,66,17,182
5895,51,34,66,18,169
5896,84,15,68,17,184
5897,68,15,68,17,168
5898,66,34,67,15,182
5899,67,17,67,15,166
5900,66,34,83,16,199
5901,67,16,83,16,182
5902,52,16,83,16,167
5903,51,33,66,16,166
5904,51,16,66,16,149
5906,83,16,67,17,183
5908,66,35,66,16,183
5909,51,35,66,16,168
5910,84,16,67,17,184
5911,67,16,67,17,167
5915,66,17,83,16,182
5916,67,33,66,16,182
5917,67,16,66,16,165
5918,66,34,65,17,182
5919,66,18,65,17,166
5920,83,16,84,16,199
5921,82,33,67,17,199
5922,66,33,67,17,183
5923,66,17,67,17,167
5924,65,33,85,17,200
5925,66,16,85,17,184
5927,68,16,68,17,169
5928,67,33,52,16,168
5930,67,35,66,17,185
5931,67,17,66,17,167
5932,68,33,83,16,200
5934,52,16,83,16,167
5935,67,16,66,16,165
5937,66,16,84,16,182
5939,66,16,67,18,167
5941,65,19,50,16,150
5942,84,16,68,16,184
5943,67,16,68,16,167
5944,67,34,84,16,201
5945,51,34,84,16,185
5946,50,16,84,16,166
5947,50,34,66,16,166
5948,68,32,84,16,200
5949,66,16,84,16,182
5950,66,34,66,16,182
5951,67,16,66,16,165
5953,66,16,50,17,149
5954,66,34,83,18,201
5955,82,33,68,16,199
5956,66,33,68,16,183
5958,50,17,68,16,151
5960,83,18,66,17,184
5962,68,33,66,16,183
5963,52,33,66,16,167
5965,67,17,99,21,204
5966,66,33,87,16,202
5967,67,16,87,16,186
5970,99,37,67,16,219
5971,82,37,67,16,202
5972,66,37,67,16,186
5973,71,16,67,16,170
5974,52,16,67,16,151
5975,53,19,66,16,154
5977,51,32,84,15,182
5978,67,34,65,18,184
5979,51,34,65,18,168
5980,66,33,84,16,199
5981,66,17,84,16,183
5982,84,15,68,18,185
5983,68,15,68,18,169
5984,65,34,52,16,167
5988,52,16,67,16,151
5990,52,16,66,16,150
5991,67,16,83,16,182
5992,67,33,82,21,203
5995,65,18,69,16,168
5998,82,21,79,17,199
