序号,发送->接收,接收->转发,转发->接收,接收->处理,总计
1,70,36,65,17,188
2,66,17,65,17,165
3,69,31,67,18,185
5,67,34,67,16,184
6,65,17,67,16,165
7,65,33,68,17,183
9,67,34,51,16,168
11,51,16,51,16,134
12,66,18,66,16,166
13,50,18,66,16,150
14,67,16,66,17,166
15,51,16,66,17,150
16,68,16,68,15,167
17,66,33,67,30,196
18,82,35,62,12,191
19,66,35,62,12,175
22,67,17,58,17,159
23,50,17,58,17,142
24,80,28,66,17,191
25,62,28,66,17,173
26,59,16,66,17,158
27,58,34,66,16,174
30,66,34,69,14,183
33,67,17,50,16,150
34,67,36,80,17,200
35,66,20,80,17,183
37,53,30,67,17,167
39,67,16,68,15,166
40,80,17,69,16,182
43,67,17,66,18,168
44,68,35,65,16,184
45,66,20,65,16,167
46,69,31,50,17,167
47,52,31,50,17,150
49,69,16,67,15,167
51,65,17,67,17,166
52,50,17,67,17,151
53,67,16,68,16,167
54,51,16,68,16,151
56,67,35,65,17,184
58,68,32,50,17,167
60,51,16,50,17,134
61,66,17,66,16,165
62,65,34,68,14,181
63,66,17,68,14,165
64,50,17,68,14,149
65,51,32,68,15,166
67,85,32,65,18,200
68,68,32,65,18,183
69,52,32,65,18,167
70,68,32,67,18,185
71,67,17,67,18,169
72,64,33,67,17,181
73,67,16,67,17,167
75,68,16,66,17,167
76,67,33,68,17,185
77,68,15,68,17,168
79,66,16,68,17,167
81,65,18,65,18,166
82,68,33,67,15,183
83,68,16,67,15,166
84,52,16,67,15,150
88,67,32,51,16,166
89,65,17,51,16,149
90,67,33,68,16,184
92,65,34,67,17,183
93,68,16,67,17,168
94,51,16,67,17,151
96,68,33,66,16,183
97,66,17,66,16,165
98,67,32,67,16,182
100,50,15,67,16,148
101,66,17,67,18,168
102,66,33,70,14,183
103,65,17,70,14,166
104,67,34,68,17,186
105,66,18,68,17,169
106,67,36,63,18,184
108,70,32,65,17,184
109,68,18,65,17,168
111,67,14,67,16,164
112,63,34,67,16,180
113,67,16,67,16,166
114,65,33,66,17,181
115,65,16,66,17,164
116,67,34,65,19,185
117,65,18,65,19,167
118,67,32,69,15,183
120,66,33,68,17,184
122,65,36,65,19,185
124,52,17,65,19,153
125,52,32,65,20,169
126,51,17,65,20,153
128,65,32,71,14,182
129,69,13,71,14,167
130,65,36,65,19,185
131,68,16,65,19,168
132,68,35,63,19,185
134,71,30,69,18,188
135,65,16,69,18,168
136,65,33,54,32,184
138,63,36,66,14,179
140,52,17,66,14,149
142,54,32,66,18,170
143,67,16,68,15,166
144,66,34,64,17,181
146,50,20,64,17,151
148,68,30,67,18,183
149,54,30,67,18,169
151,65,17,68,17,167
152,64,33,52,18,167
153,66,16,52,18,152
154,67,35,66,20,188
157,68,18,51,13,150
158,52,18,51,13,134
159,52,31,69,17,169
160,66,33,68,15,182
161,69,13,68,15,165
162,51,13,68,15,147
163,50,36,67,29,182
164,69,32,82,16,199
165,66,15,82,16,179
166,68,35,63,18,184
168,67,29,69,15,180
169,79,34,66,19,198
170,64,34,66,19,183
171,67,16,66,19,168
172,63,35,50,16,164
173,52,35,50,16,153
174,69,50,89,10,218
175,66,35,89,10,200
177,67,16,73,10,166
178,50,16,73,10,149
180,69,39,53,10,171
181,89,28,66,17,200
182,73,28,66,17,184
183,68,18,66,17,169
184,67,35,64,16,182
185,76,10,64,16,166
188,66,33,67,16,182
189,58,16,67,16,157
192,66,34,67,16,183
193,66,17,67,16,166
195,67,17,66,17,167
196,67,34,67,16,184
197,66,18,67,16,167
198,67,32,67,17,183
199,67,16,67,17,167
200,66,35,65,17,183
203,67,16,67,16,166
204,67,33,68,16,184
205,67,16,68,16,167
206,65,34,66,16,181
207,66,17,66,16,165
208,67,34,65,18,184
209,66,18,65,18,167
210,68,32,68,16,184
212,66,33,68,17,184
213,66,17,68,17,168
215,67,17,67,16,167
216,68,33,66,16,183
217,68,17,66,16,167
218,68,34,66,16,184
220,67,32,67,16,182
221,67,16,67,16,166
225,66,17,67,16,166
226,67,33,67,16,183
228,66,34,67,17,184
229,67,17,67,17,168
230,67,33,67,16,183
231,67,17,67,16,167
232,50,17,67,16,150
233,66,18,67,15,166
234,67,33,64,19,183
236,67,34,68,14,183
237,67,18,68,14,167
238,67,49,66,18,200
239,65,34,66,18,183
240,64,19,66,18,167
242,68,31,67,16,182
243,67,17,67,16,167
245,66,18,66,17,167
246,65,33,66,16,180
248,52,15,66,16,149
249,51,33,67,17,168
250,66,33,66,17,182
252,66,34,65,19,184
253,66,18,65,19,168
258,65,35,65,17,182
259,67,16,65,17,165
260,68,34,64,18,184
261,51,34,64,18,167
262,52,17,64,18,151
265,65,16,69,16,166
266,64,34,67,18,183
267,67,16,67,18,168
268,51,16,67,18,152
269,67,18,65,19,169
270,51,18,65,19,153
271,67,16,71,12,166
272,67,33,50,16,166
274,65,38,80,17,200
275,68,19,80,17,184
276,71,28,69,16,184
277,65,16,69,16,166
279,81,35,67,15,198
281,68,17,67,15,167
283,66,17,68,16,167
284,51,17,68,16,152
287,66,19,65,17,167
288,68,32,66,17,183
289,67,16,66,17,166
290,66,33,50,16,165
292,65,33,84,16,198
293,66,16,84,16,182
294,66,33,67,17,183
297,66,17,67,16,166
298,67,33,66,18,184
299,67,16,66,18,167
300,67,34,67,16,184
301,67,17,67,16,167
302,67,32,69,15,183
304,66,35,66,17,184
307,67,18,66,16,167
309,66,17,67,16,166
311,67,17,66,17,167
312,66,33,66,16,181
313,67,17,66,16,166
314,67,33,66,18,184
315,66,17,66,18,167
316,66,33,51,16,166
317,67,16,51,16,150
318,66,33,68,15,182
319,66,17,68,15,166
321,67,16,67,17,167
322,51,16,67,17,151
324,68,33,66,17,184
325,65,18,66,17,166
327,67,17,65,19,168
329,68,16,52,15,151
330,66,33,67,16,182
332,65,34,66,18,183
334,52,15,66,18,151
335,66,17,67,18,168
336,67,33,68,15,183
337,64,17,68,15,164
338,66,34,67,17,184
339,68,16,67,17,168
341,69,16,65,17,167
342,52,16,65,17,150
343,65,18,67,17,167
345,66,15,52,16,149
346,65,35,83,16,199
347,67,18,83,16,184
348,67,33,66,18,184
350,52,16,66,18,152
351,51,34,66,18,169
353,66,16,67,16,165
354,66,34,66,16,182
355,68,16,66,16,166
356,66,33,66,16,181
357,68,15,66,16,165
360,66,33,67,16,182
361,64,17,67,16,164
362,66,34,66,17,183
365,66,18,66,18,168
367,51,33,51,16,151
369,68,16,69,15,168
370,66,34,67,16,183
371,68,16,67,16,167
373,68,17,66,17,168
375,66,17,66,17,166
377,65,18,65,18,166
378,66,32,67,18,183
379,68,15,67,18,168
380,66,33,68,17,184
381,67,16,68,17,168
384,67,34,67,17,185
386,52,16,67,17,152
389,67,16,66,17,166
390,67,32,68,16,183
391,67,15,68,16,166
392,52,15,68,16,151
393,66,16,67,16,165
394,66,34,68,15,183
395,66,17,68,15,166
396,68,33,66,17,184
397,66,17,66,17,166
399,66,19,64,18,167
400,68,31,67,17,183
401,67,16,67,17,167
402,66,33,67,17,183
403,67,16,67,17,167
404,64,34,67,16,181
406,67,33,68,15,183
407,67,16,68,15,166
408,67,34,67,15,183
409,66,17,67,15,165
410,67,34,67,26,194
413,51,33,60,4,148
414,67,34,65,18,184
415,66,19,65,18,168
416,67,30,68,18,183
417,78,4,68,18,168
419,68,16,68,16,168
420,65,33,67,16,181
421,57,15,67,16,155
424,68,32,67,16,183
425,66,16,67,16,165
426,67,33,68,17,185
427,65,17,68,17,167
428,65,34,66,17,182
429,66,17,66,17,166
430,67,34,65,18,184
431,67,18,65,18,168
432,68,32,67,17,184
434,51,15,67,17,150
435,67,16,68,16,167
436,65,34,67,16,182
437,66,16,67,16,165
438,67,34,66,18,185
439,67,17,66,18,168
440,51,17,66,18,152
442,50,17,66,18,151
443,66,17,67,17,167
444,66,33,68,15,182
445,68,15,68,15,166
447,68,16,66,17,167
448,67,34,64,19,184
449,66,17,64,19,166
450,68,32,68,16,184
451,65,17,68,16,166
452,66,32,70,14,182
453,66,15,70,14,165
454,64,36,66,16,182
458,70,32,67,16,185
459,65,18,67,16,166
460,66,33,68,15,182
461,66,17,68,15,166
463,68,17,67,17,169
464,50,17,67,17,151
465,67,18,66,17,168
466,68,33,67,15,183
467,66,18,67,15,166
468,67,33,66,18,184
469,68,16,66,18,168
472,67,32,67,15,181
473,50,32,67,15,164
474,66,33,67,17,183
475,67,15,67,17,166
476,65,34,68,17,184
478,67,33,67,16,183
481,66,18,66,16,166
483,70,15,66,16,167
485,66,18,67,15,166
486,66,32,68,16,182
487,65,16,68,16,165
488,66,35,67,19,187
489,66,19,67,19,171
490,67,33,53,29,182
491,51,33,53,29,166
492,50,18,53,29,150
493,52,34,66,15,167
494,67,48,68,16,199
495,71,29,68,16,184
496,53,29,68,16,166
498,66,33,67,16,182
499,62,18,67,16,163
500,70,33,66,16,185
501,68,16,66,16,166
502,66,34,65,19,184
503,66,19,65,19,169
504,67,32,66,19,184
505,66,16,66,19,167
507,67,17,67,18,169
508,65,33,68,18,184
509,68,14,68,18,168
511,69,15,67,34,185
514,68,33,68,16,185
515,67,15,68,16,166
517,62,21,66,16,165
518,67,34,66,16,183
524,66,34,66,20,186
525,66,18,66,20,170
526,68,38,64,31,201
527,67,23,64,31,185
529,56,28,67,16,167
530,66,36,81,16,199
531,71,16,81,16,184
533,58,31,66,17,172
534,67,33,65,17,182
535,63,17,65,17,162
536,81,16,66,17,180
537,70,16,66,17,169
538,66,32,68,17,183
540,65,34,68,16,183
541,65,17,68,16,166
542,66,34,66,18,184
544,51,17,66,18,152
545,68,17,66,16,167
546,68,32,67,18,185
547,67,16,67,18,168
549,67,16,68,16,167
551,66,17,67,17,167
552,67,35,65,17,184
554,51,17,65,17,150
556,51,16,68,17,152
557,66,16,67,17,166
559,66,18,66,17,167
560,68,32,67,16,183
561,68,15,67,16,166
562,52,15,67,16,150
563,67,17,66,17,167
566,67,33,67,17,184
567,66,17,67,17,167
568,66,33,68,15,182
570,66,34,67,16,183
571,67,17,67,16,167
572,67,34,66,16,183
573,50,34,66,16,166
575,66,18,65,17,166
576,67,33,65,17,182
577,66,17,65,17,165
578,66,32,68,17,183
579,67,16,68,17,168
580,65,33,69,16,183
581,66,16,69,16,167
583,66,18,66,18,168
584,68,34,66,16,184
586,69,32,67,16,184
588,66,34,66,16,182
589,67,16,66,16,165
592,67,33,67,32,199
593,82,34,65,18,199
594,66,34,65,18,183
595,66,18,65,18,167
597,67,17,67,15,166
598,50,17,67,15,149
599,65,18,70,15,168
600,65,35,66,18,184
601,67,17,66,18,168
602,67,35,64,17,183
603,53,35,64,17,169
604,70,31,50,18,169
606,66,33,66,18,183
607,69,15,66,18,168
608,64,35,65,17,181
609,66,18,65,17,166
613,67,16,69,16,168
615,66,18,65,18,167
616,69,34,64,17,184
617,67,18,64,17,166
618,69,31,68,15,183
621,67,15,68,16,166
624,68,33,67,14,182
625,65,18,67,14,164
626,68,33,67,16,184
627,67,17,67,16,167
628,66,34,65,18,183
629,68,17,65,18,168
630,67,33,67,16,183
631,65,19,67,16,167
633,66,16,68,16,166
634,65,35,66,16,182
637,67,17,67,16,167
638,68,33,67,17,185
640,66,34,66,16,182
641,66,18,66,16,166
643,67,17,66,18,168
644,67,33,67,16,183
645,68,16,67,16,167
648,66,34,67,16,183
650,67,33,66,17,183
651,67,17,66,17,167
654,67,32,67,18,184
655,51,32,67,18,168
656,66,34,67,16,183
657,67,17,67,16,167
659,66,17,66,34,183
660,67,34,66,16,183
661,68,16,66,16,166
662,67,32,68,16,183
663,67,16,68,16,167
664,50,16,68,16,150
666,66,34,66,18,184
667,66,18,66,18,168
668,68,33,66,17,184
669,54,33,66,17,170
670,67,33,68,15,183
671,68,16,68,15,167
672,50,16,68,15,149
673,50,33,67,17,167
674,66,35,65,17,183
675,66,18,65,17,166
676,68,32,67,16,183
677,65,17,67,16,165
678,67,33,68,16,184
679,67,16,68,16,167
680,65,34,67,15,181
681,67,17,67,15,166
684,68,33,67,16,184
685,67,17,67,16,167
686,67,34,65,17,183
687,66,19,65,17,167
688,67,33,66,16,182
694,66,37,63,17,183
695,66,21,63,17,167
696,71,29,51,17,168
697,54,29,51,17,151
698,66,34,67,17,184
700,63,34,66,17,180
701,67,17,66,17,167
703,66,17,66,16,165
704,67,33,66,19,185
705,67,16,66,19,168
706,66,33,52,17,168
707,67,16,52,17,152
711,68,17,65,17,167
712,52,17,65,17,151
713,53,32,65,17,167
714,68,33,66,17,184
715,82,32,51,17,182
716,65,32,51,17,165
717,51,32,51,17,151
718,65,34,68,17,184
720,66,34,67,17,184
721,66,17,67,17,167
722,51,17,67,17,152
723,68,17,67,15,167
725,68,16,65,18,167
726,67,34,66,15,182
728,67,31,69,15,182
729,65,16,69,15,165
730,65,35,66,18,184
731,66,17,66,18,167
732,66,34,66,17,183
733,66,19,66,17,168
736,66,34,66,17,183
737,69,16,66,17,168
738,66,34,66,17,183
740,51,17,66,17,151
743,66,17,65,18,166
744,66,32,68,15,181
745,67,15,68,15,165
747,67,15,67,18,167
748,65,35,66,18,184
749,66,17,66,18,167
750,51,17,66,18,152
751,65,17,68,15,165
752,67,34,66,18,185
753,67,16,66,18,167
754,66,34,65,18,183
755,69,16,65,18,168
756,52,16,65,18,151
758,66,33,69,15,183
759,66,15,69,15,165
760,65,35,65,17,182
762,68,34,66,15,183
763,69,15,66,15,165
764,54,15,66,15,150
765,66,16,68,16,166
767,63,18,66,17,164
771,67,17,66,18,168
772,66,32,67,18,183
773,68,15,67,18,168
774,65,34,66,19,184
775,66,17,66,19,168
776,66,33,52,17,168
777,67,15,52,17,151
778,67,33,85,16,201
779,68,15,85,16,184
780,66,36,65,18,185
781,67,17,65,18,167
782,52,17,65,18,152
783,51,33,65,18,167
785,66,16,67,16,165
786,65,33,68,16,182
787,68,15,68,16,167
788,65,34,67,16,182
790,67,34,69,13,183
791,65,18,69,13,165
792,68,33,65,18,184
793,66,17,65,18,166
794,67,36,63,18,184
795,51,36,63,18,168
797,66,16,68,16,166
798,65,34,67,17,183
799,67,16,67,17,167
801,68,16,67,16,167
802,68,33,66,18,185
804,67,34,66,18,185
805,66,17,66,18,167
806,67,32,68,16,183
809,67,16,68,15,166
810,66,34,65,18,183
811,68,16,65,18,167
812,52,16,65,18,151
813,66,18,66,15,165
815,65,16,69,15,165
816,65,35,66,17,183
817,67,17,66,17,167
818,66,34,65,17,182
819,66,19,65,17,167
820,69,32,67,16,184
822,66,33,67,15,181
823,68,16,67,15,166
824,65,34,66,18,183
825,67,17,66,18,168
826,50,17,66,18,151
828,67,33,68,15,183
829,65,18,68,15,166
831,68,15,68,15,166
832,51,15,68,15,149
833,68,18,66,18,170
834,68,33,66,17,184
835,65,18,66,17,166
836,68,33,67,16,184
837,66,18,67,16,167
838,66,33,67,17,183
839,51,33,67,17,168
842,67,33,67,15,182
844,67,34,65,17,183
847,51,33,66,17,167
848,67,32,67,17,183
849,65,17,67,17,166
850,65,34,50,17,166
851,67,17,50,17,151
852,66,33,68,16,183
853,68,16,68,16,168
855,67,17,66,18,168
856,50,17,66,18,151
857,66,18,65,17,166
858,68,32,69,14,183
859,67,16,69,14,166
860,66,33,68,16,183
862,65,36,66,15,182
863,66,19,66,15,166
864,50,19,66,15,150
866,68,34,65,18,185
867,67,18,65,18,168
868,66,33,65,17,181
869,67,18,65,17,167
871,69,14,68,16,167
872,65,33,68,15,181
875,64,18,65,19,166
876,68,33,66,17,184
877,66,17,66,17,166
879,66,17,67,18,168
881,68,15,66,16,165
882,66,33,68,16,183
883,68,16,68,16,168
886,66,35,66,17,184
889,66,17,50,16,149
890,68,33,66,17,184
893,67,16,69,16,168
894,50,16,69,16,151
895,67,16,52,15,150
897,66,19,65,16,166
901,50,34,67,16,167
902,65,34,66,17,182
903,65,18,66,17,166
904,68,33,66,16,183
906,67,33,66,19,185
907,67,17,66,19,169
908,66,33,67,16,182
911,66,17,67,16,166
912,66,34,65,36,201
913,68,15,65,36,184
914,67,33,68,15,183
915,67,17,68,15,167
917,64,16,68,17,165
918,65,36,64,18,183
919,85,32,66,18,201
920,68,32,66,18,184
922,51,17,66,18,152
924,64,34,66,17,181
925,67,16,66,17,166
926,66,33,67,17,183
928,52,15,67,17,151
929,67,15,68,17,167
930,51,15,68,17,151
931,65,17,66,35,183
935,68,15,52,15,150
936,51,15,52,15,133
937,63,21,65,18,167
938,67,32,68,16,183
939,67,15,68,16,166
942,65,35,66,17,183
943,83,33,66,16,198
946,68,33,67,16,184
948,66,33,67,17,183
949,67,16,67,17,167
950,50,16,67,17,150
951,65,18,66,17,166
953,66,17,66,17,166
954,67,33,50,18,168
956,50,16,50,18,134
957,67,16,67,18,168
958,66,35,65,18,184
960,50,18,65,18,151
962,67,33,68,16,184
963,68,15,68,16,167
964,50,15,68,16,149
965,67,16,66,18,167
967,66,17,66,16,165
969,66,16,66,18,166
970,50,16,66,18,150
975,66,16,68,17,167
976,66,34,67,16,183
977,68,16,67,16,167
978,68,34,66,18,186
979,67,17,66,18,168
982,51,16,66,17,150
983,66,17,66,17,166
986,51,15,68,15,149
987,67,16,68,15,166
988,66,35,67,16,184
989,65,18,67,16,166
991,66,18,67,15,166
993,66,19,66,16,167
995,68,17,66,16,167
997,67,18,67,16,168
999,66,17,67,17,167
1000,66,34,65,18,183
1001,67,18,65,18,168
1002,67,33,66,16,182
1003,67,17,66,16,166
1004,67,32,67,18,184
1005,68,15,67,18,168
1006,65,34,51,15,165
1007,67,16,51,15,149
1008,66,33,66,19,184
1009,65,17,66,19,167
1011,67,15,68,16,166
1012,51,15,68,16,150
1013,69,14,68,16,167
1014,66,35,66,16,183
1017,65,17,66,18,166
1018,68,33,68,14,183
1019,65,17,68,14,164
1020,66,33,68,16,183
1021,66,17,68,16,167
1025,66,19,65,17,167
1026,68,32,68,15,183
1030,65,35,67,16,183
1031,66,18,67,16,167
1033,66,16,68,17,167
1034,66,36,67,14,183
1035,67,18,67,14,166
1036,67,32,67,17,183
1038,52,16,67,17,152
1039,67,18,65,17,167
1040,67,32,67,16,182
1042,67,33,50,17,167
1044,65,34,66,17,182
1046,67,33,66,18,184
1047,66,17,66,18,167
1048,50,17,66,18,151
1051,67,16,51,17,151
1052,50,16,51,17,134
1054,66,35,66,16,183
1055,67,17,66,16,166
1056,51,17,66,16,150
1057,66,16,68,16,166
1058,67,34,68,14,183
1059,65,18,68,14,165
1060,66,34,66,16,182
1061,66,18,66,16,166
1062,68,34,66,16,184
1063,68,18,66,16,168
1065,66,18,65,19,168
1066,66,34,66,16,182
1067,66,18,66,16,166
1069,52,31,69,15,167
1070,65,35,66,17,183
1071,68,16,66,17,167
1072,66,34,65,18,183
1073,66,18,65,18,167
1074,69,32,68,16,185
1075,65,17,68,16,166
1076,66,33,70,15,184
1077,67,16,70,15,168
1081,67,19,63,18,167
1082,70,31,66,16,183
1083,67,16,66,16,165
1084,66,32,67,19,184
1086,63,34,67,17,181
1087,66,16,67,17,166
1088,66,33,67,18,184
1089,64,17,67,18,166
1090,67,34,68,14,183
1095,66,17,66,17,166
1096,51,17,66,17,151
1097,51,32,51,15,149
1098,67,34,66,17,184
1100,66,32,67,17,182
1101,69,15,67,17,168
1102,51,15,67,17,150
1103,66,16,67,16,165
1105,66,16,67,16,165
1106,67,34,66,17,184
1109,66,17,66,18,167
1111,66,17,67,16,166
1112,66,33,67,18,184
1113,67,16,67,18,168
1114,66,34,68,17,185
1117,66,17,67,17,167
1118,67,35,66,16,184
1119,67,17,66,16,166
1120,51,17,66,16,150
1121,69,15,66,17,167
1122,52,15,66,17,150
1124,66,32,67,19,184
1125,65,16,67,19,167
1126,66,35,51,14,166
1129,66,17,67,19,169
1131,69,14,53,16,152
1132,51,14,53,16,134
1133,69,15,67,17,168
1134,67,35,65,18,185
1135,67,16,65,18,166
1136,53,16,65,18,152
1137,65,17,67,16,165
1138,67,33,67,17,184
1140,65,34,65,18,182
1141,68,16,65,18,167
1143,66,17,66,16,165
1144,67,32,68,16,183
1147,67,16,67,16,166
1148,66,34,66,16,182
1150,68,33,68,16,185
1151,66,17,68,16,167
1155,66,19,65,19,169
1156,68,32,66,18,184
1159,67,17,66,18,168
1160,65,33,67,18,183
1161,68,14,67,18,167
1162,52,14,67,18,151
1163,68,15,70,16,169
1166,51,16,52,17,136
1167,67,18,65,16,166
1168,52,18,65,16,151
1169,68,17,66,15,166
1170,52,17,66,15,150
1172,65,34,65,19,183
1173,65,18,65,19,167
1175,64,17,52,15,148
1176,66,33,67,17,183
1177,68,15,67,17,167
1178,65,34,68,15,182
1180,52,15,68,15,150
1182,67,35,66,15,183
1183,65,18,66,15,164
1186,68,33,66,17,184
1188,66,33,67,17,183
1189,66,18,67,17,168
1192,66,34,65,18,183
1193,68,17,65,18,168
1194,67,34,65,18,184
1196,51,17,65,18,151
1197,66,16,68,15,165
1198,65,34,68,16,183
1199,66,16,68,16,166
1200,65,34,67,16,182
1202,52,16,67,16,151
1204,68,33,65,17,183
1206,67,32,67,17,183
1207,68,16,67,17,168
1210,65,34,67,17,183
1212,67,34,69,15,185
1213,66,17,69,15,167
1214,68,33,51,15,167
1216,67,36,81,17,201
1218,69,30,68,16,183
1219,67,15,68,16,166
1220,51,15,68,16,150
1221,67,17,66,16,166
1222,81,17,67,16,181
1224,68,33,68,15,184
1225,66,17,68,15,166
1226,66,34,67,15,182
1227,66,18,67,15,166
1228,67,34,64,17,182
1229,67,18,64,17,166
1230,68,33,67,16,184
1233,66,16,68,15,165
1234,64,36,64,16,180
1236,67,32,66,19,184
1237,68,16,66,19,169
1238,68,32,53,16,169
1239,51,32,53,16,152
1241,64,18,68,15,165
1243,70,16,65,18,169
1245,53,33,66,17,169
1246,68,32,67,16,183
1247,64,17,67,16,164
1249,69,16,66,17,168
1250,66,33,66,17,182
1251,68,16,66,17,167
1254,66,33,68,15,182
1255,66,16,68,15,165
1256,66,35,66,17,184
1258,68,33,65,18,184
1260,68,33,66,16,183
1261,66,18,66,16,166
1263,68,15,50,19,152
1264,65,34,68,16,183
1266,66,35,64,18,183
1267,65,19,64,18,166
1269,51,33,66,16,166
1270,68,31,51,16,166
1273,67,17,67,17,168
1274,66,32,69,15,182
1275,66,16,69,15,166
1276,51,16,69,15,151
1277,66,18,67,16,167
1278,67,34,65,19,185
1279,68,17,65,19,169
1280,69,33,51,16,169
1282,67,32,67,18,184
1283,66,16,67,18,167
1284,65,35,64,17,181
1286,51,16,64,17,148
1289,66,14,67,17,164
1293,65,16,67,16,164
1294,67,36,64,19,186
1295,67,19,64,19,169
1296,68,31,67,17,183
1297,67,16,67,17,167
1298,67,33,68,15,183
1299,66,17,68,15,166
1301,68,15,67,19,169
1303,68,17,52,14,151
1305,64,18,66,19,167
1307,69,14,67,16,166
1308,52,14,67,16,149
1310,66,34,66,19,185
1313,62,17,52,16,147
1314,50,17,52,16,135
1315,65,16,67,19,167
1316,66,35,67,14,182
1317,69,16,67,14,166
1321,67,16,65,18,166
1322,67,32,67,17,183
1323,66,18,67,17,168
1324,67,33,69,14,183
1325,64,17,69,14,164
1327,69,16,67,15,167
1328,67,35,65,16,183
1329,68,18,65,16,167
1331,65,18,66,16,165
1332,67,33,66,17,183
1333,65,18,66,17,166
1334,65,33,67,17,182
1335,67,17,67,17,168
1336,66,33,51,17,167
1337,67,17,51,17,152
1338,66,34,67,17,184
1339,50,34,67,17,168
1340,67,34,66,17,184
1343,51,33,67,14,165
1344,67,33,67,17,184
1345,67,16,67,17,167
1346,66,34,66,16,182
1348,67,33,66,16,182
1349,64,19,66,16,165
1350,67,33,67,15,182
1351,50,33,67,15,165
1352,66,33,68,14,181
1353,68,17,68,14,167
1356,67,34,66,16,183
1357,66,19,66,16,167
1358,68,32,65,17,182
1359,66,18,65,17,166
1360,66,34,66,16,182
1361,51,34,66,16,167
1363,68,15,69,16,168
1364,65,35,66,18,184
1365,66,18,66,18,168
1366,66,34,66,16,182
1369,68,16,65,20,169
1370,66,34,66,17,183
1371,68,16,66,17,167
1372,66,51,67,15,199
1373,66,35,67,15,183
1375,67,15,67,17,166
1376,66,33,68,17,184
1379,67,15,67,17,166
1380,67,34,66,17,184
1381,50,34,66,17,167
1382,68,33,66,18,185
1384,67,33,66,18,184
1385,67,16,66,18,167
1386,66,33,67,16,182
1387,66,16,67,16,165
1388,66,33,68,17,184
1389,67,15,68,17,167
1390,66,34,68,15,183
1391,67,16,68,15,166
1392,51,16,68,15,150
1394,68,34,65,18,185
1395,67,17,65,18,167
1396,68,32,51,17,168
1397,67,17,51,17,152
1398,66,33,69,15,183
1400,65,35,66,16,182
1402,51,17,66,16,150
1404,69,32,66,18,185
1405,66,17,66,18,167
1406,66,32,68,17,183
1407,65,16,68,17,166
1409,66,17,67,17,167
1413,51,33,67,17,168
1414,51,16,67,17,151
1416,66,34,66,16,182
1417,66,17,66,16,165
1419,67,16,67,16,166
1420,67,33,68,15,183
1422,66,34,67,15,182
1423,65,18,67,15,165
1425,67,18,65,18,168
1426,68,33,68,15,184
1427,67,18,68,15,168
1430,65,36,65,15,181
1431,68,18,65,15,166
1434,51,16,67,16,150
1435,66,17,66,17,166
1436,65,33,67,16,181
1437,65,18,67,16,166
1438,67,33,67,16,183
1439,66,17,67,16,166
1440,66,34,68,15,183
1441,68,17,68,15,168
1442,67,33,67,16,183
1443,67,17,67,16,167
1446,68,32,66,17,183
1447,67,17,66,17,167
1448,67,33,66,17,183
1449,67,17,66,17,167
1451,67,16,68,15,166
1453,67,16,66,18,167
1456,68,31,67,17,183
1457,66,16,67,17,166
1458,66,34,68,16,184
1459,67,16,68,16,167
1460,65,33,69,15,182
1461,67,16,69,15,167
1462,67,35,66,33,201
1463,66,18,66,33,183
1465,67,18,83,16,184
1466,51,18,83,16,168
1467,52,32,67,16,167
1469,63,20,68,15,166
1471,68,16,67,17,168
1472,67,34,50,16,167
1476,67,33,66,17,183
1477,68,16,66,17,167
1479,51,33,66,16,166
1480,66,33,67,16,182
1481,66,16,67,16,165
1482,66,33,68,16,183
1483,67,16,68,16,167
1484,66,34,67,17,184
1486,67,34,66,17,184
1487,66,18,66,17,167
1488,68,33,66,16,183
1491,51,33,67,15,166
1492,50,16,67,15,148
1494,66,34,67,16,183
1495,65,18,67,16,166
1496,67,33,67,17,184
1498,67,34,66,17,184
1500,67,33,66,16,182
1501,52,33,66,16,167
1502,67,33,67,17,184
1504,66,33,66,18,183
1505,67,16,66,18,167
1508,67,32,68,16,183
1509,67,15,68,16,166
1510,51,15,68,16,150
1511,68,16,68,15,167
1512,66,34,66,16,182
1513,66,17,66,16,165
1514,68,34,65,17,184
1515,66,18,65,17,166
1516,68,32,68,15,183
1518,66,33,67,17,183
1519,66,17,67,17,167
1520,65,35,65,17,182
1521,67,18,65,17,167
1522,68,32,67,16,183
1525,67,16,68,16,167
1526,65,34,68,16,183
1527,67,17,68,16,168
1528,67,34,67,15,183
1529,66,18,67,15,166
1531,67,18,63,20,168
1532,50,18,63,20,151
1533,68,17,65,17,167
1535,66,35,66,17,184
1536,63,20,66,17,166
1538,65,33,67,17,182
1540,68,35,67,15,185
1541,66,17,67,15,165
1542,68,32,67,17,184
1543,67,16,67,17,167
1544,51,16,67,17,151
1545,66,18,65,17,166
1546,67,32,68,16,183
1547,66,17,68,16,167
1548,67,33,67,34,201
1549,67,16,67,34,184
1550,65,35,66,15,181
1552,68,32,68,16,184
1553,67,16,68,16,167
1554,67,34,66,18,185
1556,66,34,66,17,183
1557,65,19,66,17,167
1558,68,32,66,18,184
1559,69,16,66,18,169
1560,66,34,67,16,183
1561,69,16,67,16,168
1562,66,32,68,16,182
1564,51,15,68,16,150
1565,66,17,66,15,164
1567,66,17,66,18,167
1569,66,17,67,17,167
1570,66,33,51,16,166
1573,68,16,83,16,183
1574,67,33,66,16,182
1575,52,33,66,16,167
1576,51,16,66,16,149
1577,65,17,67,16,165
1578,66,33,68,17,184
1580,66,34,66,17,183
1581,66,18,66,17,167
1583,66,18,66,16,166
1586,66,34,66,19,185
1587,67,17,66,19,169
1588,66,34,67,15,182
1589,65,18,67,15,165
1590,68,32,66,18,184
1591,68,15,66,18,167
1592,51,15,66,18,150
1593,69,16,66,16,167
1594,67,31,70,14,182
1595,65,16,70,14,165
1596,66,35,67,16,184
1598,66,35,65,16,182
1599,67,19,65,16,167
1600,70,32,66,16,184
1602,67,33,67,17,184
1604,65,33,67,17,182
1607,66,18,66,16,166
1608,67,33,66,17,183
1609,68,16,66,17,167
1610,67,33,66,17,183
1611,68,16,66,17,167
1614,66,33,67,18,184
1616,66,33,68,16,183
1619,67,16,67,18,168
1621,68,16,67,16,167
1623,66,17,66,20,169
1624,67,34,65,17,183
1625,67,16,65,17,165
1626,51,16,65,17,149
1627,67,16,68,16,167
1629,68,13,68,16,165
1630,65,35,66,18,184
1632,68,33,65,18,184
1633,64,17,65,18,164
1634,51,17,65,18,151
1635,51,33,66,18,168
1636,66,32,68,16,182
1641,66,16,67,17,166
1642,52,16,67,17,152
1643,66,17,66,18,167
1644,67,34,67,16,184
1645,67,16,67,16,166
1646,51,16,67,16,150
1647,68,15,51,17,151
1648,66,35,83,17,201
1651,66,17,67,16,166
1652,51,17,67,16,151
1653,66,17,68,15,166
1654,83,17,66,17,183
1655,67,17,66,17,167
1657,67,18,64,18,167
1658,68,32,67,16,183
1659,66,17,67,16,166
1660,66,32,68,16,182
1661,67,15,68,16,166
1662,64,35,66,17,182
1664,67,33,67,17,184
1665,66,17,67,17,167
1667,66,17,67,18,168
1668,66,34,66,17,183
1670,67,33,66,17,183
1671,68,16,66,17,167
1672,67,33,68,15,183
1674,51,15,68,15,149
1675,66,16,68,15,165
1676,66,35,65,17,183
1677,65,18,65,17,165
1679,66,18,66,16,166
1680,68,32,70,31,201
1681,66,17,70,31,184
1682,65,34,67,16,182
1683,67,17,67,16,167
1684,66,36,81,16,199
1685,67,20,81,16,184
1686,70,31,66,18,185
1689,51,34,67,16,168
1691,69,16,67,17,169
1693,68,17,66,15,166
1694,67,32,67,15,181
1695,51,32,67,15,165
1696,51,16,67,15,149
1697,66,17,66,16,165
1698,66,33,66,18,183
1700,67,33,67,15,182
1701,65,18,67,15,165
1702,66,33,66,18,183
1703,67,17,66,18,168
1705,69,16,66,17,168
1707,66,17,67,17,167
1708,66,34,68,15,183
1709,66,16,68,15,165
1710,66,33,67,16,182
1711,68,16,67,16,167
1712,67,35,66,17,185
1713,66,18,66,17,167
1714,50,18,66,17,151
1715,66,17,66,18,167
1716,67,34,66,17,184
1718,66,32,67,17,182
1721,68,16,66,18,168
1722,66,33,67,17,183
1724,51,16,67,17,151
1727,67,16,68,17,168
1728,67,33,52,15,167
1729,67,16,52,15,150
1731,67,17,65,16,165
1732,51,17,65,16,149
1733,68,15,67,18,168
1734,52,15,67,18,152
1735,66,16,66,18,166
1736,65,34,66,18,183
1737,64,18,66,18,166
1738,67,32,69,15,183
1739,68,14,69,15,166
1740,66,34,65,20,185
1741,68,16,65,20,169
1742,66,35,66,18,185
1743,66,17,66,18,167
1744,52,17,66,18,153
1746,65,20,82,16,183
1748,66,33,67,15,181
1749,69,15,67,15,166
1751,82,34,66,17,199
1752,66,34,66,17,183
1753,64,18,66,17,165
1754,67,34,66,16,183
1756,68,32,67,17,184
1757,68,16,67,17,168
1758,66,34,68,15,183
1759,68,17,68,15,168
1760,66,33,67,15,181
1761,66,17,67,15,165
1764,68,32,66,16,182
1765,67,17,66,16,166
1766,67,33,67,16,183
1767,65,18,67,16,166
1768,65,33,67,16,181
1770,66,34,69,13,182
1771,51,34,69,13,167
1772,67,33,67,17,184
1774,67,36,64,16,183
1776,69,31,65,18,183
1777,66,18,65,18,167
1778,67,33,67,16,183
1779,68,16,67,16,167
1780,64,32,69,15,180
1781,67,16,69,15,167
1782,65,35,67,15,182
1783,66,17,67,15,165
1785,67,18,66,16,167
1788,67,33,68,16,184
1789,66,18,68,16,168
1790,66,32,68,17,183
1791,67,16,68,17,168
1794,68,32,65,19,184
1795,68,16,65,19,168
1796,52,16,65,19,152
1797,67,15,67,17,166
1798,64,33,67,17,181
1799,64,17,67,17,165
1800,65,34,67,16,182
1803,68,16,68,16,168
1804,51,16,68,16,151
1805,65,17,67,15,164
1807,66,18,65,19,168
1808,68,33,66,17,184
1810,67,32,69,16,184
1811,66,17,69,16,168
1812,65,34,67,18,184
1813,68,15,67,18,168
1814,66,35,65,17,183
1817,66,16,67,16,165
1819,68,15,67,18,168
1821,66,17,67,16,166
1822,67,33,66,18,184
1823,65,17,66,18,166
1825,68,16,67,15,166
1826,67,32,68,16,183
1827,67,16,68,16,167
1828,66,35,65,18,184
1829,66,17,65,18,166
1833,66,16,68,16,166
1834,65,34,66,17,182
1835,68,16,66,17,167
1837,67,17,67,15,166
1839,66,16,68,16,166
1840,66,35,66,16,183
1842,67,33,67,15,182
1845,67,17,67,16,167
1846,66,34,65,19,184
1847,67,18,65,19,169
1848,67,33,65,19,184
1849,66,18,65,19,168
1850,67,32,68,17,184
1851,67,16,68,17,168
1852,65,33,52,16,166
1853,69,14,52,16,151
1854,65,35,67,16,183
1857,66,16,66,18,166
1858,52,16,66,18,152
1860,67,32,66,19,184
1861,66,16,66,19,167
1862,66,35,65,17,183
1863,68,17,65,17,167
1864,67,31,51,16,165
1866,66,34,68,16,184
1867,67,15,68,16,166
1868,65,33,68,17,183
1869,67,16,68,17,168
1870,51,16,68,17,152
1873,67,17,66,18,168
1874,51,17,66,18,152
1876,67,32,67,17,183
1877,67,16,67,17,167
1878,66,34,66,18,184
1879,67,16,66,18,167
1880,50,16,66,18,150
1881,67,16,66,17,166
1882,67,33,68,15,183
1883,82,33,68,15,198
1885,67,15,68,15,165
1886,66,35,65,17,183
1887,66,18,65,17,166
1888,50,18,65,17,150
1891,66,17,68,16,167
1893,67,17,67,15,166
1894,66,34,81,18,199
1897,51,33,66,17,167
1898,67,33,66,18,184
1899,65,18,66,18,167
1900,81,18,67,16,182
1901,65,18,67,16,166
1902,66,33,68,16,183
1903,68,16,68,16,168
1904,66,34,66,18,184
1905,69,16,66,18,169
1906,67,34,66,17,184
1907,66,18,66,17,167
1911,50,34,66,18,168
1912,66,34,66,17,183
1913,67,17,66,17,167
1914,51,17,66,17,151
1915,67,15,67,16,165
1916,66,34,67,16,183
1919,66,16,67,17,166
1922,67,33,66,18,184
1923,66,17,66,18,167
1924,50,17,66,18,151
1925,68,16,68,20,172
1926,66,33,67,16,182
1927,67,16,67,16,166
1928,66,35,66,15,182
1929,67,17,66,15,165
1930,68,32,67,18,185
1932,55,12,67,18,152
1935,61,18,67,15,161
1936,67,33,67,17,184
1939,69,16,67,15,167
1940,67,33,67,16,183
1942,67,34,66,17,184
1943,66,17,66,17,166
1944,50,17,66,17,150
1946,67,33,68,16,184
1947,66,17,68,16,167
1948,66,33,51,16,166
1951,50,35,82,16,183
1954,51,16,66,18,151
1955,67,17,66,18,168
1956,82,16,67,18,183
1957,82,33,52,16,183
1958,66,33,52,16,167
1959,50,33,52,16,151
1960,66,34,84,15,199
1961,67,16,84,15,182
1963,67,16,65,18,166
1964,52,16,65,18,151
1966,84,15,68,16,183
1967,66,15,68,16,165
1968,65,35,66,16,182
1969,68,17,66,16,167
1973,66,17,51,16,150
1976,67,33,67,16,183
1978,51,16,67,16,150
1979,51,33,68,15,167
1980,66,34,65,18,183
1982,67,34,66,17,184
1983,67,18,66,17,168
1984,68,31,52,15,166
1985,66,16,52,15,149
1987,67,17,65,17,166
1989,68,15,67,17,167
1991,65,17,67,19,168
1992,65,34,52,16,167
1993,65,17,52,16,150
1994,67,33,67,17,184
1995,68,16,67,17,168
2000,67,35,66,16,184
2001,65,18,66,16,165
2002,67,33,84,15,199
2003,66,18,84,15,183
2005,67,17,66,16,166
2006,66,32,66,18,182
2007,67,16,66,18,167
2008,84,15,67,16,182
2013,65,17,66,18,166
2014,67,33,67,17,184
2015,67,17,67,17,168
2016,68,33,66,18,185
2018,66,34,66,17,183
2019,68,16,66,17,167
2020,67,32,67,18,184
2021,68,15,67,18,168
2022,51,15,67,18,151
2023,66,16,68,16,166
2025,66,16,68,16,166
2026,67,35,66,18,186
2027,67,17,66,18,168
2028,51,17,66,18,152
2029,67,17,51,14,149
2030,68,33,83,17,201
2031,66,17,83,17,183
2032,66,32,68,15,181
2033,50,32,68,15,165
2034,51,14,68,15,148
2035,68,16,67,16,167
2037,65,17,67,16,165
2039,64,19,66,17,166
2041,67,17,66,17,167
2042,67,33,67,16,183
2043,52,33,67,16,168
2044,66,33,67,17,183
2045,67,16,67,17,167
2046,66,34,66,17,183
2047,67,17,66,17,167
2048,67,33,66,18,184
2049,66,17,66,18,167
2050,67,33,67,17,184
2052,66,33,67,17,183
2054,66,34,67,16,183
2055,67,16,67,16,166
2056,67,33,68,15,183
2057,67,16,68,15,166
2058,67,34,67,16,184
2059,66,17,67,16,166
2060,67,34,65,17,183
2061,66,18,65,17,166
2062,68,33,67,16,184
2063,66,18,67,16,167
2065,67,16,51,33,167
2066,65,35,65,18,183
2068,67,49,67,18,201
2069,67,33,67,18,185
2070,51,33,67,18,169
2072,65,35,65,17,182
2074,53,17,65,17,152
2077,51,31,67,16,165
2079,66,17,66,16,165
2080,65,33,67,17,182
2081,65,16,67,17,165
2082,51,16,67,17,151
2083,66,17,68,16,167
2085,65,18,67,17,167
2086,67,34,67,16,184
2087,68,17,67,16,168
2088,68,33,66,16,183
2089,68,17,66,16,167
2091,67,17,65,16,165
2092,67,32,67,16,182
2093,51,32,67,16,166
2095,65,17,67,18,167
2098,67,33,67,16,183
2099,67,17,67,16,167
2100,67,33,50,24,174
2101,51,33,50,24,158
2102,66,34,67,15,182
2103,67,17,67,15,166
2104,67,40,61,15,183
2106,50,24,61,15,150
2108,67,34,66,17,184
2109,66,19,66,17,168
2110,61,32,51,15,159
2111,67,17,51,15,150
2112,66,34,67,16,183
2113,69,16,67,16,168
2114,66,32,67,16,181
2115,68,15,67,16,166
2116,51,15,67,16,149
2119,66,16,68,15,165
2120,67,34,66,17,184
2121,66,18,66,17,167
2122,66,34,66,16,182
2124,68,32,68,16,184
2125,67,17,68,16,168
2126,66,34,67,16,183
2127,67,17,67,16,167
2128,66,34,66,17,183
2129,67,18,66,17,168
2130,50,18,66,17,151
2131,67,17,67,15,166
2132,67,33,67,16,183
2133,67,17,67,16,167
2134,66,34,67,16,183
2136,67,33,66,16,182
2137,66,18,66,16,166
2138,67,34,67,14,182
2139,66,18,67,14,165
2140,67,32,83,17,199
2141,68,16,83,17,184
2142,66,35,65,16,182
2144,67,33,66,15,181
2145,65,19,66,15,165
2146,83,17,68,16,184
2147,67,17,68,16,168
2148,65,34,67,16,182
2150,66,34,66,16,182
2151,66,19,66,16,167
2153,52,33,65,18,168
2155,68,17,67,17,169
2157,66,16,67,17,166
2158,65,35,65,18,183
2159,67,17,65,18,167
2160,67,32,67,17,183
2162,67,33,68,16,184
2165,66,16,67,16,165
2166,67,34,67,16,184
2169,66,17,66,19,168
2171,66,18,69,14,167
2172,67,32,68,17,184
2173,67,16,68,17,168
2174,66,37,80,16,199
2175,69,18,80,16,183
2178,51,17,65,18,151
2179,66,16,66,16,164
2180,80,16,68,16,180
2181,66,16,68,16,166
2182,65,34,66,18,183
2183,66,16,66,18,166
2185,84,32,67,17,200
2186,68,32,67,17,184
2187,66,16,67,17,166
2188,66,35,65,19,185
2189,68,17,65,19,169
2190,67,32,69,14,182
2191,67,16,69,14,166
2192,67,33,67,16,183
2195,68,17,66,15,166
2196,52,17,66,15,150
2198,67,35,65,18,185
2199,64,19,65,18,166
2201,67,18,50,16,151
2203,68,16,67,18,169
2205,68,16,67,17,168
2206,50,16,67,17,150
2207,68,15,65,20,168
2211,66,14,68,16,164
2212,65,36,65,17,183
2213,67,16,65,17,165
2214,67,32,67,18,184
2215,66,16,67,18,167
2216,52,16,67,18,153
2217,64,17,68,15,164
2218,65,34,66,17,182
2219,66,17,66,17,166
2221,69,16,66,18,169
2222,52,16,66,18,152
2223,66,17,69,17,169
2224,66,34,68,15,183
2225,65,17,68,15,165
2228,52,17,65,17,151
2229,69,16,66,15,166
2230,68,32,67,17,184
2233,65,17,66,16,164
2234,66,33,67,16,182
2236,67,33,67,17,184
2237,67,16,67,17,167
2238,66,34,67,15,182
2240,67,33,67,15,182
2241,66,17,67,15,165
2243,68,17,66,17,168
2245,66,18,67,15,166
2246,67,33,66,18,184
2247,65,18,66,18,167
2248,66,34,66,17,183
2249,68,17,66,17,168
2250,67,32,68,16,183
2251,67,17,68,16,168
2252,66,34,50,17,167
2253,67,16,50,17,150
2255,68,17,66,16,167
2256,68,33,67,16,184
2257,66,17,67,16,166
2259,67,16,66,16,165
2261,66,18,66,16,166
2265,66,18,66,17,167
2266,66,34,66,17,183
2268,68,32,68,16,184
2270,66,34,66,18,184
2273,67,17,66,17,167
2274,68,32,51,16,167
2275,67,16,51,16,150
2276,50,16,51,16,133
2277,67,16,67,17,167
2278,66,33,67,16,182
2279,67,16,67,16,166
2280,51,16,67,16,150
2281,65,18,66,17,166
2282,67,33,50,17,167
2283,67,16,50,17,150
2284,67,33,66,19,185
2285,67,17,66,19,169
2286,66,34,67,16,183
2287,66,17,67,16,166
2289,51,32,68,15,166
2290,66,35,67,15,183
2291,68,16,67,15,166
2292,67,33,65,18,183
2293,67,17,65,18,167
2294,68,34,67,16,185
2296,67,31,67,18,183
2298,65,36,65,17,183
2299,68,18,65,17,168
2300,67,31,67,18,183
2302,52,15,67,18,152
2303,67,16,67,16,166
2305,66,16,67,17,166
2306,67,34,67,16,184
2307,67,16,67,16,166
2308,67,33,50,16,166
2309,66,17,50,16,149
2311,66,17,65,18,166
2314,50,16,67,17,150
2315,67,15,69,15,166
2316,65,34,68,15,182
2317,67,16,68,15,166
2318,67,35,65,16,183
2319,66,18,65,16,165
2320,69,33,65,17,184
2321,66,18,65,17,166
2322,68,32,66,18,184
2323,66,17,66,18,167
2324,65,33,69,15,182
2325,66,17,69,15,167
2326,65,33,68,17,183
2327,67,16,68,17,168
2330,51,18,64,18,151
2331,67,17,66,18,168
2333,50,32,69,16,167
2335,67,16,68,16,167
2336,66,35,65,18,184
2337,84,33,65,17,199
2338,69,33,65,17,184
2340,68,32,68,16,184
2341,66,16,68,16,166
2342,65,33,67,16,181
2343,67,15,67,16,165
2344,65,35,68,13,181
2345,66,18,68,13,165
2347,66,16,67,17,166
2348,51,16,67,17,151
2349,66,20,65,15,166
2350,68,31,66,17,182
2353,68,17,65,18,168
2356,66,33,68,16,183
2357,66,16,68,16,166
2358,65,35,67,17,184
2360,68,33,67,15,183
2362,55,13,67,15,150
2364,67,33,66,18,184
2365,64,16,66,18,164
2366,51,16,66,18,151
2367,66,17,68,16,167
2368,65,34,66,18,183
2369,65,17,66,18,166
2371,69,16,65,18,168
2372,52,16,65,18,151
2373,51,32,67,18,168
2374,66,33,69,15,183
2375,66,15,69,15,165
2377,67,16,68,16,167
2378,51,16,68,16,151
2379,67,17,65,18,167
2381,66,18,66,16,166
2382,68,32,68,16,184
2383,66,16,68,16,166
2384,65,34,66,16,181
2385,68,16,66,16,166
2388,68,32,68,17,185
2389,66,16,68,17,167
2390,66,36,63,19,184
2391,66,20,63,19,168
2393,67,17,66,16,166
2394,51,17,66,16,150
2395,69,14,69,16,168
2397,67,16,66,16,165
2398,66,34,67,15,182
2399,65,18,67,15,165
2400,69,32,68,15,184
2401,66,16,68,15,165
2402,66,35,68,14,183
2403,66,19,68,14,167
2404,67,33,68,14,182
2405,66,18,68,14,166
2407,52,35,65,17,169
2408,68,33,65,17,183
2409,53,33,65,17,168
2410,68,32,66,17,183
2412,65,33,68,16,182
2414,65,33,66,17,181
2415,68,16,66,17,167
2416,66,35,64,18,183
2417,66,18,64,18,166
2418,68,31,51,16,166
2419,67,15,51,16,149
2420,51,15,51,16,133
2422,64,34,67,17,182
2425,66,18,67,16,167
2426,68,33,66,18,185
2427,65,18,66,18,167
2428,67,34,66,17,184
2429,68,17,66,17,168
2430,67,32,68,16,183
2431,68,16,68,16,168
2432,66,34,66,18,184
2434,66,34,65,18,183
2435,67,17,65,18,167
2439,67,15,69,15,166
2440,65,35,67,15,182
2441,67,17,67,15,166
2442,51,17,67,15,150
2444,69,33,65,19,186
2445,66,18,65,19,168
2446,67,33,66,17,183
2450,65,34,66,17,182
2451,69,15,66,17,167
2452,66,32,69,16,183
2453,68,15,69,16,168
2454,51,15,69,16,151
2456,66,35,66,16,183
2457,66,18,66,16,166
2458,69,32,68,15,184
2460,51,16,68,15,150
2461,67,17,67,17,168
2462,66,34,66,15,181
2463,66,18,66,15,165
2465,66,18,67,16,167
2469,66,19,66,16,167
2470,67,31,69,17,184
2473,68,17,67,16,168
2474,66,34,65,17,182
2477,68,16,68,15,167
2478,51,16,68,15,150
2479,51,32,51,17,151
2480,65,36,82,15,198
2481,65,19,82,15,181
2482,68,32,65,19,184
2483,67,17,65,19,168
2484,51,17,65,19,152
2485,51,33,65,17,166
2486,82,15,67,16,180
2487,67,15,67,16,165
2488,65,33,69,17,184
2489,68,14,69,17,168
2491,65,17,69,15,166
2492,67,35,66,17,185
2493,64,19,66,17,166
2495,52,34,66,17,169
2496,69,32,66,17,184
2497,68,17,66,17,168
2502,66,32,68,18,184
2503,66,15,68,18,167
2505,64,18,51,16,149
2508,68,34,66,17,185
2510,51,16,66,17,150
2511,69,15,51,16,151
2512,66,34,84,15,199
2514,66,33,66,17,182
2515,66,16,66,17,165
2516,51,16,66,17,150
2518,68,31,68,18,185
2519,67,15,68,18,168
2520,51,15,68,18,152
2523,66,17,67,15,165
2524,51,17,67,15,150
2525,51,33,67,17,168
2526,65,34,65,19,183
2527,67,17,65,19,168
2531,67,15,68,19,169
2532,65,35,65,19,184
2534,51,16,65,19,151
2536,68,32,68,17,185
2537,68,13,68,17,166
2538,52,13,68,17,150
2540,67,33,68,15,183
2541,65,16,68,15,164
2542,68,33,66,18,185
2543,66,16,66,18,166
2544,66,35,65,18,184
2547,66,16,68,16,166
2549,66,16,67,16,165
2550,65,34,66,16,181
2552,68,33,66,17,184
2553,66,17,66,17,166
2554,50,17,66,17,150
2555,65,17,67,16,165
2556,66,33,67,17,183
2557,66,17,67,17,167
2559,67,17,66,18,168
2560,67,33,67,17,184
2561,67,17,67,17,168
2562,67,33,68,16,184
2563,67,16,68,16,167
2564,66,34,66,18,184
2566,67,34,66,18,185
2567,67,17,66,18,168
2572,66,33,67,16,182
2573,68,15,67,16,166
2574,52,15,67,16,150
2575,67,15,67,18,167
2577,66,16,51,16,149
2578,67,33,67,19,186
2579,65,17,67,19,168
2581,67,16,66,18,167
2583,70,14,67,17,168
2584,67,33,67,16,183
2586,66,34,66,16,182
2587,65,16,66,16,163
2588,67,33,67,17,184
2590,67,33,66,18,184
2591,65,17,66,18,166
2592,66,34,66,17,183
2593,65,18,66,17,166
2594,67,32,68,16,183
2595,68,15,68,16,167
2596,66,34,67,16,183
2597,68,16,67,16,167
2600,68,33,66,18,185
2602,67,33,67,18,185
2603,66,17,67,18,168
2605,67,16,67,17,167
2606,50,16,67,17,150
2607,68,16,67,16,167
2608,67,33,50,16,166
2609,68,15,50,16,149
2611,66,17,67,19,169
2612,67,32,68,16,183
2614,50,16,68,16,150
2615,66,18,67,15,166
2617,70,14,66,18,168
2618,54,14,66,18,152
2620,67,32,67,18,184
2621,63,17,67,18,165
2624,65,34,66,18,183
2625,68,16,66,18,168
2626,51,16,66,18,151
2627,67,16,67,17,167
2629,66,16,52,16,150
2630,50,16,52,16,134
2631,66,17,82,17,182
2633,68,16,66,16,166
2634,52,16,66,16,150
2635,66,17,67,16,166
2636,82,17,66,18,183
2637,65,17,66,18,166
2638,66,34,66,17,183
2639,50,34,66,17,167
2642,66,34,67,17,184
2644,66,34,65,17,182
2645,67,17,65,17,166
2646,51,17,65,17,150
2648,67,32,68,16,183
2649,67,15,68,16,166
2650,65,34,66,18,183
2652,66,34,67,16,183
2653,67,16,67,16,166
2654,52,16,67,16,151
2655,51,32,69,16,168
2656,66,35,65,18,184
2657,66,17,65,18,166
2658,67,34,65,16,182
2660,69,31,67,18,185
2661,67,15,67,18,167
2662,65,34,66,19,184
2663,67,16,66,19,168
2664,65,33,52,15,165
2666,67,33,67,18,185
2667,67,15,67,18,167
2669,69,15,67,16,167
2670,52,15,67,16,150
2673,66,16,67,17,166
2674,67,33,66,18,184
2675,66,17,66,18,167
2676,67,34,66,23,190
2677,66,17,66,23,172
2680,66,34,67,17,184
2681,67,16,67,17,167
2682,66,32,68,16,182
2683,72,9,68,16,165
2685,66,17,67,17,167
2686,67,33,67,17,184
2687,61,16,67,17,161
2688,68,34,66,17,185
2691,67,16,67,18,168
2692,67,33,52,15,167
2693,68,16,52,15,151
2694,66,34,82,18,200
2696,67,33,67,17,184
2697,68,15,67,17,167
2698,52,15,67,17,151
2699,66,18,65,19,168
2700,82,18,66,18,184
2701,82,32,67,18,199
2702,67,32,67,18,184
2703,68,15,67,18,168
2704,65,34,66,18,183
2705,69,15,66,18,168
2706,66,33,68,17,184
2709,66,15,67,17,165
2710,66,35,65,17,183
2712,51,17,65,17,150
2713,67,15,67,15,164
2714,52,15,67,15,149
2715,66,16,68,16,166
2717,65,17,67,16,165
2718,50,17,67,16,150
2719,65,19,66,17,167
2720,68,33,67,17,185
2722,67,33,68,15,183
2724,66,34,66,16,182
2725,67,17,66,16,166
2727,68,17,82,18,185
2728,68,32,68,16,184
2730,66,34,66,17,183
2735,52,32,66,17,167
2737,67,17,66,16,166
2738,66,32,67,18,183
2739,66,16,67,18,167
2740,66,34,51,15,166
2742,66,33,68,15,182
2743,66,17,68,15,166
2744,67,33,69,15,184
2745,68,15,69,15,167
2747,68,17,66,16,167
2748,68,34,62,20,184
2750,69,32,67,15,183
2752,66,50,84,16,216
2753,67,34,84,16,201
2754,62,20,84,16,182
2755,67,17,67,16,167
2757,66,17,51,16,150
2758,52,17,51,16,136
2759,84,32,51,16,183
2760,67,32,51,16,166
2761,68,16,51,16,151
2763,67,15,67,16,165
2764,65,34,67,16,182
2766,51,16,67,16,150
2767,67,15,68,15,165
2771,65,18,65,19,167
2774,67,32,52,16,167
2775,67,16,52,16,151
2776,65,34,83,16,198
2777,69,15,83,16,183
2778,66,34,65,18,183
2779,68,16,65,18,167
2780,52,16,65,18,151
2781,65,16,67,18,166
2782,83,16,67,17,183
2783,81,34,67,17,199
2784,65,34,67,17,183
2785,67,16,67,17,167
2786,51,16,67,17,151
2787,68,15,67,18,168
2788,67,34,66,17,184
2789,66,17,66,17,166
2793,68,15,67,16,166
2794,66,34,68,16,184
2795,66,17,68,16,167
2797,66,16,68,16,166
2798,51,16,68,16,151
2799,66,19,66,16,167
2800,68,33,65,17,183
2802,68,33,67,17,185
2803,68,17,67,17,169
2804,66,32,52,15,165
2805,66,16,52,15,149
2806,65,35,66,15,181
2809,68,15,67,16,166
2810,52,15,67,16,150
2811,68,16,67,16,167
2812,66,33,67,16,182
2814,67,34,66,18,185
2815,65,18,66,18,167
2816,67,33,67,19,186
2817,68,17,67,19,171
2818,67,33,66,18,184
2821,68,16,66,17,167
2822,67,32,67,17,183
2823,70,13,67,17,167
2825,66,16,66,18,166
2827,64,16,68,16,164
2828,51,16,68,16,151
2831,67,17,67,15,166
2832,51,17,67,15,150
2833,67,17,67,16,167
2834,51,17,67,16,151
2836,67,33,66,16,182
2837,66,18,66,16,166
2838,67,33,67,16,183
2839,66,17,67,16,166
2841,67,17,66,17,167
2842,66,34,66,16,182
2843,66,18,66,16,166
2844,67,32,67,17,183
2845,67,16,67,17,167
2846,66,34,67,17,184
2847,67,17,67,17,168
2848,66,33,68,15,182
2849,66,17,68,15,166
2850,67,34,67,16,184
2851,67,17,67,16,167
2852,67,34,65,17,183
2853,68,17,65,17,167
2855,66,18,66,16,166
2856,67,32,66,18,183
2857,66,16,66,18,166
2859,67,17,66,18,168
2860,66,32,68,18,184
2862,66,34,67,16,183
2863,67,16,67,16,166
2865,68,16,67,16,167
2866,68,33,67,16,184
2867,68,15,67,16,166
2869,65,18,65,18,166
2870,67,33,67,15,182
2871,65,17,67,15,164
2873,67,16,67,17,167
2874,65,35,66,17,183
2876,67,32,67,18,184
2877,66,17,67,18,168
2878,67,34,67,17,185
2879,66,17,67,17,167
2880,66,33,67,16,182
2882,51,16,67,16,150
2883,68,16,66,17,167
2886,67,33,84,16,200
2887,65,17,84,16,182
2888,66,33,67,18,184
2890,50,16,67,18,151
2892,84,16,67,18,185
2896,67,34,67,16,184
2900,67,34,51,15,167
2901,67,17,51,15,150
2903,65,17,67,16,165
2904,67,33,68,16,184
2906,51,15,68,16,150
2907,67,17,66,17,167
2909,65,18,67,15,165
2910,68,32,67,18,185
2911,67,16,67,18,168
2912,66,35,66,16,183
2913,67,18,66,16,167
2914,67,32,50,18,167
2915,66,17,50,18,151
2917,68,16,66,18,168
2918,66,34,67,16,183
2920,50,18,67,16,151
2922,66,35,66,16,183
2923,68,17,66,16,167
2924,67,32,67,16,182
2925,67,16,67,16,166
2927,66,17,65,17,165
2928,66,33,66,18,183
2929,66,17,66,18,167
2930,67,32,68,17,184
2931,66,16,68,17,167
2932,65,34,67,18,184
2933,66,17,67,18,168
2934,66,34,66,18,184
2935,68,16,66,18,168
2936,52,16,66,18,152
2938,67,33,66,18,184
2941,67,15,67,18,167
2942,66,33,68,18,185
2943,65,16,68,18,167
2944,66,34,66,17,183
2946,67,34,67,15,183
2947,68,16,67,15,166
2948,68,32,67,16,183
2949,68,14,67,16,165
2952,67,32,68,16,183
2955,66,19,66,15,166
2957,67,18,82,17,184
2958,68,33,66,18,185
2959,68,17,66,18,169
2960,66,33,67,16,182
2961,66,18,67,16,167
2962,82,17,66,18,183
2963,66,17,66,18,167
2964,66,34,67,16,183
2965,69,16,67,16,168
2966,67,32,68,16,183
2968,50,16,68,16,150
2969,66,17,67,16,166
2972,68,34,66,15,183
2974,67,32,67,18,184
2975,67,16,67,18,168
2976,66,34,63,20,183
2977,68,16,63,20,167
2978,66,33,67,16,182
2980,67,50,83,17,217
2981,67,32,83,17,199
2982,63,20,83,17,183
2983,68,17,66,17,168
2984,67,32,68,16,183
2985,65,16,68,16,165
2987,83,34,65,18,200
2989,67,17,65,18,167
2990,51,17,65,18,151
2991,67,18,66,17,168
2994,65,35,66,18,184
2995,67,17,66,18,168
2996,66,33,67,17,183
2997,67,16,67,17,167
2998,52,16,67,17,152
3000,66,34,67,17,184
3001,67,16,67,17,167
3003,67,15,68,16,166
3006,67,33,66,17,183
3007,67,16,66,17,166
3009,66,34,66,16,182
3010,64,19,66,16,165
3011,66,16,66,19,167
3012,66,34,66,17,183
3014,52,17,66,17,152
3015,66,16,68,15,165
3016,66,34,68,15,183
3019,67,17,65,17,166
3020,68,34,65,18,185
3022,68,31,52,15,166
3023,51,31,52,15,149
3024,65,34,68,16,183
3026,65,33,67,16,181
3027,68,15,67,16,166
3028,52,15,67,16,150
3029,68,17,67,16,168
3031,66,16,51,17,150
3032,51,16,51,17,135
3033,65,19,83,15,182
3035,67,17,65,19,168
3036,51,17,65,19,152
3037,52,34,66,15,167
3038,83,15,68,16,182
3040,65,35,65,18,183
3041,67,16,65,18,166
3043,65,18,68,16,167
3044,68,32,68,16,184
3045,65,16,68,16,165
3047,68,18,65,16,167
3048,68,32,66,17,183
3050,52,16,66,17,151
3051,66,17,67,16,166
3052,65,33,67,17,182
3053,65,17,67,17,166
3054,66,34,66,16,182
3056,67,33,67,17,184
3058,67,33,66,18,184
3061,66,18,66,17,167
3062,67,32,67,17,183
3063,67,15,67,17,166
3064,66,34,67,16,183
3065,68,16,67,16,167
3066,66,33,67,16,182
3068,67,34,67,17,185
3071,66,17,68,17,168
3072,67,34,67,17,185
3073,66,18,67,17,168
3074,67,34,66,17,184
3075,68,17,66,17,168
3076,51,17,66,17,151
3078,67,33,67,17,184
3079,67,16,67,17,167
3082,67,33,66,17,183
3083,66,17,66,17,166
3084,67,32,66,19,184
3085,67,15,66,19,167
3086,65,34,67,16,182
3088,66,32,51,18,167
3089,66,15,51,18,150
3090,66,35,66,17,184
3093,66,18,82,16,182
3094,69,32,66,17,184
3095,82,33,66,18,199
3097,67,16,66,18,167
3098,65,33,51,17,166
3099,66,16,51,17,150
3100,66,33,68,16,183
3101,66,16,68,16,166
3103,67,17,67,15,166
3104,51,17,67,15,150
3105,51,33,67,17,168
3106,68,34,67,16,185
3107,66,18,67,16,167
3108,67,33,70,13,183
3109,65,18,70,13,166
3110,67,34,67,16,184
3111,68,17,67,16,168
3112,67,36,69,10,182
3113,68,20,69,10,167
3114,70,31,66,17,184
3116,67,38,61,16,182
3117,67,22,61,16,166
3118,69,28,65,18,180
3119,56,28,65,18,167
3121,67,16,66,18,167
3122,61,32,68,17,178
3123,67,16,68,17,168
3125,66,16,66,17,165
3126,66,34,67,17,184
3127,68,16,67,17,168
3128,68,32,67,18,185
3129,67,15,67,18,167
3130,66,35,66,16,183
3132,67,32,68,17,184
3133,67,15,68,17,167
3134,52,15,68,17,152
3136,66,34,66,17,183
3138,68,32,67,22,189
3139,67,15,67,22,171
3140,66,34,55,29,184
3142,66,33,67,17,183
3146,55,29,69,14,167
3147,67,16,67,15,165
3149,62,15,68,18,163
3150,70,35,65,17,187
3151,69,14,65,17,165
3152,67,33,67,16,183
3153,65,18,67,16,166
3155,65,14,67,18,164
3157,67,18,68,14,167
3158,67,32,67,17,183
3159,65,16,67,17,165
3161,68,18,81,18,185
3164,67,33,67,17,184
3165,66,16,67,17,166
3167,67,18,65,17,167
3168,68,32,66,18,184
3169,67,16,66,18,167
3170,51,16,66,18,151
3172,65,33,68,16,182
3175,67,16,66,17,166
3176,67,34,68,15,184
3177,68,16,68,15,167
3178,52,16,68,15,151
3180,66,36,64,18,184
3182,68,47,69,17,201
3183,52,47,69,17,185
3184,51,32,69,17,169
3185,66,17,69,15,167
3187,67,17,65,17,166
3188,53,17,65,17,152
3189,69,17,65,18,169
3192,65,34,85,16,200
3193,65,17,85,16,183
3196,52,15,68,16,151
3199,67,16,67,17,167
3201,51,32,67,18,168
3202,64,35,66,16,181
3203,83,32,68,15,198
3204,67,32,68,15,182
3206,52,15,68,15,150
3207,68,16,66,16,166
3208,66,34,65,17,182
3211,65,17,66,17,165
3212,66,33,69,17,185
3214,65,33,68,16,182
3216,50,16,68,16,150
3217,67,19,64,18,168
3218,69,32,66,17,184
3219,69,15,66,17,167
3220,53,15,66,17,151
3221,51,32,69,16,168
3222,64,34,67,17,182
3224,66,35,82,16,199
3225,67,18,82,16,183
3226,69,32,66,19,186
3227,67,16,66,19,168
3228,67,35,66,16,184
3229,67,18,66,16,167
3231,66,16,67,17,166
3232,66,35,65,18,184
3233,68,16,65,18,167
3234,66,32,67,18,183
3235,67,16,67,18,168
3236,67,33,68,16,184
3238,65,34,66,18,183
3239,67,16,66,18,167
3241,68,16,64,17,165
3242,52,16,64,17,149
3243,66,16,65,19,166
3244,66,49,68,17,200
3245,66,31,68,17,182
3247,65,35,67,17,184
3249,66,18,66,16,166
3250,70,32,67,16,185
3252,69,34,66,17,186
3256,67,33,67,16,183
3258,66,35,66,15,182
3259,67,18,66,15,166
3262,67,34,66,18,185
3263,66,18,66,18,168
3265,65,18,65,18,166
3267,67,17,66,16,166
3269,51,32,67,18,168
3270,65,34,51,15,165
3271,67,16,51,15,149
3272,66,33,67,17,183
3273,64,17,67,17,165
3274,67,33,67,18,185
3275,67,15,67,18,167
3277,67,17,67,17,168
3278,67,33,68,15,183
3279,66,16,68,15,165
3280,67,34,67,17,185
3281,68,16,67,17,168
3282,51,16,67,17,151
3283,67,17,65,16,165
3284,51,17,65,16,149
3286,67,32,69,16,184
3287,67,15,69,16,167
3288,65,35,66,17,183
3289,66,19,66,17,168
3290,67,34,65,17,183
3291,65,19,65,17,166
3293,69,16,67,17,169
3294,66,33,66,19,184
3295,68,16,66,19,169
3296,65,34,65,18,182
3297,66,17,65,18,166
3298,67,32,69,14,182
3299,67,15,69,14,165
3300,66,33,69,17,185
3301,68,14,69,17,168
3304,69,33,66,16,184
3306,69,32,68,15,184
3307,68,15,68,15,166
3309,68,17,67,17,169
3310,66,34,65,18,183
3311,65,18,65,18,166
3312,68,33,66,16,183
3314,67,32,67,17,183
3315,68,15,67,17,167
3316,65,34,67,16,182
3317,68,16,67,16,167
3318,66,33,68,16,183
3319,65,17,68,16,166
3321,66,17,67,18,168
3322,67,34,66,16,183
3324,68,33,66,17,184
3326,67,33,66,17,183
3327,69,15,66,17,167
3328,51,15,66,17,149
3330,66,33,68,16,183
3331,65,16,68,16,165
3332,66,33,51,15,165
3333,67,16,51,15,149
3334,66,35,65,17,183
3335,67,17,65,17,166
3336,68,31,69,15,183
3342,69,32,67,16,184
3343,50,32,67,16,165
3344,67,33,66,18,184
3345,67,16,66,18,167
3346,65,34,65,19,183
3348,67,32,52,16,167
3349,66,16,52,16,150
3350,66,52,67,15,200
3352,65,19,67,15,166
3353,68,16,66,18,168
3354,52,16,66,18,152
3355,68,15,66,18,167
3356,68,33,69,14,184
3357,67,15,69,14,165
3358,66,33,68,18,185
3360,66,36,66,16,184
3362,69,32,67,16,184
3364,68,34,67,17,186
3366,66,33,51,15,165
3367,52,33,51,15,151
3368,67,34,65,16,182
3369,65,18,65,16,164
3370,67,32,66,17,182
3371,68,15,66,17,166
3372,51,15,66,17,149
3373,68,15,68,16,167
3374,65,33,68,16,182
3376,66,35,66,17,184
3377,65,18,66,17,166
3378,68,33,65,17,183
3379,68,17,65,17,167
3381,67,17,67,17,168
3383,67,15,68,17,167
3384,65,35,66,18,184
3385,66,18,66,18,168
3386,67,33,51,15,166
3387,67,16,51,15,149
3388,68,33,66,19,186
3393,67,15,68,16,166
3396,52,16,68,16,152
3397,65,18,67,16,166
3398,68,35,64,17,184
3399,65,19,64,17,165
3400,68,32,67,16,183
3401,69,16,67,16,168
3402,51,16,67,16,150
3403,67,16,67,18,168
3404,64,35,66,16,181
3406,67,32,66,17,182
3407,67,16,66,17,166
3408,67,34,67,18,186
3409,68,16,67,18,169
3410,66,32,68,15,181
3411,66,16,68,15,165
3413,65,18,66,15,164
3415,69,15,66,17,167
3417,51,33,67,17,168
3419,63,18,51,16,148
3420,66,34,84,16,200
3421,68,17,84,16,185
3422,67,33,67,18,185
3423,69,16,67,18,170
3424,51,16,67,18,152
3425,50,34,66,18,168
3427,67,16,65,18,166
3428,67,33,68,16,184
3430,66,32,69,15,182
3431,67,14,69,15,165
3432,65,36,64,18,183
3434,50,18,64,18,150
3435,66,17,65,16,164
3436,52,17,65,16,150
3438,64,34,68,15,181
3439,66,16,68,15,165
3441,66,18,67,16,167
3442,68,34,66,17,185
3443,66,18,66,17,167
3444,68,33,65,19,185
3445,67,18,65,19,169
3447,67,17,67,15,166
3448,66,32,68,16,182
3450,65,35,67,17,184
3451,68,16,67,17,168
3452,67,33,66,17,183
3453,65,18,66,17,166
3454,68,34,66,17,185
3455,65,18,66,17,166
3456,67,32,67,16,182
3458,66,34,67,15,182
3459,67,17,67,15,166
3460,66,33,67,17,183
3461,66,16,67,17,166
3462,67,34,66,34,201
3463,66,18,66,34,184
3464,67,33,84,15,199
3465,65,18,84,15,182
3466,67,33,66,18,184
3467,68,16,66,18,168
3468,66,34,66,17,183
3469,66,19,66,17,168
3470,67,32,69,16,184
3473,69,16,67,16,168
3474,66,35,64,18,183
3475,66,18,64,18,166
3477,67,16,66,17,166
3478,67,32,68,16,183
3479,66,16,68,16,166
3480,64,34,67,17,182
3484,68,33,66,17,184
3485,66,17,66,17,166
3489,52,31,68,16,167
3490,66,35,65,18,184
3491,66,18,65,18,167
3492,66,33,68,16,183
3493,66,18,68,16,168
3494,68,32,67,17,184
3495,67,16,67,17,167
3496,65,36,65,16,182
3498,68,31,50,19,168
3500,52,15,50,19,136
3502,65,35,66,15,181
3505,52,30,69,16,167
3506,65,36,65,17,183
3508,66,33,66,16,181
3509,65,18,66,16,165
3510,51,18,66,16,151
3511,67,16,67,18,168
3513,67,17,66,18,168
3515,66,17,68,16,167
3520,68,33,66,17,184
3524,65,34,67,16,182
3527,67,16,69,16,168
3529,67,18,65,18,168
3530,67,35,81,17,200
3532,69,30,68,16,183
3533,69,14,68,16,167
3534,51,14,68,16,149
3537,82,33,68,16,199
3538,68,33,68,16,185
3541,66,19,66,15,166
3542,68,33,65,18,184
3543,68,17,65,18,168
3545,68,17,66,16,167
3546,66,32,68,17,183
3547,65,17,68,17,167
3550,66,34,65,19,184
3551,67,18,65,19,169
3553,67,15,52,16,150
3554,66,33,69,14,182
3555,67,16,69,14,166
3556,65,35,66,17,183
3557,67,16,66,17,166
3558,52,16,66,17,151
3559,68,17,65,17,167
3560,69,32,67,17,185
3561,64,18,67,17,166
3563,66,16,67,16,165
3564,65,34,66,17,182
3565,68,17,66,17,168
3566,67,33,70,15,185
3567,67,16,70,15,168
3568,51,16,70,15,152
3569,66,17,66,19,168
3570,66,37,63,17,183
3571,66,20,63,17,166
3572,70,29,68,17,184
3573,69,14,68,17,168
3574,52,14,68,17,151
3575,68,15,67,16,166
3576,63,34,66,17,180
3577,65,17,66,17,165
3578,68,33,66,17,184
3579,66,16,66,17,165
3582,66,33,67,18,184
3583,66,16,67,18,167
3584,66,33,68,17,184
3586,66,34,67,17,184
3587,66,17,67,17,167
3588,67,34,66,17,184
3589,68,16,66,17,167
3590,52,16,66,17,151
3594,66,33,68,15,182
3595,66,16,68,15,165
3596,66,33,68,17,184
3597,67,15,68,17,167
3598,51,15,68,17,151
3599,66,18,70,13,167
3600,68,33,66,19,186
3601,83,37,62,17,199
3602,68,37,62,17,184
3603,51,37,62,17,167
3607,68,14,68,17,167
3608,62,35,67,16,180
3609,66,18,67,16,167
3610,68,33,65,17,183
3612,51,17,65,17,150
3613,68,17,67,15,167
3615,67,15,51,16,149
3619,51,31,69,16,167
3620,51,16,69,16,152
3621,68,15,52,16,151
3622,81,19,66,16,182
3624,69,32,67,15,183
3625,67,16,67,15,165
3627,69,16,66,17,168
3629,66,17,67,15,165
3630,67,33,67,19,186
3632,66,34,65,17,182
3633,67,17,65,17,166
3635,67,18,67,17,169
3636,67,32,52,17,168
3637,69,13,52,17,151
3638,52,13,52,17,134
3640,67,34,64,17,182
3641,65,17,64,17,163
3643,52,32,67,15,166
3644,86,12,68,16,182
3645,69,12,68,16,165
3647,65,18,66,17,166
3649,80,33,51,16,180
3650,68,33,51,16,168
3651,51,33,51,16,151
3652,66,34,67,15,182
3655,51,33,66,17,167
3657,65,19,65,17,166
3658,67,32,66,18,183
3660,66,33,51,17,167
3661,68,16,51,17,152
3663,67,16,67,20,170
3664,66,35,66,18,185
3665,67,17,66,18,168
3666,51,17,66,18,152
3667,51,32,52,15,150
3668,67,34,68,17,186
3669,69,14,68,17,168
3670,52,14,68,17,151
3671,66,15,52,15,148
3672,52,15,52,15,134
3676,52,15,68,15,150
3678,82,18,81,17,198
3679,65,18,81,17,181
3680,68,33,82,18,201
3681,52,33,82,18,185
3682,67,32,68,15,182
3683,66,17,68,15,166
3684,81,17,67,18,183
3686,65,35,67,15,182
3688,68,32,69,13,182
3689,67,17,69,13,166
3690,67,35,66,16,184
3691,68,17,66,16,167
3692,67,34,65,16,182
3693,67,19,65,16,167
3696,66,33,68,15,182
3701,66,19,64,18,167
3702,68,33,65,18,184
3703,67,18,65,18,168
3704,67,31,67,18,183
3705,67,16,67,18,168
3707,67,16,66,18,167
3708,65,33,67,18,183
3713,66,16,67,16,165
3714,51,16,67,16,150
3715,67,17,65,18,167
3716,69,32,66,20,187
3717,67,16,66,20,169
3718,67,33,68,15,183
3722,51,15,67,17,150
3723,50,35,65,18,168
3724,68,32,68,15,183
3726,67,33,68,15,183
3727,64,16,68,15,163
3729,68,17,66,17,168
3731,66,18,50,16,150
3733,65,18,85,14,182
3735,68,16,66,17,167
3737,51,35,65,16,167
3739,68,14,67,16,165
3740,66,34,67,17,184
3742,65,33,67,17,182
3743,64,17,67,17,165
3744,67,34,68,16,185
3745,66,18,68,16,168
3746,67,33,51,15,166
3749,68,18,66,15,167
3752,51,15,66,19,151
3756,66,34,69,16,185
3758,65,35,67,17,184
3759,50,35,67,17,169
3760,52,17,67,17,153
3761,65,19,66,15,165
3762,69,33,64,18,184
3763,67,17,64,18,166
3764,67,33,67,15,182
3765,69,16,67,15,167
3766,66,31,68,16,181
3767,65,16,68,16,165
3768,64,36,66,16,182
3769,65,18,66,16,165
3773,66,18,66,17,167
3774,66,32,68,16,182
3778,66,34,67,15,182
3780,51,17,67,15,150
3782,67,34,82,16,199
3783,66,18,82,16,182
3784,67,32,66,17,182
3786,66,34,67,16,183
3788,82,16,69,15,182
3789,67,16,69,15,167
3790,66,35,65,16,182
3792,67,34,81,18,200
3793,51,34,81,18,184
3794,69,31,68,17,185
3795,52,31,68,17,168
3796,65,33,68,16,182
3798,64,35,66,18,183
3799,66,18,66,18,168
3800,68,33,67,17,185
3801,52,33,67,17,169
3802,52,16,67,17,152
3803,67,17,68,17,169
3804,66,34,67,16,183
3805,67,16,67,16,166
3806,67,34,66,16,183
3807,68,17,66,16,167
3808,68,33,65,17,183
3809,67,16,65,17,165
3810,67,33,67,17,184
3812,66,32,67,18,183
3813,65,16,67,18,166
3814,65,35,50,16,166
3815,66,18,50,16,150
3816,67,32,68,17,184
3817,68,15,68,17,168
3821,65,18,65,17,165
3822,68,33,66,34,201
3823,67,16,66,34,183
3825,51,32,68,16,167
3827,65,17,68,15,165
3828,66,34,66,17,183
3830,68,34,67,15,184
3832,68,32,66,17,183
3833,53,32,66,17,168
3834,66,35,65,17,183
3836,67,31,67,18,183
3837,67,16,67,18,168
3838,66,34,66,17,183
3839,66,17,66,17,166
3841,67,16,67,17,167
3843,68,15,68,17,168
3844,66,34,66,19,185
3846,67,34,51,16,168
3847,66,17,51,16,150
3849,51,32,67,18,168
3853,50,32,69,15,166
3854,67,35,66,20,188
3855,66,17,66,20,169
3856,67,34,66,15,182
3857,68,16,66,15,165
3859,66,17,65,18,166
3860,66,34,66,17,183
3861,68,14,66,17,165
3865,63,17,65,18,163
3867,68,17,66,17,168
3868,52,17,66,17,152
3869,67,15,68,17,167
3870,65,35,66,17,183
3871,66,17,66,17,166
3873,67,16,67,17,167
3875,67,16,67,18,168
3876,66,34,65,17,182
3877,66,17,65,17,165
3879,67,16,67,16,166
3880,67,32,67,18,184
3881,68,14,67,18,167
3882,51,14,67,18,150
3884,67,32,68,16,183
3885,65,16,68,16,165
3887,68,16,66,18,168
3888,66,34,66,20,186
3889,67,17,66,20,170
3890,68,32,54,14,168
3891,66,16,54,14,150
3892,50,16,54,14,134
3894,66,34,67,16,183
3895,70,14,67,16,167
3897,65,18,50,16,149
3898,67,34,66,17,184
3899,81,32,67,18,198
3900,67,32,67,18,184
3901,52,32,67,18,169
3902,50,16,67,18,151
3903,67,16,66,18,167
3904,66,33,67,16,182
3905,67,16,67,16,166
3907,67,15,66,18,166
3911,65,16,67,17,165
3912,66,35,67,16,184
3913,66,17,67,16,166
3914,67,32,68,16,183
3915,66,17,68,16,167
3916,67,35,65,18,185
3918,67,33,68,15,183
3919,68,17,68,15,168
3921,67,16,68,16,167
3924,68,32,64,19,183
3925,67,17,64,19,167
3927,66,17,66,17,166
3928,65,50,66,16,197
3929,67,33,66,16,182
3930,64,19,66,16,165
3931,67,16,66,19,168
3932,66,34,66,16,182
3933,66,17,66,16,165
3934,69,32,68,17,186
3935,66,16,68,17,167
3936,66,34,67,18,185
3937,68,15,67,18,168
3939,66,18,67,16,167
3940,68,33,68,16,185
3941,66,16,68,16,166
3942,67,34,66,18,185
3943,69,16,66,18,169
3945,66,18,65,16,165
3946,68,32,68,16,184
3947,66,16,68,16,166
3949,68,15,67,17,167
3950,65,35,65,17,182
3951,65,19,65,17,166
3952,68,32,68,16,184
3953,66,16,68,16,166
3955,68,16,67,17,168
3956,65,35,66,18,184
3957,66,18,66,18,168
3959,67,16,66,17,166
3961,67,17,66,17,167
3962,66,32,68,15,181
3963,68,14,68,15,165
3964,66,34,66,17,183
3965,66,17,66,17,166
3966,66,34,66,16,182
3967,65,17,66,16,164
3969,66,17,68,17,168
3972,66,34,67,15,182
3974,68,34,67,15,184
3976,68,33,67,15,183
3977,52,33,67,15,167
3978,67,34,65,18,184
3979,65,19,65,18,167
3980,67,33,66,17,183
3981,67,18,66,17,168
3982,67,32,67,16,182
3984,65,34,67,16,182
3986,66,33,66,17,182
3987,68,16,66,17,167
3990,67,32,67,16,182
3991,66,16,67,16,165
3994,66,33,67,16,182
3995,68,15,67,16,166
3997,66,19,66,16,167
3999,64,18,67,16,165
4000,67,34,67,16,184
4001,67,18,67,16,168
4002,66,33,66,18,183
4003,68,17,66,18,169
4004,50,17,66,18,151
4005,51,34,67,15,167
4006,67,32,66,18,183
4008,66,35,64,18,183
4009,68,17,64,18,167
4010,67,31,68,16,182
4011,66,16,68,16,166
4013,66,15,69,16,166
4015,67,17,66,17,167
4020,66,34,66,17,183
4021,67,17,66,17,167
4022,66,34,64,17,181
4024,50,18,64,17,149
4026,66,32,69,15,182
4027,67,15,69,15,166
4029,66,19,67,14,166
4031,67,17,82,17,183
4032,69,34,65,18,186
4033,67,19,65,18,169
4035,65,18,66,18,167
4036,82,17,67,17,183
4038,65,33,67,17,182
4040,66,34,66,17,183
4041,68,16,66,17,167
4042,67,33,67,18,185
4043,66,16,67,18,167
4045,66,16,67,17,166
4046,50,16,67,17,150
4047,66,17,65,17,165
4048,67,33,68,16,184
4049,68,15,68,16,167
4050,67,32,68,16,183
4051,67,15,68,16,166
4052,65,36,66,17,184
4053,64,19,66,17,166
4054,68,32,67,18,185
4055,67,16,67,18,168
4056,52,16,67,18,153
4058,66,33,66,19,184
4060,67,33,65,19,184
4061,69,15,65,19,168
4062,66,33,51,18,168
4063,66,16,51,18,151
4064,66,51,83,18,218
4065,67,32,83,18,200
4066,52,32,83,18,185
4068,51,18,65,18,152
4071,83,34,66,16,199
4072,65,34,66,16,181
4076,67,33,68,15,183
4077,65,17,68,15,165
4079,51,34,67,15,167
4081,67,18,65,16,166
4083,67,18,66,16,167
4085,66,17,66,17,166
4086,65,34,67,16,182
4087,66,18,67,16,167
4089,67,16,68,15,166
4093,67,17,67,16,167
4095,66,18,66,19,169
4096,66,34,67,17,184
4097,67,17,67,17,168
4099,68,16,68,17,169
4100,66,35,66,16,183
4101,68,16,66,16,166
4103,68,16,65,17,166
4104,68,33,66,17,184
4105,66,16,66,17,165
4106,66,32,51,16,165
4107,65,16,51,16,148
4108,65,34,66,18,183
4109,65,17,66,18,166
4110,66,33,68,17,184
4111,67,16,68,17,168
4112,51,16,68,17,152
4113,68,15,68,15,166
4115,67,17,66,16,166
4116,51,17,66,16,150
4117,67,16,66,17,166
4118,68,33,67,16,184
4120,66,33,67,16,182
4122,66,34,66,17,183
4123,68,17,66,17,168
4124,67,33,66,18,184
4126,67,33,51,15,166
4127,66,17,51,15,149
4128,66,33,68,15,182
4129,67,16,68,15,166
4130,66,33,68,17,184
4131,68,15,68,17,168
4132,51,15,68,17,151
4133,66,18,66,16,166
4134,68,33,67,15,183
4135,65,18,67,15,165
4136,68,33,67,17,185
4137,68,16,67,17,168
4138,66,34,65,18,183
4141,65,18,66,17,166
4143,68,15,68,16,167
4145,68,16,67,17,168
4147,66,17,66,17,166
4148,68,33,66,18,185
4149,66,17,66,18,167
4150,67,33,51,16,167
4151,67,16,51,16,150
4154,66,34,67,16,183
4155,67,16,67,16,166
4157,67,17,65,17,166
4159,66,17,67,15,165
4160,67,32,67,16,182
4162,65,35,66,17,183
4163,66,18,66,17,167
4164,67,32,67,18,184
4165,66,17,67,18,168
4166,67,34,66,17,184
4167,66,18,66,17,167
4168,66,33,65,18,182
4169,68,16,65,18,167
4170,67,33,68,15,183
4171,69,15,68,15,167
4174,65,18,68,17,168
4175,65,18,67,16,166
4177,66,17,66,18,167
4179,68,17,66,16,167
4180,67,31,51,17,166
4181,52,31,51,17,151
4183,66,17,66,18,167
4184,66,33,67,17,183
4185,66,17,67,17,167
4187,67,16,67,16,166
4190,67,33,66,18,184
4191,67,16,66,18,167
4192,51,16,66,18,151
4194,65,34,68,15,182
4195,66,16,68,15,165
4196,66,35,65,19,185
4197,68,17,65,19,169
4199,67,17,66,16,166
4200,51,17,66,16,150
4203,68,15,66,18,167
4204,66,34,66,16,182
4205,67,18,66,16,167
4206,68,32,67,17,184
4208,66,34,50,18,168
4209,68,16,50,18,152
4210,66,33,84,16,199
4211,65,17,84,16,182
4213,66,18,65,18,167
4214,50,18,65,18,151
4215,52,31,52,16,151
4217,67,16,66,17,166
4218,65,34,67,16,182
4219,68,16,67,16,167
4221,66,16,67,16,165
4222,66,35,66,17,184
4223,65,18,66,17,166
4225,67,16,67,18,168
4226,67,34,67,16,184
4227,66,18,67,16,167
4228,66,33,66,17,182
4229,67,16,66,17,166
4230,67,34,65,17,183
4231,69,16,65,17,167
4232,67,32,68,17,184
4236,65,35,66,16,182
4237,66,18,66,16,166
4239,68,16,67,17,168
4240,52,16,67,17,152
4243,65,18,68,15,166
4244,67,33,67,16,183
4245,67,16,67,16,166
4246,67,35,65,17,184
4247,67,19,65,17,168
4249,66,17,66,17,166
4250,50,17,66,17,150
4251,51,33,67,16,167
4252,65,33,66,17,181
4253,67,16,66,17,166
4254,66,34,66,16,182
4255,67,17,66,16,166
4256,67,32,68,17,184
4257,66,16,68,17,167
4259,66,17,68,16,167
4260,66,34,65,18,183
4262,68,34,67,16,185
4265,52,31,52,16,151
4267,66,18,83,17,184
4268,67,32,68,16,183
4269,67,16,68,16,167
4270,52,16,68,16,152
4271,67,17,66,18,168
4272,83,17,68,30,198
4274,68,32,66,17,183
4276,66,36,80,17,199
4278,68,30,67,17,182
4280,66,34,67,16,183
4281,65,17,67,16,165
4283,68,17,66,18,169
4284,67,34,66,17,184
4286,67,32,68,18,185
4287,67,16,68,18,169
4288,66,34,68,15,183
4289,67,16,68,15,166
4290,66,34,67,15,182
4293,68,16,66,16,166
4295,66,18,66,17,167
4296,67,33,67,16,183
4297,64,18,67,16,165
4298,66,33,66,18,183
4300,66,34,50,17,167
4301,68,17,50,17,152
4303,67,16,66,18,167
4308,66,36,66,16,184
4309,66,18,66,16,166
4311,82,35,66,16,199
4312,67,35,66,16,184
4315,53,32,67,17,169
4316,51,16,67,17,151
4317,68,16,66,18,168
4318,66,33,66,18,183
4320,67,33,67,18,185
4321,66,16,67,18,167
4323,68,15,68,18,169
4324,66,34,67,16,183
4326,67,34,66,18,185
4327,67,16,66,18,167
4328,52,16,66,18,152
4329,68,15,66,18,167
4331,65,17,67,17,166
4332,66,33,51,16,166
4336,67,33,67,16,183
4337,66,16,67,16,165
4338,51,16,67,16,150
4339,65,17,68,16,166
4340,66,34,67,16,183
4342,67,34,67,15,183
4343,51,34,67,15,167
4345,67,17,65,18,167
4347,67,18,65,17,167
4348,67,31,68,18,184
4349,66,16,68,18,168
4350,65,34,67,15,181
4351,67,16,67,15,165
4354,68,33,66,18,185
4357,65,19,66,17,167
4358,67,32,67,17,183
4360,66,34,68,16,184
4361,69,16,68,16,169
4362,66,33,69,15,183
4363,66,16,69,15,166
4364,67,35,66,16,184
4365,66,18,66,16,166
4366,68,34,64,17,183
4367,67,18,64,17,166
4368,69,32,67,19,187
4370,66,32,66,18,182
4371,66,16,66,18,166
4374,67,31,52,17,167
4376,54,12,52,17,135
4379,64,17,67,16,164
4380,52,17,67,16,152
4381,67,18,64,18,167
4382,69,33,83,16,201
4383,66,18,83,16,183
4385,51,31,68,16,166
4386,64,35,82,18,199
4387,67,17,82,18,184
4389,67,16,67,17,167
4390,68,34,65,17,184
4391,66,18,65,17,166
4392,82,18,68,16,184
4394,67,32,67,17,183
4397,67,19,64,17,167
4398,68,31,66,19,184
4400,67,33,67,18,185
4401,67,16,67,18,168
4404,66,34,69,16,185
4405,68,15,69,16,168
4406,67,34,68,15,184
4407,68,16,68,15,167
4408,68,35,65,16,184
4411,67,17,65,17,166
4412,68,32,66,18,184
4413,67,17,66,18,168
4414,65,33,67,17,182
4415,65,17,67,17,166
4417,67,16,67,16,166
4419,68,16,67,16,167
4420,67,33,67,17,184
4421,67,16,67,17,167
4422,51,16,67,17,151
4424,67,33,66,17,183
4425,66,17,66,17,166
4427,68,15,69,17,169
4428,65,34,52,15,166
4429,66,17,52,15,150
4430,66,35,66,15,182
4431,66,18,66,15,165
4432,69,32,68,17,186
4434,52,15,68,17,152
4435,50,34,66,16,166
4437,64,19,65,16,164
4438,68,32,67,17,184
4439,66,15,67,17,165
4442,65,34,67,16,182
4443,64,18,67,16,165
4444,67,34,66,16,183
4445,68,17,66,16,167
4446,51,17,66,16,150
4448,67,33,67,17,184
4449,66,17,67,17,167
4450,66,32,52,16,166
4451,66,16,52,16,150
4452,65,35,67,16,183
4453,66,18,67,16,167
4454,67,33,66,16,182
4455,68,16,66,16,166
4457,68,17,66,17,168
4458,67,32,51,16,166
4460,66,34,83,17,200
4461,65,18,83,17,183
4465,51,34,66,17,168
4467,66,17,66,17,166
4468,67,33,66,16,182
4469,67,17,66,16,166
4470,66,33,68,16,183
4471,67,16,68,16,167
4472,66,33,51,16,166
4473,67,16,51,16,150
4474,50,16,51,16,133
4475,65,19,83,17,184
4477,67,16,68,15,166
4480,83,17,65,18,183
4481,67,17,65,18,167
4482,68,33,50,17,168
4483,50,33,50,17,150
4484,66,32,84,17,199
4485,66,16,84,17,183
4486,65,35,66,17,183
4487,68,17,66,17,168
4488,50,17,66,17,150
4489,67,16,67,18,168
4490,84,17,66,17,184
4491,83,33,66,19,201
4492,66,33,66,19,184
4493,50,33,66,19,168
4495,68,15,52,16,151
4497,66,16,69,15,166
4498,66,35,66,17,184
4499,67,16,66,17,166
4500,52,16,66,17,151
4501,66,19,64,18,167
4502,69,32,50,18,169
4503,65,17,50,18,150
4504,66,32,69,15,182
4505,68,15,69,15,167
4506,64,36,66,18,184
4507,67,18,66,18,169
4508,50,18,66,18,152
4509,66,18,67,16,167
4510,69,33,67,15,184
4512,66,34,64,18,182
4513,69,16,64,18,167
4517,64,16,68,17,165
4518,64,35,66,18,183
4520,66,33,66,18,183
4521,68,16,66,18,168
4522,68,33,67,16,184
4523,67,16,67,16,166
4524,66,33,66,18,183
4525,67,15,66,18,166
4526,51,15,66,18,150
4527,67,16,66,16,165
4528,67,32,69,16,184
4530,66,34,67,16,183
4533,66,19,65,17,167
4536,51,16,68,15,150
4538,65,35,65,21,186
4540,68,33,53,15,169
4542,50,18,53,15,136
4543,67,16,67,17,167
4545,71,15,64,17,167
4546,53,15,64,17,149
4547,52,31,66,18,167
4548,67,33,67,17,184
4549,63,16,67,17,163
4550,64,33,51,18,166
4551,67,16,51,18,152
4552,66,34,67,18,185
4553,67,16,67,18,168
4554,67,35,66,15,183
4555,67,18,66,15,166
4556,51,18,66,15,150
4557,67,16,67,17,167
4559,68,16,67,15,166
4560,66,33,66,16,181
4561,65,18,66,16,165
4562,67,34,82,17,200
4565,67,17,67,17,168
4566,66,33,67,17,183
4567,65,17,67,17,166
4568,82,17,66,18,183
4569,67,17,66,18,168
4571,51,33,67,18,169
4572,67,33,68,16,184
4573,50,33,68,16,167
4574,66,34,70,12,182
4575,67,16,70,12,165
4576,67,34,67,15,183
4577,68,16,67,15,166
4578,52,16,67,15,150
4581,64,19,65,17,165
4582,67,33,65,17,182
4583,66,18,65,17,166
4584,64,32,67,16,179
4585,68,16,67,16,167
4587,67,16,69,15,167
4588,65,34,67,16,182
4589,66,17,67,16,166
4590,67,35,65,17,184
4591,66,19,65,17,167
4593,67,17,67,16,167
4594,67,33,50,18,168
4595,67,17,50,18,152
4596,65,34,66,18,183
4597,67,17,66,18,168
4599,67,18,65,17,167
4601,51,32,66,18,167
4603,68,15,67,18,168
4605,67,16,52,15,150
4606,66,34,66,17,183
4607,66,16,66,17,165
4608,51,16,66,17,150
4609,68,15,67,17,167
4610,52,15,67,17,151
4611,66,16,67,17,166
4612,66,34,66,18,184
4613,65,17,66,18,166
4614,67,33,51,16,167
4615,67,16,51,16,150
4616,51,16,51,16,134
4621,67,18,65,17,167
4623,67,15,51,16,149
4624,66,34,84,16,200
4625,67,16,84,16,183
4628,51,16,67,17,151
4629,66,17,66,18,167
4630,84,16,66,19,185
4631,67,16,66,19,168
4632,67,33,67,17,184
4633,67,16,67,17,167
4634,66,33,67,17,183
4635,67,15,67,17,166
4636,51,15,67,17,150
4638,67,33,68,17,185
4641,65,18,66,16,165
4642,68,33,67,19,187
4644,68,33,53,14,168
4645,68,16,53,14,151
4646,50,16,53,14,133
4647,66,18,83,15,182
4648,67,33,65,18,183
4649,69,14,65,18,166
4650,53,14,65,18,150
4652,83,15,68,16,182
4653,64,15,68,16,163
4654,65,35,65,18,183
4656,51,17,65,18,151
4657,67,16,66,17,166
4658,68,32,68,17,185
4659,66,16,68,17,167
4660,65,34,67,17,183
4662,50,16,67,17,150
4663,67,17,66,17,167
4664,51,17,66,17,151
4666,67,33,68,16,184
4667,67,16,68,16,167
4668,66,33,51,16,166
4669,66,16,51,16,149
4670,66,35,65,18,184
4671,66,18,65,18,167
4673,51,32,68,15,166
4674,51,16,68,15,150
4675,68,15,67,17,167
4676,65,35,65,16,181
4677,67,17,65,16,165
4678,51,17,65,16,149
4679,65,17,67,19,168
4680,67,33,67,17,184
4682,65,34,66,18,183
4683,66,18,66,18,168
4684,67,33,68,15,183
4686,53,14,68,15,150
4687,68,16,68,16,168
4688,66,35,65,16,182
4689,65,17,65,16,163
4690,51,17,65,16,149
4691,66,18,65,18,167
4692,68,32,68,17,185
4694,65,33,68,16,182
4695,66,17,68,16,167
4696,65,35,65,18,183
4697,67,17,65,18,167
4698,68,33,66,16,183
4701,66,16,68,16,166
4702,65,34,66,17,182
4703,82,34,67,15,198
4704,66,34,67,15,182
4705,66,18,67,15,166
4708,66,35,65,18,184
4710,67,32,67,18,184
4711,66,17,67,18,168
4714,65,34,70,16,185
4716,67,33,69,16,185
4718,67,37,63,16,183
4719,67,19,63,16,165
4721,52,32,82,17,183
4723,51,31,68,15,165
4724,63,33,67,16,179
4725,63,17,67,16,163
4726,82,17,83,16,198
4727,66,17,83,16,182
4728,68,32,67,17,184
4729,52,32,67,17,168
4731,65,17,67,16,165
4732,83,16,67,16,182
4733,68,16,67,16,167
4735,51,33,68,16,168
4737,65,18,66,17,166
4741,68,16,67,17,168
4742,66,35,65,18,184
4743,67,18,65,18,168
4745,66,17,68,16,167
4750,51,17,66,17,151
4753,65,18,52,14,149
4754,66,33,83,17,199
4759,66,16,50,16,148
4760,83,17,67,18,185
4761,64,17,67,18,166
4762,67,32,53,15,167
4763,66,16,53,15,150
4766,67,33,66,16,182
4768,53,15,66,16,150
4770,83,16,67,16,182
4771,65,16,67,16,164
4772,66,35,65,18,184
4773,65,19,65,18,167
4774,67,32,67,18,184
4775,66,17,67,18,168
4776,50,17,67,18,152
4777,67,17,68,16,168
4778,65,34,68,15,182
4779,68,16,68,15,167
4780,51,16,68,15,150
4783,66,18,65,16,165
4784,68,31,68,17,184
4785,65,16,68,17,166
4787,67,16,67,16,166
4788,65,34,64,19,182
4789,66,18,64,19,167
4791,67,16,68,14,165
4792,67,50,67,15,199
4793,51,50,67,15,183
4794,64,19,67,15,165
4795,66,18,64,17,165
4796,68,32,66,18,184
4797,66,18,66,18,168
4799,67,15,52,16,150
4804,52,16,67,18,153
4805,51,33,52,16,152
4806,83,18,67,16,184
4808,67,34,67,15,183
4810,52,16,67,15,150
4811,52,33,66,18,169
4814,67,32,66,18,183
4815,65,17,66,18,166
4816,66,33,67,17,183
4818,50,15,67,17,149
4820,66,34,67,17,184
4821,82,34,65,18,199
4823,66,17,65,18,166
4825,66,17,67,15,165
4826,67,32,67,17,183
4827,67,15,67,17,166
4828,65,35,68,15,183
4829,67,17,68,15,167
4831,65,17,67,17,166
4833,66,19,64,16,165
4834,68,31,68,16,183
4835,53,31,68,16,168
4836,51,16,68,16,151
4837,67,16,68,16,167
4838,64,35,66,17,182
4840,68,33,66,16,183
4841,67,17,66,16,166
4842,51,17,66,16,150
4845,67,16,68,16,167
4847,66,18,66,16,166
4849,66,18,65,17,166
4850,68,32,67,17,184
4853,66,17,66,18,167
4855,66,17,67,17,167
4856,67,32,68,17,184
4857,68,15,68,17,168
4859,67,17,67,17,168
4861,67,16,66,18,167
4862,52,16,66,18,152
4864,67,32,69,15,183
4867,67,16,50,15,148
4868,66,35,65,17,183
4870,69,30,68,16,183
4871,66,15,68,16,165
4872,50,15,68,16,149
4873,67,16,68,15,166
4874,65,33,66,17,181
4877,65,19,64,17,165
4881,67,16,68,17,168
4882,64,33,68,17,182
4883,66,16,68,17,167
4884,66,35,66,18,185
4885,68,16,66,18,168
4887,68,16,51,15,150
4888,52,16,51,15,134
4889,66,16,52,16,150
4890,66,33,68,16,183
4892,51,15,68,16,150
4893,68,16,83,16,183
4894,52,16,83,16,167
4895,50,33,66,16,165
4896,68,32,68,15,183
4898,83,16,68,15,182
4899,69,16,68,15,168
4900,66,34,67,17,184
4902,68,34,67,14,183
4903,65,19,67,14,165
4904,68,33,66,17,184
4906,67,34,64,18,183
4907,69,17,64,18,168
4909,66,18,66,17,167
4911,66,15,67,17,165
4912,64,34,66,18,182
4913,68,16,66,18,168
4914,66,33,68,18,185
4915,66,16,68,18,168
4917,66,16,53,15,150
4918,66,35,66,17,184
4919,67,17,66,17,167
4920,51,17,66,17,151
4921,69,15,66,16,166
4922,53,15,66,16,150
4923,50,33,66,17,166
4924,66,33,66,18,183
4925,65,16,66,18,165
4927,64,17,67,17,165
4930,66,34,68,17,185
4931,68,16,68,17,169
4932,67,33,68,19,187
4933,67,16,68,19,170
4934,67,35,66,16,184
4935,66,18,66,16,166
4937,68,16,67,15,166
4939,70,14,67,16,167
4940,52,14,67,16,149
4942,67,33,67,15,182
4943,63,18,67,15,163
4945,67,16,66,18,167
4946,65,35,65,17,182
4949,66,16,69,15,166
4951,67,16,67,18,168
4952,65,35,66,18,184
4954,69,32,52,15,168
4955,66,17,52,15,150
4956,67,34,68,15,184
4957,68,16,68,15,167
4958,66,33,66,18,183
4960,52,15,66,18,151
4962,68,31,68,17,184
4964,66,33,65,19,183
4965,68,15,65,19,167
4966,64,35,68,16,183
4967,66,18,68,16,168
4968,68,49,66,19,202
4969,67,32,66,19,184
4970,65,19,66,19,169
4972,68,31,68,15,182
4973,67,15,68,15,165
4974,69,35,82,16,202
4976,66,33,65,18,182
4977,65,18,65,18,166
4978,50,18,65,18,151
4980,82,16,68,17,183
4981,67,16,68,17,168
4982,65,34,66,16,181
4985,67,17,65,18,167
4987,67,15,67,17,166
4988,51,15,67,17,150
4989,65,17,67,17,166
4992,67,33,68,16,184
4996,66,35,83,16,200
4997,67,17,83,16,183
4998,51,17,83,16,167
4999,67,18,65,16,166
5000,51,18,65,16,150
5001,51,33,66,16,166
5002,83,16,67,17,183
5004,65,34,66,16,181
5006,66,33,66,17,182
5007,66,17,66,17,166
5010,66,33,68,15,182
5011,66,17,68,15,166
5013,66,17,83,17,183
5014,67,34,66,17,184
5018,83,17,66,17,183
5019,67,17,66,17,167
5020,66,32,68,17,183
5021,51,32,68,17,168
5022,65,34,68,15,182
5024,66,34,66,18,184
5025,66,17,66,18,167
5026,68,34,65,18,185
5027,68,17,65,18,168
5029,66,17,70,32,185
5032,65,37,65,15,182
5034,51,19,65,15,150
5035,64,20,64,17,165
5036,69,33,66,16,184
5038,65,31,67,17,180
5039,53,31,67,17,168
5040,64,35,67,17,183
5041,65,18,67,17,167
5042,66,32,52,16,166
5043,51,32,52,16,151
5044,67,35,66,16,184
5045,67,18,66,16,167
5048,52,16,67,16,151
5049,67,17,68,15,167
5050,66,34,65,18,183
5053,67,18,66,17,168
5054,68,31,68,15,182
5055,67,16,68,15,166
5056,65,35,66,17,183
5060,52,16,67,16,151
5061,65,18,70,12,165
5062,66,34,67,15,182
5064,67,36,63,16,182
5065,68,20,63,16,167
5066,70,31,66,16,183
5067,65,19,66,16,166
5068,67,32,66,18,183
5070,63,34,67,15,179
5073,67,16,68,15,166
5076,67,33,66,18,184
5077,66,18,66,18,168
5078,68,34,65,17,184
5079,65,19,65,17,166
5082,66,33,67,17,183
5083,69,15,67,17,168
5084,65,35,65,16,181
5085,66,18,65,16,165
5086,68,32,67,17,184
5087,65,17,67,17,166
5088,67,33,67,17,184
5095,51,33,70,14,168
5096,66,34,66,16,182
5098,67,36,63,18,184
5099,67,19,63,18,167
5102,66,33,68,17,184
5103,65,17,68,17,167
5104,63,34,66,18,181
5105,67,16,66,18,167
5108,68,32,69,15,184
5109,67,15,69,15,166
5110,66,35,66,16,183
5112,67,34,65,16,182
5114,69,32,65,19,185
5115,66,17,65,19,167
5116,66,33,67,16,182
5119,66,16,69,15,166
5120,65,35,66,18,184
5121,68,16,66,18,168
5122,67,34,67,15,183
5123,67,18,67,15,167
5124,69,32,68,16,185
5125,65,17,68,16,166
5126,66,35,65,17,183
5127,68,17,65,17,167
5128,67,33,65,18,183
5129,67,18,65,18,168
5131,66,16,68,15,165
5132,65,33,67,16,181
5137,66,17,68,16,167
5138,67,34,66,18,185
5139,65,18,66,18,167
5140,66,34,66,17,183
5141,67,18,66,17,168
5144,66,34,67,15,182
5145,68,16,67,15,166
5146,66,32,69,16,183
5148,66,35,66,18,185
5149,66,17,66,18,167
5150,67,34,65,18,184
5151,65,19,65,18,167
5152,50,19,65,18,152
5153,67,16,66,17,166
5154,66,33,66,19,184
5157,67,15,52,15,149
5158,66,33,68,16,183
5159,65,16,68,16,165
5160,66,34,67,34,201
5161,67,15,67,34,183
5162,52,15,67,34,168
5163,67,17,67,17,168
5164,68,33,67,17,185
5165,65,17,67,17,166
5167,84,33,66,18,201
5168,67,33,66,18,184
5169,51,33,66,18,168
5172,66,33,67,17,183
5176,51,15,69,14,149
5177,68,15,67,17,167
5178,67,35,66,17,185
5179,66,18,66,17,167
5181,64,18,51,17,150
5182,67,34,67,16,184
5183,67,17,67,16,167
5184,66,34,65,16,181
5185,69,17,65,16,167
5187,51,33,65,17,166
5188,67,32,67,16,182
5190,65,33,50,19,167
5191,82,34,82,19,217
5192,65,34,82,19,200
5193,66,17,82,19,184
5196,50,19,66,20,155
5197,52,32,54,12,150
5198,67,34,82,17,200
5199,66,19,82,17,184
5201,72,12,67,16,167
5202,54,12,67,16,149
5203,69,15,66,18,168
5205,79,32,68,17,196
5206,67,32,68,17,184
5207,65,16,68,17,166
5208,66,34,66,18,184
5209,67,16,66,18,167
5210,66,34,67,16,183
5211,68,16,67,16,167
5212,68,32,69,16,185
5215,66,17,66,16,165
5218,51,18,66,16,151
5219,67,16,68,16,167
5220,66,34,66,19,185
5221,66,18,66,19,169
5222,66,34,66,15,181
5223,66,18,66,15,165
5224,68,32,66,17,183
5225,52,32,66,17,167
5227,69,15,67,16,167
5230,66,35,66,16,183
5232,67,36,79,18,200
5233,68,20,79,18,185
5237,66,18,51,16,151
5239,66,18,67,15,166
5240,67,34,66,16,183
5241,51,34,66,16,167
5242,51,16,66,16,149
5244,67,33,66,16,182
5245,64,18,66,16,164
5246,66,33,67,17,183
5247,68,17,67,17,169
5248,66,33,67,17,183
5249,68,16,67,17,168
5251,66,18,68,15,167
5252,67,33,67,17,184
5253,67,16,67,17,167
5254,51,16,67,17,151
5256,68,32,67,16,183
5257,66,17,67,16,166
5258,67,34,65,17,183
5259,67,17,65,17,166
5260,66,33,65,18,182
5261,67,17,65,18,167
5262,50,17,65,18,150
5263,66,16,70,14,166
5266,65,37,82,15,199
5267,67,19,82,15,183
5268,51,19,82,15,167
5269,53,30,67,17,167
5271,66,17,66,17,166
5272,82,15,67,16,180
5273,83,33,67,16,199
5274,67,33,67,16,183
5275,67,16,67,16,166
5279,66,17,67,17,167
5280,67,35,65,17,184
5281,66,19,65,17,167
5285,68,16,68,15,167
5286,65,33,67,17,182
5287,66,16,67,17,166
5288,66,35,66,17,184
5289,67,17,66,17,167
5291,51,32,66,18,167
5292,67,34,66,16,183
5293,66,17,66,16,165
5295,68,15,68,17,168
5297,67,16,67,16,166
5298,66,34,66,16,182
5299,65,18,66,16,165
5302,67,33,68,16,184
5303,67,17,68,16,168
5304,66,34,67,15,182
5305,65,18,67,15,165
5306,67,34,65,16,182
5307,67,18,65,16,166
5308,68,33,66,17,184
5314,66,34,68,14,182
5315,68,17,68,14,167
5316,51,17,68,14,150
5317,68,16,66,18,168
5318,66,36,65,16,183
5319,67,18,65,16,166
5321,66,16,68,16,166
5322,66,35,67,17,185
5323,66,17,67,17,167
5324,65,33,66,17,181
5325,67,17,66,17,167
5327,66,18,67,15,166
5329,68,15,69,16,168
5331,67,18,65,16,166
5332,67,34,64,19,184
5333,65,19,64,19,167
5334,69,31,67,17,184
5338,64,34,68,16,182
5339,67,15,68,16,166
5340,67,34,67,16,184
5342,51,17,67,16,151
5343,65,18,65,19,167
5345,67,17,51,16,151
5346,67,32,67,17,183
5347,67,16,67,17,167
5349,68,16,65,17,166
5350,51,16,65,17,149
5351,66,17,67,17,167
5353,65,16,67,17,165
5354,65,34,66,18,183
5355,84,33,67,15,199
5356,67,33,67,15,182
5357,67,16,67,15,165
5358,67,33,67,16,183
5359,67,16,67,16,166
5360,66,34,67,15,182
5361,67,16,67,15,165
5362,67,33,67,17,184
5363,65,18,67,17,167
5365,65,18,67,17,167
5367,67,18,67,17,169
5368,67,34,66,17,184
5369,68,17,66,17,168
5370,67,33,67,15,182
5371,69,16,67,15,167
5373,67,16,67,16,166
5374,66,34,66,16,182
5375,66,17,66,16,165
5376,67,33,65,18,183
5378,67,33,66,17,183
5380,66,32,69,15,182
5381,67,16,69,15,167
5383,67,16,69,15,167
5384,66,35,66,15,182
5385,67,18,66,15,166
5387,66,19,82,17,184
5388,50,19,82,17,168
5390,66,32,67,18,183
5391,66,17,67,18,168
5394,67,32,68,16,183
5395,52,32,68,16,168
5397,82,35,65,17,199
5399,67,17,65,17,166
5401,66,17,66,17,166
5403,67,15,68,17,167
5406,66,34,67,16,183
5407,66,17,67,16,166
5408,68,34,66,16,184
5409,68,17,66,16,167
5412,67,33,51,16,167
5413,66,17,51,16,150
5414,66,32,67,17,182
5415,67,16,67,17,167
5416,65,35,84,14,198
5417,68,16,84,14,182
5418,51,16,84,14,165
5421,65,18,66,17,166
5422,84,14,67,17,182
5423,67,14,67,17,165
5424,66,35,67,15,183
5427,66,15,67,17,165
5428,67,35,65,17,184
5429,66,18,65,17,166
5432,67,33,67,16,183
5433,67,16,67,16,166
5434,65,33,69,15,182
5435,67,16,69,15,167
5437,67,16,67,18,168
5438,67,35,65,18,185
5439,66,19,65,18,168
5440,69,32,51,16,168
5441,66,17,51,16,150
5443,69,15,54,15,153
5444,65,34,66,16,181
5446,51,16,66,16,149
5447,49,35,66,16,166
5448,54,15,66,16,151
5449,65,17,67,18,167
5450,66,35,66,16,183
5451,62,19,66,16,163
5452,66,32,68,16,182
5453,52,32,68,16,168
5454,67,34,66,18,185
5455,69,16,66,18,169
5456,66,34,50,16,166
5457,66,18,50,16,150
5458,68,32,84,16,200
5459,66,16,84,16,182
5460,66,34,66,17,183
5461,68,16,66,17,167
5462,50,16,66,17,149
5463,66,18,65,17,166
5464,84,16,67,17,184
5465,66,16,67,17,166
5466,66,33,67,17,183
5468,65,34,67,16,182
5469,66,17,67,16,166
5470,67,33,50,17,167
5471,83,34,67,16,200
5472,67,34,67,16,184
5475,66,17,66,17,166
5476,50,17,66,17,150
5477,67,17,65,17,166
5478,67,32,69,14,182
5479,67,16,69,14,166
5480,66,33,67,17,183
5482,65,36,64,19,184
5483,66,19,64,19,168
5484,50,19,64,19,152
5485,66,17,52,14,149
5487,67,16,68,17,168
5489,69,14,68,17,168
5490,52,14,68,17,151
5491,66,18,66,17,167
5492,68,33,66,16,183
5493,66,16,66,16,164
5494,68,33,67,16,184
5495,68,16,67,16,167
5497,66,16,68,17,167
5498,66,34,67,17,184
5500,67,34,65,18,184
5502,68,33,66,17,184
5503,69,16,66,17,168
5504,67,32,68,17,184
5505,68,15,68,17,168
5506,65,34,51,17,167
5507,66,16,51,17,150
5508,66,34,66,18,184
5511,67,17,65,18,167
5512,51,17,65,18,151
5513,51,32,68,16,167
5514,66,33,51,15,165
5518,68,31,67,18,184
5519,66,15,67,18,166
5520,51,15,67,18,151
5522,83,15,68,17,183
5523,67,15,68,17,167
5524,67,35,66,16,184
5526,65,33,68,16,182
5531,51,35,64,19,169
5533,51,32,66,16,165
5534,51,16,66,16,149
5535,67,16,68,16,167
5536,64,34,67,17,182
5537,67,15,67,17,166
5538,66,34,66,17,183
5539,66,18,66,17,167
5540,68,33,67,15,183
5541,65,17,67,15,164
5543,68,16,67,17,168
5544,66,34,66,17,183
5547,65,18,66,17,166
5548,67,33,68,16,184
5551,68,16,67,17,168
5553,66,18,66,17,167
5555,67,16,67,18,168
5556,51,16,67,18,152
5557,67,17,67,16,167
5558,66,33,66,18,183
5559,67,16,66,18,167
5560,67,34,66,17,184
5561,68,16,66,17,167
5562,67,32,68,16,183
5563,66,16,68,16,166
5564,66,34,66,18,184
5567,67,17,66,18,168
5568,68,32,68,15,183
5570,66,34,67,16,183
5572,66,34,66,16,182
5573,68,16,66,16,166
5575,65,18,66,17,166
5576,67,33,66,17,183
5579,67,17,67,16,167
5580,66,33,67,18,184
5581,67,16,67,18,168
5582,66,34,66,18,184
5583,67,17,66,18,168
5584,67,33,67,18,185
5592,52,16,52,14,134
5594,67,33,67,16,183
5595,68,14,67,16,165
5596,52,14,67,16,149
5598,82,18,66,16,182
5599,63,18,66,16,163
5600,67,34,65,17,183
5601,65,18,65,17,165
5602,67,32,68,16,183
5603,69,15,68,16,168
5604,66,33,51,15,165
5605,66,17,51,15,149
5609,68,15,68,16,167
5610,51,15,68,16,150
5611,67,16,68,17,168
5613,65,18,66,18,167
5614,68,34,65,18,185
5615,66,18,65,18,167
5616,68,32,67,16,183
5617,69,15,67,16,167
5618,66,33,68,16,183
5619,50,33,68,16,167
5620,65,34,67,16,182
5621,66,16,67,16,165
5622,67,34,67,16,184
5623,65,18,67,16,166
5625,66,17,66,17,166
5626,67,34,65,19,185
5627,67,18,65,19,169
5628,67,32,68,17,184
5629,67,16,68,17,168
5630,66,33,67,17,183
5631,67,16,67,17,167
5632,65,35,65,18,183
5633,68,16,65,18,167
5634,68,32,68,16,184
5635,68,15,68,16,167
5637,65,16,67,18,166
5638,65,35,66,17,183
5639,66,17,66,17,166
5640,51,17,66,17,151
5641,67,16,67,18,168
5642,67,34,67,18,186
5643,67,16,67,18,168
5644,66,33,68,16,183
5645,67,16,68,16,167
5646,67,34,65,18,184
5647,67,16,65,18,166
5648,67,34,65,17,183
5650,52,16,65,17,150
5651,66,15,68,17,166
5652,65,34,66,19,184
5653,65,16,66,19,166
5654,65,34,67,16,182
5655,66,17,67,16,166
5656,68,32,67,18,185
5659,68,16,67,16,167
5661,66,16,68,16,166
5663,66,17,65,17,165
5664,67,33,65,18,183
5666,68,32,67,18,185
5667,66,16,67,18,167
5668,65,33,52,15,165
5669,66,16,52,15,149
5671,67,16,66,18,167
5673,68,15,67,18,168
5674,52,15,67,18,152
5675,67,15,68,18,168
5677,66,16,67,18,167
5678,67,34,51,16,168
5679,67,16,51,16,150
5680,68,33,66,18,185
5682,67,34,65,19,185
5684,51,16,65,19,151
5686,66,33,85,16,200
5687,66,15,85,16,182
5689,67,16,66,17,166
5690,52,16,66,17,151
5691,70,30,67,17,184
5692,85,16,68,16,185
5693,66,16,68,16,166
5695,63,17,66,18,164
5697,67,17,66,17,167
5698,68,32,68,15,183
5700,66,34,66,17,183
5701,67,16,66,17,166
5702,66,34,66,17,183
5703,67,17,66,17,167
5706,66,34,67,16,183
5707,66,17,67,16,166
5708,66,32,51,17,166
5710,66,35,67,17,185
5711,68,16,67,17,168
5712,67,33,51,15,166
5715,66,17,65,17,165
5716,67,32,66,17,182
5717,68,15,66,17,166
5718,51,15,66,17,149
5721,65,16,68,17,166
5723,67,18,66,18,169
5724,68,33,66,18,185
5726,68,33,67,17,185
5727,68,16,67,17,168
5728,66,33,67,16,182
5730,66,34,67,15,182
5731,67,16,67,15,165
5733,66,16,66,18,166
5734,67,34,65,17,183
5736,67,32,66,19,184
5737,65,17,66,19,167
5739,68,15,69,15,167
5741,67,16,68,15,166
5742,66,36,66,15,183
5743,67,17,66,15,165
5744,52,17,66,15,150
5745,52,32,67,16,167
5747,64,19,67,16,166
5748,66,33,67,15,181
5749,66,18,67,15,166
5750,67,34,66,16,183
5751,68,18,66,16,168
5752,67,33,70,13,183
5753,68,17,70,13,168
5754,67,33,50,17,167
5755,66,18,50,17,151
5758,70,30,66,17,183
5759,68,17,66,17,168
5760,50,17,66,17,150
5761,66,17,67,16,166
5762,79,17,66,17,179
5763,83,33,66,18,200
5765,51,33,66,18,168
5766,67,33,68,17,185
5767,66,17,68,17,168
5769,66,16,52,16,150
5770,66,35,81,18,200
5771,68,17,81,18,184
5772,68,33,66,17,184
5773,68,16,66,17,167
5774,52,16,66,17,151
5775,67,15,67,18,167
5776,81,18,66,17,182
5777,64,18,66,17,165
5778,66,33,68,16,183
5779,66,16,68,16,166
5781,69,15,67,17,168
5782,51,15,67,17,150
5783,66,18,66,16,166
5784,50,18,66,16,150
5785,66,16,69,15,166
5786,67,34,71,13,185
5788,66,35,66,15,182
5789,66,19,66,15,166
5790,50,19,66,15,150
5791,67,21,62,17,167
5793,55,30,66,15,166
5794,66,32,66,18,182
5795,66,17,66,18,167
5796,62,34,67,15,178
5797,66,17,67,15,165
5798,66,32,67,18,183
5799,66,17,67,18,168
5803,67,17,68,15,167
5804,67,34,68,15,184
5805,67,16,68,15,166
5806,66,34,66,15,181
5807,67,18,66,15,166
5809,65,19,65,17,166
5813,66,18,66,18,168
5814,65,33,67,16,181
5815,67,16,67,16,166
5816,66,33,67,17,183
5817,69,15,67,17,168
5819,67,16,50,17,150
5820,67,33,68,16,184
5821,65,17,68,16,166
5825,67,18,66,16,167
5826,68,33,65,17,183
5827,67,17,65,17,166
5828,67,33,66,16,182
5832,65,34,67,16,182
5833,67,17,67,16,167
5834,66,34,66,17,183
5835,66,18,66,17,167
5836,68,33,68,15,184
5838,51,16,68,15,150
5840,66,35,65,17,183
5841,66,18,65,17,166
5842,68,32,66,16,182
5844,67,33,67,16,183
5847,67,16,68,16,167
5848,66,34,50,18,168
5849,65,18,50,18,151
5850,67,34,65,19,185
5852,68,34,65,18,185
5853,52,34,65,18,169
5854,50,18,65,18,151
5855,52,31,71,14,168
5856,65,34,67,16,182
5857,68,15,67,16,166
5859,67,19,81,15,182
5860,71,30,66,18,185
5862,67,33,68,15,183
5863,65,17,68,15,165
5864,81,15,67,16,179
5865,82,35,65,18,200
5866,66,35,65,18,184
5867,68,17,65,18,168
5868,68,32,66,19,185
5869,65,17,66,19,167
5870,67,33,67,18,185
5871,65,17,67,18,167
5872,65,33,67,18,183
5873,68,15,67,18,168
5874,66,34,67,16,183
5875,84,33,67,18,202
5876,67,33,67,18,185
5877,67,15,67,18,167
5880,67,33,68,16,184
5881,65,17,68,16,166
5882,67,33,67,16,183
5884,51,15,67,16,149
5885,68,17,66,16,167
5887,66,16,68,17,167
5888,67,34,66,17,184
5890,66,34,65,18,183
5892,68,32,68,16,184
5895,67,16,68,17,168
5896,65,35,67,15,182
5897,66,17,67,15,165
5898,51,17,67,15,150
5899,51,33,67,16,167
5900,51,17,67,16,151
5901,67,17,65,16,165
5902,67,33,82,16,198
5903,66,18,82,16,182
5904,67,32,84,16,199
5906,65,33,67,18,183
5908,82,16,52,15,165
5909,66,16,52,15,149
5910,66,34,67,17,184
5911,68,16,67,17,168
5915,49,34,66,18,167
5916,67,32,68,16,183
5917,66,15,68,16,165
5918,66,34,68,17,185
5919,67,16,68,17,168
5920,66,34,66,17,183
5921,67,16,66,17,166
5922,52,16,66,17,151
5923,66,18,65,17,166
5924,68,32,67,17,184
5925,67,15,67,17,166
5927,67,16,68,17,168
5928,65,34,67,16,182
5930,67,34,67,15,183
5931,67,17,67,15,166
5932,51,17,67,15,150
5934,51,16,67,15,149
5935,66,18,66,16,166
5937,65,18,67,17,167
5939,66,18,66,18,168
5941,51,34,67,17,169
5942,67,32,66,18,183
5943,69,15,66,18,168
5944,66,35,67,15,183
5945,68,17,67,15,167
5946,67,31,69,15,182
5947,67,14,69,15,165
5948,66,36,66,16,184
5949,66,18,66,16,166
5950,67,33,66,15,181
5951,65,18,66,15,164
5953,66,18,66,17,167
5954,66,33,67,16,182
5955,67,17,67,16,167
5956,66,33,68,16,183
5958,66,34,66,18,184
5960,67,34,63,18,182
5962,68,32,67,17,184
5963,67,16,67,17,167
5965,68,31,67,18,184
5966,63,18,67,18,166
5967,65,18,67,17,167
5970,53,15,68,16,152
5971,67,18,66,17,168
5972,67,33,67,17,184
5973,67,16,67,17,167
5974,52,16,67,17,152
5975,67,17,67,17,168
5977,66,17,66,17,166
5978,67,33,66,16,182
5979,68,16,66,16,166
5980,67,33,67,17,184
5981,67,16,67,17,167
5982,66,33,51,17,167
5983,66,16,51,17,150
5984,66,34,67,15,182
5988,51,17,66,17,151
5990,67,33,66,18,184
5991,65,18,66,18,167
5992,66,34,66,16,182
5995,68,16,66,17,167
5998,66,32,67,17,182
