序号,发送->接收,接收->转发,转发->接收,接收->处理,总计
1,160,18,182,18,378
2,81,18,66,19,184
3,65,18,66,19,168
5,114,35,96,19,264
6,69,18,182,18,287
7,84,35,96,19,234
9,68,16,96,19,199
11,51,32,64,19,166
12,101,49,68,16,234
13,112,19,68,16,215
14,115,34,118,16,283
15,51,49,68,16,184
16,83,34,118,16,251
17,167,17,117,18,319
18,83,17,66,17,183
19,66,17,66,17,166
22,152,34,66,15,267
23,100,18,183,15,316
24,117,34,66,15,232
25,149,35,65,18,267
26,84,34,66,15,199
27,68,34,66,15,183
30,65,35,65,18,183
33,115,33,51,17,216
34,66,34,66,18,184
35,83,33,51,17,184
37,133,17,67,17,234
39,82,18,150,17,267
40,84,17,67,17,185
43,65,18,66,18,167
44,85,17,83,17,202
45,84,32,51,17,184
46,99,34,165,18,316
47,84,34,165,18,301
49,67,16,165,18,266
51,66,17,65,18,166
52,117,16,66,18,217
53,65,17,67,17,166
54,66,33,66,18,183
56,116,33,104,13,266
58,51,16,154,13,234
60,84,16,201,16,317
61,66,16,201,16,299
62,82,18,54,13,167
63,100,16,134,16,266
64,68,33,134,16,251
65,67,16,134,16,233
67,85,33,300,16,434
68,100,33,116,35,284
69,50,33,300,16,399
70,67,33,116,35,251
71,79,34,82,35,230
72,82,18,82,35,217
73,167,35,150,17,369
75,82,50,118,33,283
76,66,50,118,33,267
77,100,35,150,17,302
79,101,15,251,17,384
81,68,15,251,17,351
82,101,34,67,17,219
83,118,33,51,15,217
84,68,34,67,17,186
88,101,32,68,16,217
89,101,15,68,16,200
90,84,15,68,16,183
92,121,13,99,18,251
93,67,16,118,16,217
94,100,33,66,18,217
96,68,33,66,18,185
97,67,17,66,18,168
98,100,34,68,15,217
100,65,34,68,15,182
101,101,33,99,18,251
102,66,51,99,18,234
103,67,33,99,18,217
104,52,33,99,18,202
105,67,17,82,18,184
106,83,18,67,16,184
108,168,32,51,16,267
109,133,17,83,16,249
111,67,18,65,17,167
112,67,33,83,16,199
113,83,32,51,16,182
114,68,32,51,16,167
115,51,32,51,16,150
116,82,16,101,17,216
117,100,16,200,18,334
118,83,16,200,18,317
120,118,16,133,18,285
122,69,32,133,18,252
124,67,33,66,18,184
125,51,33,66,18,168
126,82,17,84,15,198
128,67,32,52,15,166
129,50,32,52,15,149
130,118,15,85,15,233
131,67,16,66,18,167
132,116,16,117,18,267
134,52,15,85,15,167
135,82,36,99,32,249
136,84,18,99,32,233
138,69,31,100,17,217
140,52,15,100,17,184
142,66,33,67,16,182
143,115,35,132,18,300
144,100,35,132,18,285
146,116,16,67,16,215
148,83,16,67,16,182
149,52,32,67,16,167
151,85,32,51,16,184
152,67,32,51,16,166
153,68,15,51,16,150
154,52,15,51,16,134
157,66,16,66,17,165
158,116,17,84,17,234
159,100,17,84,17,218
160,66,34,84,17,201
161,99,17,50,17,183
162,83,17,50,17,167
163,118,33,149,17,317
164,51,17,50,17,135
165,101,17,149,17,284
166,68,33,149,17,267
168,50,17,149,17,233
169,51,32,117,17,217
170,65,35,99,19,218
171,84,33,66,19,202
172,67,33,66,19,185
173,50,33,66,19,168
174,68,33,101,15,217
175,83,33,68,15,199
177,84,33,84,17,218
178,85,14,84,17,200
180,52,14,84,17,167
181,85,33,99,17,234
182,83,18,99,17,217
183,64,18,99,17,198
184,84,17,99,18,218
185,67,17,99,18,201
188,66,33,233,17,349
189,67,16,233,17,333
192,84,15,118,16,233
193,133,16,67,17,233
195,150,33,67,16,266
196,84,16,67,17,184
197,66,16,67,17,166
198,51,16,67,17,151
199,67,17,66,17,167
200,100,33,50,17,200
203,67,16,50,17,150
204,66,34,101,16,217
205,166,18,83,32,299
206,67,33,217,16,333
207,83,34,50,16,183
208,67,34,50,16,167
209,50,34,50,16,150
210,83,18,83,32,216
212,84,16,117,16,233
213,51,32,117,16,216
215,83,50,84,17,234
216,65,50,84,17,216
217,117,32,134,32,315
218,167,33,267,16,483
220,84,16,134,32,266
221,66,16,134,32,248
225,67,16,267,16,366
226,51,16,267,16,350
228,132,18,82,17,249
229,83,50,82,17,232
230,67,50,82,17,216
231,65,35,82,17,199
232,65,18,82,17,182
233,68,17,65,17,167
234,67,32,84,17,200
236,67,33,100,18,218
237,82,35,149,18,284
238,65,35,149,18,267
239,85,33,116,18,252
240,101,50,99,18,268
242,100,18,99,18,235
243,51,50,99,18,218
245,101,15,133,18,267
246,99,35,98,18,250
248,102,33,65,18,218
249,117,33,133,17,300
250,84,18,65,18,185
252,68,33,133,17,251
253,51,33,133,17,234
258,67,34,65,16,182
259,51,34,65,16,166
260,101,33,66,35,235
261,83,33,66,35,217
262,99,34,67,15,215
265,102,15,84,18,219
266,67,32,84,18,201
267,67,15,84,18,184
268,83,18,67,16,184
269,67,18,67,16,168
270,184,16,115,19,334
271,65,18,100,16,199
272,102,32,50,17,201
274,133,33,82,19,267
275,52,32,50,17,151
276,84,16,115,19,234
277,100,17,82,19,218
279,66,17,82,19,184
281,83,33,333,17,466
283,135,16,166,16,333
284,134,33,67,16,250
287,167,17,66,16,266
288,51,16,166,16,249
289,85,32,135,17,269
290,66,32,135,17,250
292,65,35,66,16,182
293,65,17,66,16,164
294,67,34,165,17,283
297,83,34,149,17,283
298,100,33,66,17,216
299,84,33,66,17,200
300,66,33,66,17,182
301,51,33,66,17,167
302,67,33,299,18,417
304,99,33,100,18,250
307,99,17,66,18,200
309,83,33,134,17,267
311,100,34,83,17,234
312,118,15,68,17,218
313,83,18,83,17,201
314,66,18,83,17,184
315,67,15,68,17,167
316,151,33,66,17,267
317,70,14,65,18,167
318,68,33,248,19,368
319,50,33,248,19,350
321,64,33,66,17,180
322,65,18,66,17,166
324,84,32,68,18,202
325,99,17,51,18,185
327,66,17,51,18,152
329,67,33,83,15,198
330,52,33,83,15,183
332,69,30,101,16,216
334,83,19,66,16,184
335,64,19,66,16,165
336,65,32,168,15,280
337,52,32,168,15,267
338,67,34,66,15,182
339,119,47,85,17,268
341,85,47,85,17,234
342,68,47,85,17,217
343,119,33,83,17,252
345,65,20,116,17,218
346,67,33,83,17,200
347,84,32,68,16,200
348,68,32,68,16,184
350,116,17,66,33,232
351,66,17,66,18,167
353,68,17,66,33,184
354,68,32,67,16,183
355,133,17,102,16,268
356,66,34,84,15,199
357,49,34,84,15,182
360,83,17,69,16,185
361,65,17,69,16,167
362,66,33,165,18,282
365,50,36,199,17,302
367,51,31,151,17,250
369,165,18,199,18,400
370,83,31,85,17,216
371,67,31,85,17,200
373,66,33,52,17,168
375,64,18,199,18,299
377,85,32,151,17,285
378,70,32,151,17,270
379,101,17,117,17,252
380,100,33,84,17,234
381,66,17,117,17,217
384,117,16,69,16,218
386,66,33,69,16,184
389,68,17,65,17,167
390,68,34,82,17,201
391,101,15,169,16,301
392,85,15,169,16,285
393,67,15,169,16,267
394,50,15,169,16,250
395,50,35,100,16,201
396,82,17,101,16,216
397,117,33,100,16,266
399,85,33,100,16,234
400,83,17,100,16,216
401,100,18,66,16,200
402,117,33,82,17,249
403,97,33,82,17,229
404,67,49,82,17,215
406,165,34,217,16,432
407,67,17,99,17,200
408,116,15,68,32,231
409,83,32,68,32,215
410,100,34,217,16,367
413,66,17,217,16,316
414,66,34,66,17,183
415,66,17,66,17,166
416,51,17,66,17,151
417,51,32,68,16,167
419,83,34,233,18,368
420,66,34,233,18,351
421,68,17,233,18,336
424,83,18,82,18,201
425,66,18,82,18,184
426,83,16,134,18,251
427,67,16,134,18,235
428,116,18,148,19,301
429,68,16,118,15,217
430,66,34,148,19,267
431,66,18,148,19,251
432,68,32,116,19,235
434,118,15,84,16,233
435,84,33,84,16,217
436,66,33,84,16,199
437,117,35,65,17,234
438,83,17,134,17,251
439,66,17,134,17,234
440,82,19,65,17,183
442,68,32,100,17,217
443,52,32,100,17,201
444,100,34,83,17,234
445,51,33,67,17,168
447,83,33,67,16,199
448,67,33,67,16,183
449,83,34,66,17,200
450,84,17,66,17,184
451,117,33,117,16,283
452,83,17,67,17,184
453,66,17,67,17,167
454,100,34,133,16,283
458,84,16,100,16,216
459,68,16,100,16,200
460,51,16,100,16,183
461,66,17,150,33,266
463,116,33,134,16,299
464,100,33,134,16,283
465,84,33,134,16,267
466,150,33,51,16,250
467,66,17,134,16,233
468,117,33,51,16,217
469,101,33,51,16,201
472,83,35,82,17,217
473,66,35,82,17,200
474,66,19,82,17,184
475,100,17,67,33,217
476,68,33,67,33,201
478,101,34,118,16,269
481,67,17,118,16,218
483,64,18,67,18,167
485,117,34,183,16,350
486,100,34,183,16,333
487,103,16,183,16,318
488,67,34,183,16,300
489,85,33,133,17,268
490,52,16,183,16,267
491,51,33,133,17,234
492,67,50,83,17,217
493,81,18,83,17,199
494,65,18,83,17,183
495,68,33,67,16,184
496,83,17,134,15,249
498,183,19,65,16,283
499,83,33,133,16,265
500,68,33,133,16,250
501,83,34,149,16,282
502,66,34,149,16,265
503,98,19,65,16,198
504,82,19,65,16,182
505,184,31,135,16,366
507,66,18,233,16,333
508,67,32,50,16,165
509,52,32,50,16,150
511,100,16,135,16,267
514,101,33,99,18,251
515,67,18,132,18,235
517,67,17,99,18,201
518,102,33,50,15,200
524,65,18,82,17,182
525,67,15,67,17,166
526,97,19,83,17,216
527,67,33,83,17,200
529,66,33,67,18,184
530,67,17,67,18,169
531,66,17,68,15,166
533,83,35,67,16,201
534,84,18,67,16,185
535,85,32,167,16,300
536,68,32,167,16,283
537,52,32,167,16,267
538,67,35,199,16,317
540,67,33,166,16,282
541,68,17,166,16,267
542,51,17,166,16,250
544,65,34,100,16,215
545,65,18,100,16,199
546,81,18,133,17,249
547,66,18,133,17,234
549,51,33,150,16,250
551,85,33,67,16,201
552,67,33,67,16,183
554,83,17,50,16,166
556,66,34,132,17,249
557,67,17,132,17,233
559,67,16,100,17,200
560,83,16,67,17,183
561,82,35,100,15,232
562,65,35,100,15,215
563,66,18,100,15,199
566,67,34,100,16,217
567,101,17,100,16,234
568,66,34,100,16,216
570,68,33,67,16,184
571,100,17,134,17,268
572,83,17,134,17,251
573,66,17,134,17,234
575,85,33,67,17,202
576,67,33,67,17,184
577,51,33,67,17,168
578,134,32,150,17,333
579,118,32,150,17,317
580,83,17,265,18,383
581,116,34,133,18,301
583,82,34,133,18,267
584,83,16,133,18,250
586,116,17,66,18,217
588,66,18,66,17,167
589,83,49,83,18,233
592,67,17,83,18,185
593,83,33,117,17,250
594,150,16,67,17,250
595,50,33,117,17,217
597,101,16,67,17,201
598,66,18,83,17,184
599,66,16,67,17,166
600,51,16,67,17,151
601,67,16,68,18,169
602,84,17,233,16,350
603,66,17,233,16,332
604,67,34,66,17,184
606,86,16,65,17,184
607,51,34,65,17,167
608,100,33,66,17,216
609,116,35,65,16,232
613,66,18,65,16,165
615,82,17,84,16,199
616,116,18,99,18,251
617,83,34,99,18,234
618,65,34,99,18,216
621,67,17,66,18,168
624,67,32,101,17,217
625,83,33,102,15,233
626,66,33,102,15,216
627,68,15,102,15,200
628,65,34,68,15,182
629,99,17,150,16,282
630,52,15,68,15,150
631,132,33,151,17,333
633,66,17,83,33,199
634,133,51,83,17,284
637,65,17,134,17,233
638,65,51,83,17,216
640,67,18,83,17,185
641,68,16,301,16,401
643,67,15,100,17,199
644,52,15,100,17,184
645,83,33,134,17,267
648,83,17,101,17,218
650,100,33,83,18,234
651,116,34,67,16,233
654,67,34,67,16,184
655,84,49,51,34,218
656,67,49,51,34,201
657,68,32,51,34,185
659,66,18,116,16,216
660,67,33,83,16,199
661,83,34,99,17,233
662,68,34,99,17,218
663,51,34,99,17,201
664,67,33,66,17,183
666,83,16,68,32,199
667,84,34,100,17,235
668,65,34,100,17,216
669,66,17,100,17,200
670,83,17,66,17,183
671,116,17,66,17,216
672,151,17,100,34,302
673,100,17,134,34,285
674,66,17,66,17,166
675,100,17,100,34,251
676,83,17,100,34,234
677,68,17,100,34,219
678,83,17,68,34,202
679,117,34,67,16,234
680,100,34,67,16,217
681,117,34,66,15,232
684,102,33,99,18,252
685,118,33,150,32,333
686,68,33,99,18,218
687,52,33,99,18,202
688,67,33,150,32,282
694,182,17,68,16,283
695,69,16,99,17,201
696,52,16,99,17,184
697,51,32,101,16,200
698,84,32,198,19,333
700,167,49,64,19,299
701,100,17,184,16,317
703,83,34,66,17,200
704,102,49,64,19,234
705,116,18,64,19,217
706,68,49,64,19,200
707,51,49,64,19,183
711,67,16,150,17,250
712,52,16,150,17,235
713,64,19,117,17,217
714,66,34,100,17,217
715,49,34,100,17,200
716,116,17,68,16,217
717,87,32,68,16,203
718,100,34,99,18,251
720,83,17,99,18,217
721,66,17,99,18,200
722,66,34,133,16,249
723,117,33,101,17,268
725,100,16,101,17,234
726,83,16,101,17,217
728,83,16,167,16,282
729,83,34,100,17,234
730,67,34,100,17,218
731,84,33,67,17,201
732,101,34,233,17,385
733,50,33,67,17,167
736,83,17,83,17,200
737,117,33,134,17,301
738,67,33,133,17,250
740,99,34,332,17,482
743,83,32,68,17,200
744,67,32,68,17,184
745,51,32,68,17,168
747,134,32,84,17,267
748,83,17,133,17,250
749,102,32,84,17,235
750,68,49,84,17,218
751,68,32,84,17,201
752,150,17,99,17,283
753,83,33,51,16,183
754,83,16,51,16,166
755,66,16,51,16,149
756,101,33,133,17,284
758,67,33,133,17,250
759,117,32,67,17,233
760,101,32,67,17,217
762,67,32,67,17,183
763,65,17,67,17,166
764,66,34,134,16,250
765,116,34,83,16,249
767,118,32,51,16,217
771,118,32,68,15,233
772,66,35,266,17,384
773,100,16,68,15,199
774,67,32,68,15,182
775,51,32,68,15,166
776,51,16,68,15,150
777,50,33,100,18,201
778,83,17,99,17,216
779,84,33,66,17,200
780,68,33,66,17,184
781,66,18,66,17,167
782,68,32,51,16,167
783,50,32,51,16,149
785,68,16,84,16,184
786,66,33,51,16,166
787,99,17,68,16,200
788,84,17,68,16,185
790,67,33,51,16,167
791,67,16,51,16,150
792,51,16,51,16,134
793,101,16,133,18,268
794,68,32,133,18,251
795,67,16,133,18,234
797,51,33,100,18,202
798,65,35,115,17,232
799,84,33,66,16,199
801,67,17,66,16,166
802,68,32,101,15,216
804,181,17,100,17,315
805,67,16,67,15,165
806,82,17,66,33,198
809,65,18,217,17,317
810,132,35,83,17,267
811,83,33,118,17,251
812,117,17,83,17,234
813,66,17,118,17,218
815,68,17,83,17,185
816,68,32,68,17,185
817,84,34,134,31,283
818,84,17,134,31,266
819,117,34,182,16,349
820,66,34,165,17,282
822,85,17,182,16,300
823,134,17,65,17,233
824,51,17,182,16,266
825,51,32,150,16,249
826,66,34,65,17,182
828,81,34,67,16,198
829,100,16,67,18,201
831,99,17,100,16,232
832,65,34,100,16,215
833,67,17,100,16,200
834,85,16,67,16,184
835,83,33,50,18,184
836,100,34,99,18,251
837,68,15,50,18,151
838,100,34,65,18,217
839,99,18,65,18,200
842,83,17,151,34,285
844,83,34,66,16,199
847,68,33,67,34,202
848,102,49,117,34,302
849,100,34,117,34,285
850,118,34,66,17,235
851,100,34,66,17,217
852,66,18,117,34,235
853,67,34,66,17,184
855,68,32,51,34,185
856,118,17,166,17,318
857,81,19,84,17,201
858,65,19,84,17,185
859,66,17,166,17,266
860,68,34,66,16,184
862,70,33,133,17,253
863,84,33,66,17,200
864,67,33,66,17,183
866,66,34,83,16,199
867,116,34,65,19,234
868,82,17,51,16,166
869,65,17,51,16,149
871,67,17,65,19,168
872,66,33,67,17,183
875,101,16,66,17,200
876,65,19,82,17,183
877,67,16,66,17,166
879,67,17,100,16,200
881,82,34,82,18,216
882,83,17,82,18,200
883,100,17,116,17,250
886,68,48,68,17,201
889,65,18,67,17,167
890,66,34,84,14,198
893,102,16,66,17,201
894,84,16,66,17,183
895,83,32,101,16,232
897,68,14,101,16,199
901,81,17,68,32,198
902,67,17,68,32,184
903,84,33,151,15,283
904,83,17,151,15,266
906,117,18,65,18,218
907,68,32,166,17,283
908,83,18,65,18,184
911,66,17,50,15,148
912,84,34,65,17,200
913,67,34,65,17,183
914,65,18,65,17,165
915,67,15,133,18,233
917,83,33,100,18,234
918,67,33,100,18,218
919,65,17,100,18,200
920,67,34,133,17,251
922,67,50,83,17,217
924,66,18,83,17,184
925,67,16,67,17,167
926,66,34,67,16,183
928,52,16,67,16,151
929,83,34,133,16,266
930,67,34,133,16,250
931,66,17,133,16,232
935,50,34,82,17,183
936,99,34,234,16,383
937,100,17,234,16,367
938,66,34,234,16,350
939,83,33,67,17,200
942,104,30,67,17,218
943,67,20,97,17,201
946,100,34,134,33,301
948,63,34,134,33,264
949,50,34,134,33,251
950,67,32,68,17,184
951,50,32,68,17,167
953,101,17,117,32,267
954,83,17,117,32,249
956,51,17,117,32,217
957,100,18,65,17,200
958,67,33,65,17,182
960,99,50,83,18,250
962,65,50,83,18,216
963,68,32,83,18,201
964,65,17,83,18,183
965,65,17,66,18,166
967,83,32,69,15,199
969,51,32,69,15,167
970,100,35,65,17,217
975,51,33,165,17,266
976,68,32,294,6,400
977,84,33,202,16,335
978,82,16,202,16,316
979,183,34,68,16,301
982,51,17,116,17,201
983,84,32,51,17,184
986,65,34,68,16,183
987,65,17,68,16,166
988,83,17,65,28,193
989,66,17,65,28,176
991,51,34,99,16,200
993,67,15,68,16,166
995,50,34,67,17,168
997,66,17,67,16,166
999,56,17,67,17,157
1000,67,34,66,17,184
1001,117,33,66,17,233
1002,67,33,67,16,183
1003,51,33,67,16,167
1004,67,33,66,17,183
1005,83,34,65,19,201
1006,100,49,100,16,265
1007,100,33,100,16,249
1008,67,49,100,16,232
1009,115,19,183,17,334
1011,82,19,183,17,301
1012,65,19,183,17,284
1013,68,15,66,18,167
1014,100,17,118,17,252
1017,99,17,67,17,200
1018,66,35,67,17,185
1019,68,17,67,17,169
1020,83,35,83,16,217
1021,83,18,83,16,200
1025,69,15,167,16,267
1026,52,15,167,16,250
1030,84,16,67,16,183
1031,68,16,67,16,167
1033,68,33,100,17,218
1034,52,33,100,17,202
1035,83,33,101,17,234
1036,117,16,68,17,218
1038,118,17,64,19,218
1039,100,17,64,19,200
1040,66,35,64,19,184
1042,51,17,64,19,151
1044,68,50,66,16,200
1046,64,19,66,16,165
1047,134,16,67,17,234
1048,66,33,100,17,216
1051,133,16,67,17,233
1052,66,34,50,17,167
1054,84,16,67,17,184
1055,100,17,66,17,200
1056,84,17,66,17,184
1057,67,17,66,17,167
1058,100,33,101,17,251
1059,50,33,134,17,234
1060,100,34,133,17,284
1061,83,34,133,17,267
1062,117,17,65,17,216
1063,49,34,133,17,233
1065,84,33,166,16,299
1066,133,34,66,18,251
1067,84,32,134,16,266
1069,133,17,66,16,232
1070,65,34,66,18,183
1071,66,17,66,18,167
1072,66,34,66,16,182
1073,83,32,68,15,198
1074,51,17,66,16,150
1075,51,32,68,15,166
1076,66,34,67,17,184
1077,83,34,116,18,251
1081,50,33,233,16,332
1082,67,34,133,17,251
1083,85,33,166,16,300
1084,67,33,166,16,282
1086,67,34,99,16,216
1087,66,18,99,16,199
1088,133,33,66,17,249
1089,52,33,66,16,167
1090,67,33,66,16,182
1095,65,17,84,15,181
1096,66,33,116,17,232
1097,82,35,149,17,283
1098,66,35,149,17,267
1100,68,31,219,15,333
1101,52,31,219,15,317
1102,99,17,68,17,201
1103,66,33,68,17,184
1105,65,17,133,19,234
1106,84,17,166,17,284
1109,51,34,166,17,268
1111,135,15,67,17,234
1112,84,15,67,17,183
1113,101,15,67,17,200
1114,65,34,67,17,183
1117,116,49,151,17,333
1118,84,17,66,18,185
1119,82,49,151,17,299
1120,84,32,151,17,284
1121,67,32,151,17,267
1122,83,17,134,17,251
1124,66,51,151,15,283
1125,67,33,151,15,266
1126,52,33,151,15,251
1129,67,16,67,15,165
1131,83,34,65,17,199
1132,66,34,65,17,182
1133,98,19,116,17,250
1134,101,48,85,15,249
1135,66,19,116,17,218
1136,99,17,85,15,216
1137,82,17,85,15,199
1138,82,33,84,17,216
1140,64,17,84,17,182
1141,66,18,133,16,233
1143,51,34,99,16,200
1144,69,32,134,16,251
1147,66,34,83,16,199
1148,83,16,200,17,316
1150,67,33,101,17,218
1151,66,17,101,17,201
1155,51,33,67,16,167
1156,67,34,66,17,184
1159,151,33,65,17,266
1160,67,33,167,17,284
1161,50,33,167,17,267
1162,66,34,98,17,215
1163,83,33,65,17,198
1166,50,17,65,17,149
1167,50,34,117,15,216
1168,115,18,66,17,216
1169,67,32,69,15,183
1170,82,18,66,17,183
1172,83,17,66,17,183
1173,67,17,66,17,167
1175,168,16,68,33,285
1176,66,34,66,17,183
1177,133,16,68,33,250
1178,66,50,117,16,249
1180,84,16,68,33,201
1182,83,17,67,16,183
1183,66,17,67,16,166
1186,68,33,65,18,184
1188,67,33,66,17,183
1189,84,50,217,17,368
1192,65,18,217,17,317
1193,67,16,201,17,301
1194,66,34,167,17,284
1196,51,17,167,17,252
1197,67,16,67,16,166
1198,167,34,67,16,284
1199,67,16,50,17,150
1200,83,17,67,17,184
1202,83,17,67,17,184
1204,67,34,67,16,184
1206,84,16,116,17,233
1207,68,16,116,17,217
1210,67,32,50,17,166
1212,99,34,167,16,316
1213,99,17,167,16,299
1214,65,34,167,16,282
1216,50,17,167,16,250
1218,67,51,333,16,467
1219,67,34,333,16,450
1220,100,34,99,17,250
1221,67,16,67,16,166
1222,84,17,99,17,217
1224,51,17,99,17,184
1225,115,34,200,17,366
1226,99,34,200,17,350
1227,66,16,51,18,151
1228,99,35,64,17,215
1229,66,17,200,17,300
1230,66,35,64,17,182
1233,100,33,150,17,300
1234,67,49,150,17,283
1236,165,34,167,16,382
1237,65,18,66,17,166
1238,67,32,168,17,284
1239,51,32,168,17,268
1241,84,34,167,16,301
1243,66,17,167,16,266
1245,82,34,139,13,268
1246,83,17,139,13,252
1247,83,34,67,16,200
1249,151,38,111,17,317
1250,68,32,73,13,186
1251,51,32,73,13,169
1254,67,38,111,17,233
1255,50,38,111,17,216
1256,151,17,67,33,268
1258,51,32,83,17,183
1260,62,33,67,33,195
1261,82,33,166,17,298
1263,66,17,166,17,266
1264,66,34,98,19,217
1266,50,17,98,19,184
1267,51,33,65,19,168
1269,84,50,98,17,249
1270,67,50,98,17,232
1273,83,17,83,17,200
1274,65,17,83,17,182
1275,117,32,100,18,267
1276,134,35,65,18,252
1277,83,32,100,18,233
1278,68,32,100,18,218
1279,51,32,100,18,201
1280,66,35,65,18,184
1282,67,32,133,17,249
1283,69,15,133,17,234
1284,100,34,66,17,217
1286,65,34,66,17,182
1289,68,17,116,16,217
1293,66,17,100,17,200
1294,83,16,101,16,216
1295,67,16,101,16,200
1296,67,33,167,17,284
1297,67,16,167,17,267
1298,83,17,67,17,184
1299,83,34,184,16,317
1301,67,17,184,16,284
1303,84,34,65,17,200
1305,84,32,67,18,201
1307,51,32,67,18,168
1308,66,33,52,16,167
1310,82,17,84,32,215
1313,68,16,133,17,234
1314,85,16,66,17,184
1315,68,16,66,17,167
1316,84,32,84,17,217
1317,66,32,84,17,199
1321,66,17,133,17,233
1322,101,34,66,17,218
1323,68,16,233,17,334
1324,51,16,233,17,317
1325,118,32,84,16,250
1327,84,32,84,16,216
1328,68,32,84,16,200
1329,51,32,84,16,183
1331,116,34,67,17,234
1332,98,34,67,17,216
1333,82,34,67,17,200
1334,66,34,67,17,184
1335,133,17,66,17,233
1336,51,16,67,17,151
1337,68,16,67,17,168
1338,67,34,66,17,184
1339,83,33,99,18,233
1340,67,33,99,18,217
1343,67,16,66,18,167
1344,99,33,52,15,199
1345,133,17,67,16,233
1346,66,33,52,15,166
1348,51,15,52,15,133
1349,101,15,201,16,333
1350,85,15,201,16,317
1351,67,15,201,16,299
1352,52,15,201,16,284
1353,84,49,150,17,300
1356,117,17,67,16,217
1357,116,33,67,17,233
1358,63,19,84,16,182
1359,83,33,67,17,200
1360,101,34,100,16,251
1361,66,17,67,17,167
1363,50,34,100,16,200
1364,67,33,101,16,217
1365,51,33,101,16,201
1366,67,34,200,16,317
1369,217,34,66,34,351
1370,150,17,199,17,383
1371,84,33,66,16,199
1372,67,33,66,16,182
1373,67,17,66,16,166
1375,101,16,67,17,201
1376,99,34,66,34,233
1379,84,33,67,16,200
1380,67,33,67,16,183
1381,83,33,66,17,199
1382,67,33,66,17,183
1384,66,34,166,16,282
1385,84,32,100,18,234
1386,67,32,100,18,217
1387,50,32,100,18,200
1388,100,33,67,16,216
1389,50,34,66,18,168
1390,66,33,67,16,182
1391,83,33,201,16,333
1392,118,16,100,17,251
1394,133,33,51,16,233
1395,99,17,84,16,216
1396,100,33,51,16,200
1397,99,16,51,16,182
1398,67,33,51,16,167
1400,66,34,67,16,183
1402,84,16,101,16,217
1404,67,34,100,17,218
1405,68,16,100,17,201
1406,67,33,101,15,216
1407,133,17,300,17,467
1409,83,33,300,17,433
1413,84,32,167,16,299
1414,67,32,167,16,282
1416,83,17,334,16,450
1417,66,17,334,16,433
1419,84,33,67,16,200
1420,83,17,67,16,183
1422,99,34,232,19,384
1423,83,34,232,19,368
1425,84,33,135,15,267
1426,67,33,135,15,250
1427,101,17,134,16,268
1430,84,17,67,15,183
1431,68,17,67,15,167
1434,84,17,64,19,184
1435,133,34,82,17,266
1436,67,33,132,17,249
1437,84,50,82,17,233
1438,84,34,82,17,217
1439,66,34,82,17,199
1440,83,15,101,17,216
1441,68,15,101,17,201
1442,82,17,67,17,183
1443,100,16,118,16,250
1446,67,34,100,17,218
1447,84,34,83,16,217
1448,84,17,83,16,200
1449,150,33,99,18,300
1451,51,32,51,16,150
1453,67,16,66,17,166
1456,83,17,66,18,184
1457,115,33,102,15,265
1458,83,16,51,16,166
1459,82,33,102,15,232
1460,66,33,102,15,216
1461,67,16,102,15,200
1462,66,34,68,15,183
1463,67,16,68,15,166
1465,83,35,133,16,267
1466,67,35,133,16,251
1467,66,18,133,16,233
1469,117,34,65,18,234
1471,84,34,65,18,201
1472,66,34,65,18,183
1476,67,50,82,18,217
1477,67,34,82,18,201
1479,68,17,65,18,168
1480,50,17,65,18,150
1481,51,33,50,17,151
1482,135,32,101,16,284
1483,66,16,101,32,215
1484,83,17,98,18,216
1486,67,32,101,16,216
1487,149,35,66,34,284
1488,101,32,101,34,268
1491,51,32,101,34,218
1492,66,35,66,34,201
1494,67,33,99,17,216
1495,53,33,99,17,202
1496,51,17,99,17,184
1498,66,34,133,17,250
1500,67,32,135,15,249
1501,83,34,167,17,301
1502,66,34,167,17,284
1504,66,34,67,15,182
1505,85,33,117,33,268
1508,67,34,83,33,217
1509,84,32,51,33,200
1510,67,32,51,33,183
1511,51,32,51,33,167
1512,100,50,149,18,317
1513,83,50,149,18,300
1514,149,17,51,31,248
1515,68,33,149,18,268
1516,51,33,149,18,251
1518,65,18,52,16,151
1519,66,17,51,31,165
1520,103,47,68,17,235
1521,85,47,68,17,217
1522,70,47,68,17,202
1525,101,33,82,19,235
1526,64,51,82,19,216
1527,99,17,150,15,281
1528,52,33,82,19,186
1529,118,51,66,15,250
1531,66,17,117,15,215
1532,100,19,66,15,200
1533,82,19,66,15,182
1535,100,34,83,16,233
1536,51,15,51,15,132
1538,51,34,83,16,184
1540,51,15,68,16,150
1541,100,17,100,17,234
1542,101,34,165,17,317
1543,66,17,100,17,200
1544,134,34,66,16,250
1545,84,32,67,16,199
1546,67,32,67,16,182
1547,134,16,66,17,233
1548,66,34,66,16,182
1549,50,34,66,16,166
1550,83,16,66,17,182
1552,67,33,202,16,318
1553,50,33,202,16,301
1554,66,33,151,18,268
1556,83,17,135,16,251
1557,135,15,200,17,367
1558,67,34,83,18,202
1559,68,17,83,18,186
1560,85,15,200,17,317
1561,134,18,198,16,366
1562,51,15,200,17,283
1564,83,18,198,16,315
1565,66,18,198,16,298
1567,82,17,302,15,416
1569,66,17,66,17,166
1570,131,34,67,17,249
1573,83,34,67,17,201
1574,100,33,133,19,285
1575,66,17,67,17,167
1576,50,17,67,17,151
1577,100,18,66,18,202
1578,51,16,133,19,219
1580,133,33,67,17,250
1581,116,33,67,17,233
1583,117,34,66,17,234
1586,65,34,66,17,182
1587,184,50,101,15,350
1588,150,17,133,18,318
1589,66,16,99,18,199
1590,67,33,167,18,285
1591,65,16,167,18,266
1592,66,34,133,18,251
1593,83,50,101,15,249
1594,67,50,101,15,233
1595,100,16,135,17,268
1596,84,16,135,17,252
1598,50,16,135,17,218
1599,66,16,102,17,201
1600,101,33,133,18,285
1602,67,33,133,18,251
1604,84,18,98,18,218
1607,99,16,51,34,200
1608,52,15,118,15,200
1609,116,52,65,17,250
1610,65,33,52,15,165
1611,81,52,65,17,215
1614,51,34,65,17,167
1616,84,17,117,17,235
1619,248,35,232,17,532
1621,117,34,65,17,233
1623,67,17,134,33,251
1624,67,34,65,17,183
1625,50,34,65,17,166
1626,133,35,232,17,417
1627,67,16,101,17,201
1629,82,35,232,17,366
1630,65,35,232,17,349
1632,68,33,66,16,183
1633,101,17,99,16,233
1634,85,17,99,16,217
1635,68,17,99,16,200
1636,50,17,99,16,182
1641,84,33,133,17,267
1642,83,17,133,17,250
1643,67,17,133,17,234
1644,66,33,67,16,182
1645,149,33,69,31,282
1646,66,34,135,31,266
1647,67,17,135,31,250
1648,100,33,69,31,233
1651,66,17,69,31,183
1652,66,34,66,17,183
1653,100,18,98,18,234
1654,50,17,66,17,150
1655,117,34,51,16,218
1657,133,17,101,17,268
1658,66,34,51,16,167
1659,66,17,51,16,150
1660,65,33,101,17,216
1661,84,34,183,17,318
1662,101,34,65,18,218
1664,51,16,183,17,267
1665,51,34,65,18,168
1667,83,50,66,17,216
1668,99,18,66,17,200
1670,65,18,66,17,166
1671,67,17,66,17,167
1672,67,32,100,33,232
1674,51,16,100,33,200
1675,100,15,118,17,250
1676,83,15,118,17,233
1677,67,15,118,17,217
1679,83,49,86,16,234
1680,99,16,86,16,217
1681,133,17,100,16,266
1682,135,34,99,16,284
1683,101,17,100,16,234
1684,151,17,166,32,366
1685,68,17,100,16,201
1686,135,33,100,33,301
1689,67,17,166,32,282
1691,85,33,67,33,218
1693,83,34,66,32,215
1694,100,33,65,18,216
1695,84,33,65,18,200
1696,67,33,65,18,183
1697,51,33,65,18,167
1698,100,50,66,17,233
1700,98,18,66,17,199
1701,65,35,66,17,183
1702,132,34,66,17,249
1703,84,33,51,17,185
1705,84,34,66,17,201
1707,66,17,66,17,166
1708,67,34,199,17,317
1709,51,34,199,17,301
1710,134,33,117,17,301
1711,51,32,67,16,166
1712,66,34,200,16,316
1713,66,17,200,16,299
1714,66,33,117,17,233
1715,84,34,166,16,300
1716,67,34,166,16,283
1718,67,33,166,17,283
1721,67,17,301,17,402
1722,117,16,99,17,249
1724,100,33,66,17,216
1727,66,17,66,17,166
1728,82,17,100,17,216
1729,82,33,103,15,233
1731,67,16,103,15,201
1732,66,35,68,15,184
1733,85,32,101,32,250
1734,117,19,132,15,283
1735,151,33,67,15,266
1736,84,19,132,15,250
1737,67,19,132,15,233
1738,68,32,65,17,182
1739,117,32,67,17,233
1740,68,33,67,15,183
1741,84,32,67,17,200
1742,97,35,267,15,414
1743,50,32,67,17,166
1744,100,32,67,17,216
1746,67,32,67,17,183
1748,101,33,100,17,251
1749,84,33,100,17,234
1751,118,51,66,17,252
1752,67,34,117,17,235
1753,67,17,117,17,218
1754,67,51,66,17,201
1756,85,15,68,15,183
1757,151,32,66,17,266
1758,83,17,132,17,249
1759,100,17,69,13,199
1760,51,17,132,17,217
1761,115,37,80,17,249
1764,66,37,80,17,200
1765,66,20,80,17,183
1766,69,46,51,17,183
1767,100,18,66,17,201
1768,66,17,51,17,151
1770,80,17,233,17,347
1771,67,17,233,17,334
1772,68,33,100,18,219
1774,83,18,149,16,266
1776,115,18,184,15,332
1777,150,50,115,18,333
1778,100,34,66,17,217
1779,83,34,66,17,200
1780,199,33,68,33,333
1781,50,34,66,17,167
1782,117,16,84,15,232
1783,102,16,84,15,217
1785,99,17,101,33,250
1788,68,33,68,33,202
1789,115,36,98,17,266
1790,84,15,101,17,217
1791,67,15,101,17,200
1794,217,15,201,17,450
1795,65,19,99,17,200
1796,69,32,67,17,185
1797,51,32,67,17,167
1798,65,33,134,16,248
1799,51,33,134,16,234
1800,65,34,133,16,248
1803,67,15,201,17,300
1804,83,19,65,16,183
1805,99,18,66,17,200
1807,65,18,66,17,166
1808,68,33,67,16,184
1810,98,34,116,17,265
1811,84,34,116,17,251
1812,66,34,116,17,233
1813,67,17,116,17,217
1814,67,33,83,17,200
1817,67,16,67,18,168
1819,83,34,168,16,301
1821,66,17,168,16,267
1822,133,18,84,16,251
1823,135,15,69,16,235
1825,101,15,69,16,201
1826,66,18,84,16,184
1827,66,15,69,16,166
1828,84,17,84,32,217
1829,85,34,50,32,201
1833,67,34,116,17,234
1834,167,33,66,17,283
1835,68,32,66,18,184
1837,66,18,66,17,167
1839,83,33,66,17,199
1840,84,18,66,17,185
1842,115,17,67,16,215
1845,101,17,66,17,201
1846,66,34,66,17,183
1847,66,17,66,17,166
1848,84,17,69,31,201
1849,67,17,69,31,184
1850,67,33,67,16,183
1851,119,31,66,17,233
1852,66,36,64,16,182
1853,50,36,64,16,166
1854,69,31,66,17,183
1857,66,17,101,17,201
1858,64,33,68,17,182
1860,100,34,166,16,316
1861,135,15,134,16,300
1862,101,32,134,16,283
1863,68,17,166,16,267
1864,168,32,67,16,283
1866,83,17,235,17,352
1867,66,17,235,17,335
1868,66,34,66,16,182
1869,65,18,66,16,165
1870,100,34,68,15,217
1873,117,35,67,17,236
1874,66,33,67,17,183
1876,102,32,52,14,200
1877,66,19,67,17,169
1878,117,18,64,18,217
1879,52,32,52,14,150
1880,102,31,66,17,216
1881,103,14,66,17,200
1882,67,31,66,17,181
1883,52,31,66,17,166
1885,68,14,85,33,200
1886,82,15,85,15,197
1887,65,15,85,15,180
1888,184,33,116,17,350
1891,67,33,149,18,267
1893,68,15,67,17,167
1894,51,15,67,17,150
1897,99,17,100,17,233
1898,67,34,100,17,218
1899,66,17,100,17,200
1900,51,17,100,17,185
1901,83,33,250,18,384
1902,85,15,250,18,368
1903,68,15,250,18,351
1904,83,17,216,18,334
1905,66,17,216,18,317
1906,67,33,434,16,550
1907,66,16,434,16,532
1911,83,50,149,17,299
1912,85,32,149,17,283
1913,99,16,68,16,199
1914,168,33,166,17,384
1915,66,16,68,16,166
1916,150,17,166,17,350
1919,117,49,67,17,250
1922,67,49,67,17,200
1923,100,17,67,17,201
1924,65,17,67,17,166
1925,83,34,66,17,200
1926,83,17,66,17,183
1927,99,17,100,16,232
1928,84,17,100,16,217
1929,67,17,100,16,200
1930,67,33,67,16,183
1932,66,34,99,17,216
1935,66,17,66,17,166
1936,102,31,268,16,417
1939,52,31,268,16,367
1940,83,17,100,17,217
1942,65,33,67,17,182
1943,82,34,67,33,216
1944,118,16,166,18,318
1946,67,33,166,18,284
1947,84,34,100,16,234
1948,84,17,100,16,217
1951,50,33,117,16,216
1954,116,34,82,18,250
1955,52,33,50,16,151
1956,67,50,82,18,217
1957,67,34,82,18,201
1958,148,35,66,16,265
1959,149,18,66,16,249
1960,50,16,84,16,166
1961,83,51,66,16,216
1963,65,35,66,16,182
1964,66,18,66,16,166
1966,51,16,301,16,384
1967,84,33,51,32,200
1968,84,16,51,32,183
1969,66,16,51,32,165
1973,67,32,84,17,200
1976,84,17,66,16,183
1978,52,17,66,16,151
1979,118,34,98,18,268
1980,100,34,98,18,250
1982,100,33,184,16,333
1983,84,33,184,16,317
1984,101,33,167,18,319
1985,117,50,184,33,384
1987,84,50,184,33,351
1989,67,33,184,33,317
1991,83,34,116,18,251
1992,234,33,100,16,383
1993,83,51,65,18,217
1994,68,51,65,18,202
1995,135,14,68,17,234
2000,104,33,100,16,253
2001,148,35,67,15,265
2002,67,33,100,16,216
2003,64,18,100,16,198
2005,51,32,235,16,334
2006,65,35,67,15,182
2007,101,17,116,16,250
2008,83,17,116,16,232
2013,84,32,68,16,200
2014,67,32,68,16,183
2015,51,32,68,16,167
2016,65,33,68,33,199
2018,83,17,100,17,217
2019,149,34,299,18,500
2020,68,33,67,17,185
2021,67,17,67,17,168
2022,68,33,200,17,318
2023,50,33,200,17,300
2025,132,17,168,15,332
2026,67,33,133,17,250
2027,117,35,99,18,269
2028,67,32,168,15,282
2029,65,17,168,15,265
2030,81,19,99,18,217
2031,83,33,66,18,200
2032,67,33,66,18,184
2033,85,33,67,15,200
2034,85,16,67,15,183
2035,85,33,167,17,302
2037,102,16,84,15,217
2039,67,16,84,15,182
2041,84,32,67,17,200
2042,83,17,67,17,184
2043,166,17,165,18,366
2044,133,34,165,18,350
2045,84,34,66,17,201
2046,65,34,66,17,182
2047,101,17,165,18,301
2048,84,17,165,18,284
2049,66,17,165,18,266
2050,68,32,66,19,185
2052,66,33,168,17,284
2054,198,18,66,17,299
2055,67,15,67,18,167
2056,133,51,66,17,267
2057,134,33,66,17,250
2058,69,31,117,17,234
2059,65,17,117,17,216
2060,67,51,66,17,201
2061,81,18,66,17,182
2062,64,18,66,17,165
2063,68,17,132,18,235
2065,67,32,83,18,200
2066,84,17,84,33,218
2068,83,16,101,16,216
2069,66,16,101,16,199
2070,85,15,134,17,251
2072,84,33,100,17,234
2074,51,33,100,17,201
2077,66,17,332,35,450
2079,83,34,133,34,284
2080,66,34,133,34,267
2081,120,29,68,34,251
2082,83,20,64,33,200
2083,86,29,68,34,217
2085,53,29,68,34,184
2086,65,35,67,16,183
2087,84,33,233,16,366
2088,131,32,66,35,264
2089,52,33,233,16,334
2091,85,32,66,35,218
2092,67,32,66,35,200
2093,84,34,84,15,217
2095,85,32,134,18,269
2098,51,15,134,18,218
2099,66,18,66,16,166
2100,67,32,67,18,184
2101,67,15,67,18,167
2102,101,33,151,17,302
2103,84,33,151,17,285
2104,82,17,151,17,267
2106,67,34,167,17,285
2108,67,34,83,17,201
2109,51,34,83,17,185
2110,83,35,67,16,201
2111,81,19,67,16,183
2112,65,19,67,16,167
2113,83,34,316,33,466
2114,66,34,316,33,449
2115,68,17,316,33,434
2116,86,16,65,19,186
2119,134,15,68,16,233
2120,98,19,83,16,216
2121,100,15,68,16,199
2122,65,19,83,16,183
2124,52,15,68,16,151
2125,68,16,99,17,200
2126,102,33,83,33,251
2127,99,17,83,33,232
2128,167,50,67,16,300
2129,98,17,283,17,415
2130,133,50,67,16,266
2131,99,17,50,17,183
2132,82,17,50,17,166
2133,66,17,50,17,150
2134,66,50,67,16,199
2136,84,17,66,17,184
2137,67,17,66,17,167
2138,133,50,83,17,283
2139,67,16,100,17,200
2140,151,17,134,15,317
2141,67,16,116,17,216
2142,83,33,83,17,216
2144,50,33,83,17,183
2145,83,34,66,17,200
2146,67,34,66,17,184
2147,150,34,99,16,299
2148,52,17,66,17,152
2150,66,34,166,17,283
2151,117,32,167,17,333
2153,51,34,99,16,200
2155,133,17,67,16,233
2157,83,33,67,16,199
2158,66,33,67,16,182
2159,67,17,67,16,167
2160,100,34,101,16,251
2162,83,17,101,16,217
2165,67,17,68,16,168
2166,67,33,133,35,268
2169,85,33,100,16,234
2171,51,33,100,16,200
2172,68,47,53,16,184
2173,51,47,53,16,167
2174,182,17,66,17,282
2175,82,35,66,17,200
2178,118,17,66,17,218
2179,102,17,66,17,202
2180,51,33,83,17,184
2181,101,16,100,17,234
2182,83,16,100,17,216
2183,99,17,67,17,200
2185,66,17,67,17,167
2186,83,18,66,17,184
2187,66,18,66,17,167
2188,50,18,66,17,151
2189,118,34,82,17,251
2190,118,17,82,17,234
2191,101,17,82,17,217
2192,83,17,82,17,199
2195,51,32,167,18,268
2196,66,34,99,17,216
2198,66,33,467,16,582
2199,51,33,467,16,567
2201,83,33,367,17,500
2203,83,34,51,33,201
2205,102,33,83,17,235
2206,67,51,83,17,218
2207,68,33,83,17,201
2211,116,32,100,17,265
2212,52,15,101,17,185
2213,83,32,100,17,232
2214,68,32,100,17,217
2215,67,15,100,17,199
2216,118,17,66,16,217
2217,67,16,133,17,233
2218,83,17,66,16,182
2219,66,17,66,16,165
2221,82,34,134,17,267
2222,83,17,134,17,251
2223,184,33,132,35,384
2224,66,33,68,33,200
2225,66,17,68,33,184
2228,101,33,132,35,301
2229,85,33,132,35,285
2230,68,33,132,35,268
2233,83,35,100,15,233
2234,83,17,100,15,215
2236,115,17,100,34,266
2237,68,15,99,16,198
2238,53,15,99,16,183
2240,100,32,67,18,217
2241,82,32,67,18,199
2243,52,32,67,18,169
2245,136,15,83,17,251
2246,65,34,200,16,315
2247,84,33,83,17,217
2248,67,33,83,17,200
2249,69,15,83,17,184
2250,52,15,83,17,167
2251,84,50,84,16,234
2252,66,50,84,16,216
2253,66,32,84,16,198
2255,66,17,67,16,166
2256,83,18,84,15,200
2257,116,51,98,18,283
2259,84,51,98,18,251
2261,102,15,101,17,235
2265,71,13,67,17,168
2266,68,34,167,15,284
2268,68,33,117,17,235
2270,67,50,67,17,201
2273,68,17,99,16,200
2274,100,34,150,32,316
2275,66,17,66,16,165
2276,102,32,68,17,219
2277,67,17,150,32,266
2278,67,32,68,17,184
2279,51,32,68,17,168
2280,82,33,69,32,216
2281,82,16,69,32,199
2282,100,32,67,17,216
2283,85,32,67,17,201
2284,68,32,67,17,184
2285,69,15,67,17,168
2286,52,15,67,17,151
2287,69,32,83,17,201
2289,65,17,66,17,165
2290,133,34,133,17,317
2291,66,16,67,33,182
2292,51,16,67,33,167
2293,100,17,133,17,267
2294,100,33,68,16,217
2296,67,33,68,16,184
2298,84,17,66,17,184
2299,67,17,66,17,167
2300,83,18,66,32,199
2302,149,17,133,18,317
2303,51,32,101,33,217
2305,116,35,98,18,267
2306,115,18,98,18,249
2307,82,35,98,18,233
2308,66,35,98,18,217
2309,84,33,149,18,284
2311,52,33,149,18,252
2314,83,33,116,17,249
2315,68,33,116,17,234
2316,65,18,116,17,216
2317,101,16,66,17,200
2318,84,16,66,17,183
2319,67,16,66,17,166
2320,117,17,151,16,301
2321,84,32,151,16,283
2322,84,17,151,16,268
2323,65,17,151,16,249
2324,66,34,70,13,183
2325,84,34,133,33,284
2326,100,36,163,16,315
2327,51,34,133,33,251
2330,100,33,67,33,233
2331,66,17,182,17,282
2333,66,16,67,33,182
2335,67,17,132,17,233
2336,67,33,82,17,199
2337,116,49,85,16,266
2338,83,17,66,17,183
2340,66,49,85,16,216
2341,84,16,85,16,201
2342,99,50,67,17,233
2343,66,17,267,17,367
2344,66,50,67,17,200
2345,50,50,67,17,184
2347,67,18,117,17,219
2348,68,33,200,16,317
2349,135,15,134,16,300
2350,51,17,200,16,284
2353,68,15,134,16,233
2356,51,17,65,17,150
2357,115,34,134,16,299
2358,100,34,134,16,284
2360,65,34,134,16,249
2362,82,18,133,17,250
2364,150,18,99,16,283
2365,67,16,135,16,234
2366,83,17,67,17,184
2367,67,17,67,17,168
2368,100,33,66,16,215
2369,66,18,99,16,199
2371,67,17,66,16,166
2372,50,17,66,16,149
2373,101,16,67,16,200
2374,99,33,101,17,250
2375,67,16,67,16,166
2377,82,34,166,17,299
2378,65,34,166,17,282
2379,83,33,51,16,183
2381,51,33,51,16,151
2382,85,16,68,14,183
2383,68,16,68,14,166
2384,67,33,66,17,183
2385,68,16,66,17,167
2388,116,17,70,13,216
2389,116,33,67,17,233
2390,66,34,70,13,183
2391,116,37,130,17,300
2393,67,17,67,17,168
2394,104,30,100,17,251
2395,87,30,100,17,234
2397,101,17,66,17,201
2398,101,33,50,17,201
2399,100,16,50,17,183
2400,64,33,50,17,164
2401,84,33,99,17,233
2402,84,16,99,17,216
2403,83,34,167,16,300
2404,66,34,167,16,283
2405,116,49,50,17,232
2407,132,17,68,16,233
2408,67,49,50,17,183
2409,67,32,50,17,166
2410,82,17,68,16,183
2412,134,32,67,16,249
2414,67,35,66,16,184
2415,117,34,133,16,300
2416,68,32,67,16,183
2417,83,34,133,16,266
2418,101,33,100,16,250
2419,67,17,133,16,233
2420,82,17,100,16,215
2422,101,49,101,15,266
2425,83,17,101,15,216
2426,66,17,101,15,199
2427,67,17,84,15,183
2428,82,17,51,15,165
2429,65,17,51,15,148
2430,50,17,51,15,133
2431,66,35,182,34,317
2432,84,15,67,17,183
2434,84,17,265,17,383
2435,68,17,265,17,367
2439,83,50,250,19,402
2440,66,50,250,19,385
2441,67,34,250,19,370
2442,84,16,133,17,250
2444,66,34,83,16,199
2445,102,16,65,17,200
2446,68,34,65,17,184
2450,99,34,201,17,351
2451,98,17,201,17,333
2452,65,34,201,17,317
2453,66,17,201,17,301
2454,67,34,52,14,167
2456,68,33,83,17,201
2457,133,17,167,16,333
2458,185,16,66,17,284
2460,52,14,200,16,282
2461,83,34,133,16,266
2462,66,34,133,16,249
2463,64,17,133,16,230
2465,51,34,66,17,168
2469,82,33,67,16,198
2470,66,33,67,16,182
2473,99,18,149,17,283
2474,82,18,149,17,266
2477,51,33,68,33,185
2478,85,33,132,17,267
2479,69,33,132,17,251
2480,51,33,132,17,233
2481,68,17,65,17,167
2482,82,19,82,17,200
2483,83,32,67,17,199
2484,134,33,200,16,383
2485,82,34,99,17,232
2486,115,17,200,16,348
2487,51,34,99,17,201
2488,99,34,166,16,315
2489,101,17,166,16,300
2491,100,16,69,15,200
2492,50,17,166,16,249
2493,67,16,69,15,167
2495,101,17,65,16,199
2496,84,17,65,16,182
2497,68,17,65,16,166
2502,65,33,100,17,215
2503,83,33,101,16,233
2505,66,17,101,16,200
2508,100,34,84,17,235
2510,67,34,84,17,202
2511,67,17,84,17,185
2512,82,18,133,17,250
2514,100,18,100,32,250
2515,101,17,83,32,233
2516,84,17,83,32,216
2518,82,17,104,30,233
2519,52,32,104,30,218
2520,50,17,104,30,201
2523,51,49,401,17,518
2524,51,32,401,17,501
2525,88,30,116,18,252
2526,70,30,116,18,234
2527,53,30,116,18,217
2531,102,16,100,17,235
2532,83,16,100,17,216
2534,51,16,100,17,184
2536,183,17,266,17,483
2537,66,17,84,17,184
2538,151,17,266,17,451
2540,82,18,99,17,216
2541,151,33,67,17,268
2542,84,17,266,17,384
2543,67,17,266,17,367
2544,68,33,100,17,218
2547,65,18,67,17,167
2549,118,32,101,17,268
2550,50,17,134,15,216
2552,134,34,215,34,417
2553,67,15,101,17,200
2554,100,34,215,34,383
2555,85,34,215,34,368
2556,67,34,215,34,350
2557,66,18,215,34,333
2559,52,32,66,17,167
2560,66,34,66,17,183
2561,67,17,66,17,167
2562,82,16,117,34,249
2563,100,17,117,32,266
2564,83,17,117,32,249
2566,66,34,83,32,215
2567,67,17,83,32,199
2572,83,32,51,16,182
2573,67,32,51,16,166
2574,117,16,117,17,267
2575,234,17,200,16,467
2577,67,16,117,17,217
2578,68,51,66,17,202
2579,83,19,66,17,185
2581,67,16,67,16,166
2583,68,17,98,17,200
2584,85,17,200,16,318
2586,100,49,184,18,351
2587,66,17,167,16,266
2588,115,35,65,18,233
2590,65,17,184,18,284
2591,66,35,65,18,184
2592,84,16,100,16,216
2593,100,17,67,16,200
2594,52,16,100,16,184
2595,84,34,66,18,202
2596,68,34,66,18,186
2597,116,33,50,34,233
2600,83,17,50,34,184
2602,66,34,133,32,265
2603,68,16,133,32,249
2605,67,34,65,18,184
2606,99,35,99,34,267
2607,99,17,99,34,249
2608,100,33,167,33,333
2609,67,17,99,34,217
2611,50,33,167,33,283
2612,83,17,101,17,218
2614,65,34,67,17,183
2615,67,17,67,17,168
2617,67,18,119,14,218
2618,135,33,99,17,284
2620,101,33,99,17,250
2621,85,33,99,17,234
2624,67,33,100,17,217
2625,69,14,100,17,200
2626,100,32,68,15,215
2627,85,32,68,15,200
2629,64,16,68,15,163
2630,66,34,66,18,184
2631,84,34,232,18,368
2633,84,50,116,16,266
2634,100,18,116,16,250
2635,66,35,116,16,233
2636,66,18,116,16,216
2637,67,16,100,16,199
2638,66,33,133,18,250
2639,68,16,133,18,235
2642,133,33,135,17,318
2644,67,33,133,17,250
2645,66,17,133,17,233
2646,65,33,135,17,250
2648,84,15,67,17,183
2649,68,15,67,17,167
2650,83,17,68,17,185
2652,85,15,52,15,167
2653,67,15,52,15,149
2654,52,15,52,15,134
2655,50,35,283,16,384
2656,68,32,67,17,184
2657,50,32,67,17,166
2658,52,15,67,17,151
2660,83,16,67,17,183
2661,66,16,67,17,166
2662,84,17,65,18,184
2663,67,17,65,18,167
2664,100,50,67,16,233
2666,67,50,67,16,200
2667,100,17,99,33,249
2669,68,17,99,33,217
2670,133,33,200,17,383
2673,51,32,434,17,534
2674,83,16,200,17,316
2675,149,50,83,17,299
2676,81,17,167,17,282
2677,116,50,83,17,266
2680,67,50,83,17,217
2681,68,33,83,17,201
2682,51,33,83,17,184
2683,67,17,66,17,167
2685,83,33,51,15,182
2686,84,17,51,15,167
2687,66,17,51,15,149
2688,99,18,66,19,202
2691,68,15,70,31,184
2692,51,15,70,31,167
2693,100,19,65,17,201
2694,151,17,266,17,451
2696,70,31,51,15,167
2697,100,17,266,17,400
2698,84,17,266,17,384
2699,84,32,50,18,184
2700,114,17,67,16,214
2701,101,17,67,16,201
2702,83,17,67,16,183
2703,66,17,67,16,166
2704,66,34,65,17,182
2705,65,18,65,17,165
2706,50,18,65,17,150
2709,67,16,101,17,201
2710,82,17,101,15,215
2712,66,34,101,15,216
2713,84,33,68,15,200
2714,68,33,68,15,184
2715,67,17,68,15,167
2717,233,17,70,14,334
2718,182,18,103,14,317
2719,66,19,65,16,166
2720,68,32,67,16,183
2722,199,37,131,17,384
2724,81,18,103,14,216
2725,84,33,70,14,201
2727,66,17,70,14,167
2728,50,17,70,14,151
2730,103,46,68,17,234
2735,84,33,101,16,234
2737,65,17,101,16,199
2738,67,35,165,17,284
2739,68,17,165,17,267
2740,85,15,67,17,184
2742,84,17,132,34,267
2743,116,33,66,34,249
2744,99,33,66,34,232
2745,99,16,66,34,215
2747,133,16,101,16,266
2748,116,16,101,16,249
2750,83,16,101,16,216
2752,66,34,118,15,233
2753,101,16,84,15,216
2754,85,16,84,15,200
2755,68,16,84,15,183
2757,135,15,85,33,268
2758,118,15,85,33,251
2759,65,19,231,18,333
2760,68,31,85,33,217
2761,133,17,65,17,232
2763,84,34,65,17,200
2764,65,34,65,17,181
2766,133,34,51,17,235
2767,50,50,67,15,182
2771,115,35,66,16,232
2774,151,17,51,32,251
2775,68,17,66,16,167
2776,134,33,50,16,233
2777,99,17,51,32,199
2778,84,17,51,32,184
2779,66,17,51,32,166
2780,82,17,50,16,165
2781,67,17,50,16,150
2782,66,50,82,17,215
2783,199,19,153,13,384
2784,83,16,66,17,182
2785,67,16,66,17,166
2786,50,16,66,17,149
2787,131,19,153,13,316
2788,117,19,153,13,302
2789,82,17,151,21,271
2793,101,17,87,13,218
2794,67,18,83,21,189
2795,85,32,55,13,185
2797,68,15,55,13,151
2798,101,34,66,17,218
2799,83,34,66,17,200
2800,87,13,66,17,183
2802,134,34,99,33,300
2803,118,34,99,33,284
2804,83,17,133,33,266
2805,62,17,133,33,245
2806,100,34,65,33,232
2809,66,19,65,33,183
2810,68,33,65,34,200
2811,84,32,200,17,333
2812,115,17,67,17,216
2814,81,17,67,17,182
2815,83,34,133,17,267
2816,65,34,133,17,249
2817,49,34,133,17,233
2818,67,33,67,16,183
2821,102,16,101,15,234
2822,84,16,101,15,216
2823,116,33,68,16,233
2825,83,33,68,16,200
2827,66,16,68,16,166
2828,66,35,66,17,184
2831,51,33,150,15,249
2832,68,33,82,18,201
2833,84,33,67,17,201
2834,66,33,67,17,183
2836,82,17,118,33,250
2837,66,17,118,33,234
2838,66,34,84,33,217
2839,65,18,84,33,200
2841,51,32,100,18,201
2842,51,15,100,18,184
2843,68,17,65,18,168
2844,84,33,82,17,216
2845,67,33,82,17,199
2846,52,33,82,17,184
2847,134,15,68,17,234
2848,83,16,167,16,282
2849,66,16,167,16,265
2850,51,16,167,16,250
2851,82,34,100,16,232
2852,101,34,66,16,217
2853,66,17,100,16,199
2855,132,17,150,17,316
2856,85,32,84,17,218
2857,68,32,84,17,201
2859,150,49,85,16,300
2860,66,33,134,17,250
2862,51,17,134,17,219
2863,84,49,85,16,234
2865,51,49,85,16,201
2866,117,17,134,33,301
2867,66,17,68,16,167
2869,66,17,134,33,250
2870,68,34,100,33,235
2871,185,33,66,17,301
2873,83,34,67,15,199
2874,83,17,67,15,182
2876,115,18,66,17,216
2877,99,18,66,17,200
2878,68,33,66,17,184
2879,99,18,100,17,234
2880,100,33,67,17,217
2882,99,33,166,17,315
2883,51,33,67,17,168
2886,66,34,132,17,249
2887,67,17,132,17,233
2888,67,32,100,17,216
2890,51,15,100,17,183
2892,132,34,101,17,284
2896,65,34,101,17,217
2900,68,33,334,17,452
2901,118,33,67,17,235
2903,84,33,67,17,201
2904,67,33,67,17,184
2906,82,18,68,17,185
2907,65,18,68,17,168
2909,83,34,99,16,232
2910,101,32,67,16,216
2911,103,15,67,16,201
2912,85,15,67,16,183
2913,68,15,67,16,166
2914,51,15,67,16,149
2915,67,16,66,34,183
2917,66,16,67,17,166
2918,67,33,133,17,250
2920,100,33,183,17,333
2922,67,33,183,17,300
2923,51,33,183,17,284
2924,67,33,101,16,217
2925,101,16,134,16,267
2927,66,16,134,16,232
2928,50,16,134,16,216
2929,67,33,116,17,233
2930,101,32,101,17,251
2931,116,34,67,17,234
2932,100,34,67,17,218
2933,51,32,101,17,201
2934,67,34,67,17,185
2935,50,34,67,17,168
2936,66,49,84,16,215
2938,83,18,150,16,267
2941,117,33,201,16,367
2942,101,33,201,16,351
2943,84,33,201,16,334
2944,82,17,201,16,316
2946,50,17,201,16,284
2947,68,16,68,15,167
2948,84,16,67,16,183
2949,68,16,67,16,167
2952,68,33,67,16,184
2955,117,50,65,17,249
2957,101,34,65,17,217
2958,67,50,65,17,199
2959,118,48,52,16,234
2960,50,34,65,17,166
2961,166,19,67,16,268
2962,67,48,52,16,183
2963,67,32,52,16,167
2964,51,32,52,16,151
2965,65,17,51,17,150
2966,65,35,67,16,183
2968,69,33,99,17,218
2969,52,33,99,17,201
2972,83,16,67,16,182
2974,66,33,167,17,283
2975,66,16,167,17,266
2976,82,17,66,17,182
2977,83,33,100,17,233
2978,100,33,167,16,316
2980,84,16,167,16,283
2981,67,16,167,16,266
2982,66,34,99,17,216
2983,117,33,67,16,233
2984,100,33,67,16,216
2985,83,33,67,16,199
2987,67,16,67,16,166
2989,50,33,84,18,185
2990,66,34,50,18,168
2991,66,17,50,18,151
2994,84,18,131,17,250
2995,67,18,131,17,233
2996,50,18,131,17,216
2997,102,16,65,17,200
2998,85,16,65,17,183
3000,81,18,116,18,233
3001,66,18,116,18,218
3003,81,17,85,15,198
3006,66,33,134,17,250
3007,119,33,99,34,285
3009,85,33,99,34,251
3010,68,33,99,34,234
3011,52,33,99,34,218
3012,68,34,99,17,218
3014,67,32,201,15,315
3015,84,33,51,16,184
3016,83,16,51,16,166
3019,66,18,66,17,167
3020,117,16,68,15,216
3022,84,16,68,15,183
3023,134,18,65,17,234
3024,83,18,181,18,300
3026,50,18,181,18,267
3027,99,33,100,18,250
3028,83,33,100,18,234
3029,82,17,100,18,217
3031,83,17,84,17,201
3032,65,17,84,17,183
3033,151,51,65,17,284
3035,51,49,69,15,184
3036,66,17,69,15,167
3037,84,51,65,17,217
3038,67,51,65,17,200
3040,86,15,67,17,185
3041,84,34,100,16,234
3043,66,17,100,16,199
3044,84,17,67,16,184
3045,99,16,67,17,199
3047,67,16,67,17,167
3048,116,17,84,16,233
3050,67,33,84,16,200
3051,100,16,51,16,183
3052,201,32,67,16,316
3053,66,16,51,16,149
3054,84,33,82,18,217
3056,84,16,166,17,283
3058,51,16,166,17,250
3061,82,34,101,16,233
3062,66,34,101,16,217
3063,100,17,68,16,201
3064,66,33,68,16,183
3065,66,17,68,16,167
3066,83,17,51,16,167
3068,66,35,131,19,251
3071,68,16,67,17,168
3072,84,17,84,17,202
3073,67,17,84,17,185
3074,66,33,51,17,167
3075,66,17,51,17,151
3076,167,33,84,16,300
3078,149,17,84,16,266
3079,68,17,65,17,167
3082,68,33,84,16,201
3083,82,34,66,17,199
3084,65,34,66,17,182
3085,67,17,66,17,167
3086,50,17,66,17,150
3088,68,32,84,17,201
3089,67,16,84,17,184
3090,132,18,67,16,233
3093,66,34,67,16,183
3094,84,17,134,15,250
3095,84,50,165,18,317
3097,51,50,165,18,284
3098,85,16,68,15,184
3099,83,33,134,16,266
3100,66,33,134,16,249
3101,118,32,67,16,233
3103,134,16,66,20,236
3104,68,32,67,16,183
3105,51,32,67,16,166
3106,67,34,66,20,187
3107,69,16,66,20,171
3108,66,33,53,13,165
3109,84,33,100,16,233
3110,100,33,67,16,216
3111,65,17,100,16,198
3112,66,33,67,16,182
3113,51,33,67,16,167
3114,66,34,117,17,234
3116,133,34,99,17,283
3117,113,34,99,17,263
3118,67,33,101,16,217
3119,83,34,99,17,233
3121,67,17,99,17,200
3122,67,34,149,17,267
3123,68,17,149,17,251
3125,51,33,100,16,200
3126,83,16,84,17,200
3127,82,33,51,17,183
3128,65,33,51,17,166
3129,83,35,133,17,268
3130,65,35,133,17,250
3132,84,17,66,17,184
3133,51,33,66,17,167
3134,51,17,66,17,151
3136,67,32,51,18,168
3138,135,31,102,16,284
3139,68,17,66,17,168
3140,83,18,65,16,182
3142,51,18,65,16,150
3146,65,32,134,16,247
3147,100,19,132,16,267
3149,85,31,134,16,266
3150,68,31,134,16,249
3151,52,31,134,16,233
3152,52,15,134,16,217
3153,67,17,67,16,167
3155,183,32,150,17,382
3157,84,33,66,19,202
3158,67,33,66,19,185
3159,51,33,66,19,169
3161,136,33,217,14,400
3164,66,52,217,14,349
3165,69,33,217,14,333
3167,68,15,66,17,166
3168,52,15,66,17,150
3169,131,17,66,19,233
3170,51,16,50,17,134
3172,66,17,83,19,185
3175,68,16,99,17,200
3176,68,32,67,17,184
3177,83,36,164,17,300
3178,85,17,164,17,283
3180,82,17,335,17,451
3182,84,17,99,17,217
3183,65,17,99,17,198
3184,65,33,66,17,181
3185,117,33,67,18,235
3187,50,33,100,18,201
3188,133,33,51,17,234
3189,82,34,134,17,267
3192,67,33,51,17,168
3193,101,17,66,17,201
3196,68,33,67,17,185
3199,100,17,99,17,233
3201,67,17,99,17,200
3202,84,15,167,17,283
3203,115,34,67,16,232
3204,99,34,67,16,216
3206,99,33,100,17,249
3207,65,17,67,16,165
3208,117,17,100,16,250
3211,84,33,67,16,200
3212,100,33,69,15,217
3214,100,34,66,17,217
3216,83,17,66,17,183
3217,67,17,66,17,167
3218,117,16,68,34,235
3219,85,31,68,34,218
3220,84,16,68,34,202
3221,83,34,68,16,201
3222,66,34,68,16,184
3224,65,34,65,18,182
3225,50,34,65,18,167
3226,102,31,101,17,251
3227,151,33,83,17,284
3228,68,31,101,17,217
3229,83,35,99,17,234
3231,85,33,83,17,218
3232,66,33,83,17,199
3233,65,18,83,17,183
3234,101,33,134,17,285
3235,83,33,134,17,267
3236,99,34,65,17,215
3238,150,32,185,16,383
3239,67,17,65,17,166
3241,100,32,185,16,333
3242,84,32,185,16,317
3243,99,18,65,17,199
3244,65,17,185,16,283
3245,102,17,66,16,201
3247,67,17,66,16,166
3249,100,18,100,16,234
3250,65,17,51,17,150
3252,133,33,83,16,265
3256,83,17,83,16,199
3258,67,33,99,17,216
3259,83,34,65,17,199
3262,83,16,84,17,200
3263,67,16,84,17,184
3265,83,34,101,31,249
3267,100,17,133,17,267
3269,68,17,133,17,235
3270,68,35,164,17,284
3271,86,32,132,17,267
3272,69,32,132,17,250
3273,84,49,83,17,233
3274,67,49,83,17,216
3275,117,50,84,16,267
3277,85,50,84,16,235
3278,132,34,167,15,348
3279,51,50,84,16,201
3280,85,16,68,16,185
3281,67,16,68,16,167
3282,83,17,167,15,282
3283,66,17,167,15,265
3284,118,16,133,35,302
3286,84,16,133,35,268
3287,67,16,133,35,251
3288,99,16,67,17,199
3289,151,32,133,18,334
3290,133,32,133,18,316
3291,83,34,83,17,217
3293,83,32,133,18,266
3294,68,32,133,18,251
3295,52,32,133,18,235
3296,66,35,98,18,217
3297,117,33,199,17,366
3298,67,33,167,17,284
3299,118,32,102,17,269
3300,68,33,199,17,317
3301,52,33,199,17,301
3304,100,49,166,17,332
3306,67,49,166,17,299
3307,99,18,82,16,215
3309,132,17,134,18,301
3310,84,15,167,18,284
3311,69,15,167,18,269
3312,52,15,167,18,252
3314,82,16,67,17,182
3315,65,16,67,17,165
3316,101,49,84,34,268
3317,67,18,167,16,268
3318,83,34,84,34,235
3319,66,34,84,34,218
3321,67,17,134,33,251
3322,66,33,134,17,250
3324,135,33,65,17,250
3326,67,34,66,17,184
3327,83,33,65,17,198
3328,68,33,65,17,183
3330,117,15,218,17,367
3331,102,15,218,17,352
3332,66,32,218,17,333
3333,82,52,66,16,216
3334,82,35,66,16,199
3335,83,19,66,16,184
3336,65,19,66,16,166
3342,65,34,133,17,249
3343,67,16,133,17,233
3344,117,17,66,17,217
3345,100,17,66,17,200
3346,84,17,66,17,184
3348,50,17,66,17,150
3349,51,32,51,17,151
3350,101,34,132,17,284
3352,83,17,132,17,249
3353,67,17,132,17,233
3354,101,33,100,16,250
3355,84,33,100,16,233
3356,100,34,197,19,350
3357,67,16,100,16,199
3358,66,34,197,19,316
3360,149,35,183,15,382
3362,83,17,184,15,299
3364,82,35,183,15,315
3366,118,32,68,15,233
3367,101,32,68,15,216
3368,51,15,234,16,316
3369,83,17,68,15,183
3370,118,16,168,17,319
3371,80,19,84,15,198
3372,118,15,50,18,201
3373,66,16,168,17,267
3374,67,33,50,18,168
3376,53,15,50,18,136
3377,66,18,165,34,283
3378,83,18,84,16,201
3379,83,33,151,16,283
3381,84,34,65,34,217
3383,51,34,65,34,184
3384,67,33,133,34,267
3385,82,32,101,34,249
3386,67,32,101,34,234
3387,184,34,99,17,334
3388,99,34,133,17,283
3393,84,34,99,17,234
3396,67,32,67,17,183
3397,83,34,118,15,250
3398,66,34,118,15,233
3399,50,34,118,15,217
3400,66,33,68,17,184
3401,84,34,66,17,201
3402,84,17,66,17,184
3403,67,17,66,17,167
3404,85,16,65,17,183
3406,68,32,68,16,184
3407,100,16,234,17,367
3408,51,15,68,16,150
3409,65,16,234,17,332
3410,82,18,117,17,234
3411,115,34,51,17,217
3413,100,17,51,17,185
3415,84,33,201,33,351
3417,66,17,201,33,317
3419,116,17,67,17,217
3420,51,17,115,17,200
3421,52,48,67,17,184
3422,66,17,67,17,167
3423,65,17,67,17,166
3424,65,33,68,33,199
3425,117,34,99,17,267
3427,101,17,99,17,234
3428,101,33,66,17,217
3430,150,17,67,17,251
3431,66,18,66,17,167
3432,67,32,101,17,217
3434,116,17,65,33,231
3435,84,34,65,33,216
3436,66,34,65,33,198
3438,51,17,65,33,166
3439,101,15,68,34,218
3441,99,35,65,18,217
3442,82,35,65,18,200
3443,116,34,182,33,365
3444,84,16,117,32,249
3445,67,16,117,32,232
3447,51,34,182,33,300
3448,69,33,99,16,217
3450,67,34,115,33,249
3451,167,17,67,17,268
3452,67,48,117,17,249
3453,133,17,67,17,234
3454,115,17,67,17,216
3455,67,17,100,17,201
3456,131,17,84,16,248
3458,134,35,82,17,268
3459,117,35,82,17,251
3460,66,17,84,16,183
3461,84,35,82,17,218
3462,102,32,217,16,367
3463,117,33,101,16,267
3464,51,18,82,17,168
3465,52,32,217,16,317
3466,67,33,101,16,217
3467,83,34,132,18,267
3468,65,34,132,18,249
3469,66,17,132,18,233
3470,84,16,117,16,233
3473,84,33,234,16,367
3474,132,34,50,17,233
3475,183,33,67,17,300
3477,134,17,83,17,251
3478,65,34,50,17,166
3479,49,34,50,17,150
3480,167,33,100,17,317
3484,50,17,67,17,151
3485,117,34,66,17,234
3489,50,34,66,17,167
3490,99,34,67,16,216
3491,51,32,51,17,151
3492,82,18,67,16,183
3493,65,18,67,16,166
3494,66,34,132,17,249
3495,67,17,132,17,233
3496,101,33,132,35,301
3498,83,17,132,35,267
3500,116,16,101,16,249
3502,66,33,101,16,216
3505,67,16,201,16,300
3506,50,16,201,16,283
3508,66,35,133,16,250
3509,84,33,67,17,201
3510,84,17,67,17,185
3511,67,17,67,17,168
3513,84,34,66,17,201
3515,84,33,69,14,200
3520,133,33,234,16,416
3524,83,17,234,16,350
3527,83,33,184,17,317
3529,68,15,184,17,284
3530,66,33,85,16,200
3532,66,34,51,16,167
3533,65,17,51,16,149
3534,67,34,100,17,218
3537,118,33,134,16,301
3538,51,16,67,17,151
3541,66,17,134,16,233
3542,50,17,134,16,217
3543,84,32,101,16,233
3545,51,32,101,16,200
3546,100,34,132,17,283
3547,83,34,132,17,266
3550,68,33,65,17,183
3551,134,16,101,17,268
3553,82,33,101,17,233
3554,82,16,101,17,216
3555,82,34,67,17,200
3556,82,17,67,17,183
3557,83,33,67,17,200
3558,118,16,100,17,251
3559,67,16,67,17,167
3560,51,16,67,17,151
3561,101,16,101,16,234
3563,67,16,101,16,200
3564,51,16,101,16,184
3565,66,16,101,17,200
3566,66,34,84,17,201
3567,83,34,117,32,266
3568,84,17,117,32,250
3569,67,17,117,32,233
3570,84,17,84,32,217
3571,67,17,84,32,200
3572,50,17,84,32,183
3573,67,17,149,17,250
3574,50,17,149,17,233
3575,51,33,116,17,217
3576,67,49,384,16,516
3577,67,32,384,16,499
3578,64,18,384,16,482
3579,65,17,67,16,165
3582,69,33,66,18,186
3583,51,33,66,18,168
3584,67,33,51,31,182
3586,82,17,234,16,349
3587,83,49,85,17,234
3588,84,31,85,17,217
3589,68,31,85,17,201
3590,117,16,51,16,200
3594,101,33,67,16,217
3595,102,16,67,16,201
3596,83,16,67,16,182
3597,67,16,67,16,166
3598,51,16,67,16,150
3599,82,34,84,15,215
3600,100,33,133,16,282
3601,83,33,133,16,265
3602,67,33,133,16,249
3603,66,17,133,16,232
3607,101,16,66,17,200
3608,66,34,66,17,183
3609,99,17,50,17,183
3610,84,17,50,17,168
3612,83,17,168,17,285
3613,65,17,168,17,267
3615,67,17,67,17,168
3619,84,32,52,16,184
3620,67,32,52,16,167
3621,66,15,52,16,149
3622,166,34,67,15,282
3624,67,33,67,34,201
3625,67,16,67,34,184
3627,67,17,101,15,200
3629,66,17,67,15,165
3630,50,17,67,15,149
3632,68,33,66,17,184
3633,51,33,66,17,167
3635,84,34,66,18,202
3636,65,34,66,18,183
3637,50,34,66,18,168
3638,66,32,52,15,165
3640,118,15,51,16,200
3641,66,17,68,16,167
3643,133,16,101,17,267
3644,52,15,51,16,134
3645,85,32,101,17,235
3647,99,16,68,17,200
3649,101,16,52,16,185
3650,116,17,200,16,349
3651,100,17,200,16,333
3652,101,33,134,33,301
3655,151,33,267,15,466
3657,50,34,66,16,166
3658,83,17,67,33,200
3660,67,33,267,15,382
3661,101,18,66,32,217
3663,150,49,67,34,300
3664,67,33,65,17,182
3665,84,33,66,16,199
3666,67,33,66,16,182
3667,51,33,66,16,166
3668,66,49,67,34,216
3669,83,17,67,34,201
3670,65,17,67,34,183
3671,66,17,84,17,184
3672,66,35,66,15,182
3676,84,17,65,35,201
3678,66,33,67,33,199
3679,116,35,100,17,268
3680,50,18,67,33,168
3681,82,35,100,17,234
3682,65,35,100,17,217
3683,118,33,84,15,250
3684,67,33,67,17,184
3686,68,33,84,15,200
3688,82,18,50,15,165
3689,85,50,65,18,218
3690,67,50,65,18,200
3691,51,50,65,18,184
3692,51,33,65,18,167
3693,68,15,135,16,234
3696,101,32,134,16,283
3701,85,33,66,16,200
3702,100,49,67,16,232
3703,84,49,67,16,216
3704,68,49,67,16,200
3705,99,17,100,17,233
3707,66,17,100,17,200
3708,99,33,135,16,283
3713,68,16,67,17,168
3714,101,33,133,17,284
3715,117,34,133,17,301
3716,68,33,133,17,251
3717,67,16,133,17,233
3718,117,17,166,17,317
3722,67,33,133,17,250
3723,133,17,100,16,266
3724,66,33,67,16,182
3726,66,34,100,16,216
3727,67,17,100,16,200
3729,67,16,67,16,166
3731,117,33,134,17,301
3733,99,17,134,17,267
3735,67,17,134,17,235
3737,67,17,217,17,318
3739,101,16,151,17,285
3740,51,15,401,16,483
3742,100,33,67,17,217
3743,149,34,99,17,299
3744,134,34,99,17,284
3745,116,34,99,17,266
3746,100,34,99,17,250
3749,65,18,99,17,199
3752,68,32,66,17,183
3756,65,33,51,16,165
3758,101,32,101,16,250
3759,65,18,133,16,232
3760,84,16,101,16,217
3761,51,32,101,16,200
3762,51,16,101,16,184
3763,84,33,84,17,218
3764,82,17,84,17,200
3765,66,17,84,17,184
3766,217,17,166,17,417
3767,68,17,50,17,152
3768,117,17,99,17,250
3769,67,18,65,17,167
3773,83,34,166,17,300
3774,99,33,116,17,265
3778,84,17,82,17,200
3780,84,16,267,17,384
3782,67,34,99,16,216
3783,84,32,266,33,415
3784,67,32,266,33,398
3786,100,33,134,17,284
3788,66,33,134,17,250
3789,51,33,134,17,235
3790,83,18,100,17,218
3792,150,17,65,33,265
3793,51,33,67,17,168
3794,83,18,98,33,232
3795,135,15,334,17,501
3796,132,33,66,18,249
3798,99,33,66,18,216
3799,68,15,334,17,434
3800,82,16,66,18,182
3801,82,49,118,18,267
3802,82,32,118,18,250
3803,65,32,118,18,233
3804,99,18,83,18,218
3805,82,18,83,18,201
3806,66,18,83,18,185
3807,83,36,64,17,200
3808,67,36,64,17,184
3809,51,36,64,17,168
3810,119,15,101,17,252
3812,67,18,99,17,201
3813,68,15,101,17,201
3814,98,33,133,18,282
3815,84,33,133,18,268
3816,67,33,133,18,251
3817,82,34,99,18,233
3821,68,17,65,18,168
3822,100,51,117,33,301
3823,51,32,118,16,217
3825,149,34,67,16,266
3827,67,16,101,33,217
3828,100,34,67,16,217
3830,119,16,68,15,218
3832,85,16,68,15,184
3833,68,16,68,15,167
3834,52,16,68,15,151
3836,102,32,83,16,233
3837,84,32,83,16,215
3838,68,32,83,16,199
3839,53,32,83,16,184
3841,83,34,101,16,234
3843,100,16,200,17,333
3844,83,16,200,17,316
3846,101,34,232,34,401
3847,84,34,232,34,384
3849,67,17,232,34,350
3853,100,17,67,15,199
3854,100,32,218,15,365
3855,133,18,65,34,250
3856,68,32,218,15,333
3857,51,32,218,15,316
3859,66,18,65,34,183
3860,67,33,66,16,182
3861,52,33,66,16,167
3865,134,17,132,17,300
3867,51,32,118,17,218
3868,84,17,132,17,250
3869,85,32,68,15,200
3870,84,15,68,15,182
3871,51,32,68,15,166
3873,132,17,101,34,284
3875,66,17,133,34,250
3876,51,17,133,34,235
3877,82,34,67,34,217
3879,66,17,67,34,184
3880,133,34,65,17,249
3881,118,34,65,17,234
3882,83,18,99,17,217
3884,67,34,65,17,183
3885,50,34,65,17,166
3887,52,32,68,16,168
3888,150,16,67,16,249
3889,84,35,299,34,452
3890,82,18,299,34,433
3891,67,18,299,34,418
3892,68,32,67,16,183
3894,51,16,67,16,150
3895,67,17,66,17,167
3897,83,33,68,16,200
3898,67,33,68,16,184
3899,83,34,100,17,234
3900,66,34,100,17,217
3901,67,17,100,17,201
3902,67,34,99,34,234
3903,51,34,99,34,218
3904,100,34,67,15,216
3905,51,32,135,16,234
3907,67,17,67,15,166
3911,50,34,65,18,167
3912,101,31,102,15,249
3913,84,31,102,15,232
3914,68,31,102,15,216
3915,52,31,102,15,200
3916,65,34,133,17,249
3918,65,33,150,18,266
3919,67,15,150,18,250
3921,84,32,67,16,199
3924,84,16,100,17,217
3925,67,16,100,17,200
3927,67,17,134,18,236
3928,67,34,118,31,250
3929,66,18,118,31,233
3930,68,32,200,18,318
3931,51,32,200,18,301
3932,66,34,199,17,316
3933,101,17,66,17,201
3934,66,34,66,17,183
3935,68,17,66,17,168
3936,86,31,116,17,250
3937,69,31,116,17,233
3939,167,32,68,17,284
3940,66,34,249,17,366
3941,65,17,249,17,348
3942,68,50,82,18,218
3943,83,18,82,18,201
3945,99,18,149,17,283
3946,167,32,50,17,266
3947,65,18,149,17,249
3949,100,17,82,17,216
3950,85,17,82,17,201
3951,85,32,50,17,184
3952,99,33,201,16,349
3953,52,32,50,17,151
3955,99,17,84,17,217
3956,65,34,84,17,200
3957,67,17,84,17,185
3959,200,17,65,17,299
3961,68,33,83,16,200
3962,51,33,83,16,183
3963,67,17,66,16,166
3964,83,17,99,17,216
3965,65,17,99,17,198
3966,67,34,65,17,183
3967,83,34,66,17,200
3969,67,18,66,17,168
3972,65,17,85,16,183
3974,66,32,152,16,266
3976,118,17,267,32,434
3977,85,33,267,32,417
3978,83,17,267,32,399
3979,66,17,267,32,382
3980,51,17,267,32,367
3981,67,16,67,34,184
3982,66,34,132,18,250
3984,67,33,117,16,233
3986,101,32,133,17,283
3987,65,19,65,18,167
3990,66,33,68,32,199
3991,84,34,66,17,201
3994,85,16,133,17,251
3995,83,32,101,17,233
3997,82,34,100,16,232
3999,82,33,167,17,299
4000,66,33,167,17,283
4001,118,33,100,17,268
4002,67,34,99,18,218
4003,67,17,99,18,201
4004,84,16,100,17,217
4005,83,34,66,17,200
4006,67,34,66,17,184
4008,67,32,151,17,267
4009,167,16,133,16,332
4010,84,16,67,16,183
4011,101,34,115,16,266
4013,100,16,133,16,265
4015,67,16,133,16,232
4020,83,32,68,17,200
4021,67,32,68,17,184
4022,51,32,68,17,168
4024,66,34,50,17,167
4026,68,33,66,17,184
4027,151,34,117,16,318
4029,68,17,166,17,268
4031,51,32,100,18,201
4032,83,17,117,16,233
4033,117,32,51,16,216
4035,168,16,67,16,267
4036,100,34,100,16,250
4038,84,16,100,16,216
4040,66,33,67,16,182
4041,50,33,67,16,166
4042,84,17,66,16,183
4043,83,33,67,16,199
4045,50,33,67,16,166
4046,116,18,65,18,217
4047,83,34,65,18,200
4048,82,18,65,18,183
4049,100,16,151,16,283
4050,117,33,82,18,250
4051,67,16,151,16,250
4052,84,33,82,18,217
4053,68,33,82,18,201
4054,65,18,82,18,183
4055,84,32,167,17,300
4056,68,32,167,17,284
4058,52,15,167,17,251
4060,65,34,66,17,182
4061,66,16,66,17,165
4062,51,16,66,17,150
4063,150,34,66,34,284
4064,67,33,134,34,268
4065,66,16,134,34,250
4066,134,32,100,19,285
4068,67,34,66,34,201
4071,83,34,167,17,301
4072,66,34,167,17,284
4076,135,32,51,16,234
4077,51,32,67,17,167
4079,69,16,133,18,236
4081,51,32,51,16,150
4083,82,33,100,34,249
4085,50,33,100,34,217
4086,51,16,100,34,201
4087,102,15,67,16,200
4089,83,33,67,16,199
4093,115,34,83,16,248
4095,83,34,83,16,216
4096,67,34,83,16,200
4097,135,16,67,17,235
4099,117,33,101,16,267
4100,100,33,101,16,250
4101,84,33,101,16,234
4103,100,17,100,17,234
4104,51,16,101,16,184
4105,83,34,98,19,234
4106,67,34,98,19,218
4107,84,33,84,16,217
4108,68,33,84,16,201
4109,84,33,67,15,199
4110,83,17,67,15,182
4111,100,34,66,17,217
4112,83,34,66,17,200
4113,67,34,66,17,184
4115,117,34,82,17,250
4116,51,16,67,15,149
4117,100,17,82,17,216
4118,85,17,82,17,201
4120,67,32,67,17,183
4122,66,34,67,16,183
4123,66,17,67,16,166
4124,166,32,134,18,350
4126,84,17,65,34,200
4127,84,33,66,17,200
4128,67,33,66,17,183
4129,218,32,199,18,467
4130,67,32,134,18,251
4131,66,16,134,18,234
4132,99,35,98,18,250
4133,83,35,98,18,234
4134,83,18,98,18,217
4135,67,18,98,18,201
4136,134,33,101,17,285
4137,135,15,101,17,268
4138,68,32,199,18,317
4141,101,16,67,17,201
4143,134,17,100,16,267
4145,66,16,183,18,283
4147,83,34,66,16,199
4148,67,34,66,16,183
4149,50,34,66,16,166
4150,83,34,66,18,201
4151,117,32,68,16,233
4154,66,32,68,16,182
4155,100,18,100,17,235
4157,66,18,100,17,201
4159,51,33,67,17,168
4160,84,17,83,17,201
4162,66,34,149,34,283
4163,51,34,149,34,268
4164,84,32,84,16,216
4165,68,32,84,16,200
4166,83,17,83,34,217
4167,116,34,67,16,233
4168,133,50,83,17,283
4169,82,34,67,16,199
4170,68,34,67,16,185
4171,84,50,83,17,234
4174,50,34,83,17,184
4175,85,33,183,17,318
4177,67,17,183,17,284
4179,83,49,118,16,266
4180,115,17,67,17,216
4181,67,32,118,16,233
4183,99,17,67,16,199
4184,83,17,67,16,183
4185,66,17,67,16,166
4187,68,16,100,18,202
4190,50,17,99,21,187
4191,66,17,87,14,184
4192,100,54,79,17,250
4194,66,54,79,17,216
4195,68,36,79,17,200
4196,87,14,65,17,183
4197,71,14,65,17,167
4199,115,34,67,17,233
4200,117,17,67,17,218
4203,67,17,67,17,168
4204,99,34,99,17,249
4205,84,34,99,17,234
4206,84,17,99,17,217
4208,67,34,150,15,266
4209,150,17,68,15,250
4210,68,33,132,17,250
4211,116,17,68,15,216
4213,82,17,68,15,182
4214,100,32,67,17,216
4215,118,33,200,17,368
4217,52,32,67,17,168
4218,117,17,66,17,217
4219,83,34,66,17,200
4221,67,17,66,17,167
4222,67,34,116,16,233
4223,49,34,116,16,215
4225,83,17,67,16,183
4226,66,17,67,16,166
4227,100,17,232,18,367
4228,66,34,232,18,350
4229,83,32,67,18,200
4230,51,17,232,18,318
4231,83,34,66,18,201
4232,66,34,66,18,184
4236,100,18,166,34,318
4237,83,18,166,34,301
4239,68,17,149,34,268
4240,51,17,149,34,251
4243,100,15,167,17,299
4244,65,18,66,34,183
4245,168,17,150,18,353
4246,52,15,167,17,251
4247,66,17,217,18,318
4249,100,17,150,18,285
4250,85,17,150,18,270
4251,84,50,83,17,234
4252,67,50,83,17,217
4253,82,19,83,17,201
4254,85,32,68,18,203
4255,67,32,68,18,185
4256,133,35,65,15,248
4257,116,35,65,15,231
4259,100,18,65,15,198
4260,85,18,65,15,183
4262,51,18,65,15,149
4265,83,33,133,16,265
4267,50,33,133,16,232
4268,66,34,133,16,249
4269,83,33,66,16,198
4270,67,33,66,16,182
4271,117,34,68,16,235
4272,67,32,68,16,183
4274,82,17,68,16,183
4276,66,34,50,17,167
4278,118,17,267,16,418
4280,84,17,267,16,384
4281,68,17,267,16,368
4283,84,34,115,17,250
4284,66,34,115,17,232
4286,67,49,100,16,232
4287,99,33,67,16,215
4288,50,33,100,16,199
4289,66,33,67,16,182
4290,64,18,67,16,165
4293,66,17,68,16,167
4295,67,16,51,15,149
4296,51,16,51,15,133
4297,101,15,68,17,201
4298,116,17,67,17,217
4300,51,15,68,17,151
4301,66,17,67,17,167
4303,83,33,217,16,349
4308,117,17,250,15,399
4309,117,50,66,16,249
4311,67,17,250,15,349
4312,67,50,66,16,199
4315,67,32,117,18,234
4316,65,17,117,18,217
4317,66,34,134,15,249
4318,51,34,134,15,234
4320,67,37,64,17,185
4321,87,30,117,32,266
4323,65,18,117,32,232
4324,118,15,51,32,216
4326,81,15,51,32,179
4327,69,15,51,32,167
4328,117,32,317,18,484
4329,66,16,134,15,231
4331,66,32,317,18,433
4332,83,17,135,17,252
4336,117,18,51,15,201
4337,118,34,116,17,285
4338,117,18,116,17,268
4339,99,18,116,17,250
4340,66,34,116,17,233
4342,84,15,168,16,283
4343,134,17,66,18,235
4345,117,34,67,16,234
4347,99,17,67,16,199
4348,84,17,67,16,184
4349,67,17,67,16,167
4350,118,17,83,17,235
4351,68,15,135,33,251
4354,67,33,67,33,200
4357,100,17,99,16,232
4358,115,18,99,17,249
4360,100,32,67,17,216
4361,66,18,99,17,200
4362,68,32,67,17,184
4363,50,32,67,17,166
4364,65,34,50,17,166
4365,84,33,168,16,301
4366,82,17,168,16,283
4367,66,17,168,16,267
4368,50,17,168,16,251
4370,50,17,66,34,167
4371,85,32,68,16,201
4374,82,18,100,16,216
4376,82,18,118,32,250
4379,85,33,52,32,202
4380,67,33,52,32,184
4381,67,17,52,32,168
4382,82,17,68,16,183
4383,167,16,68,16,267
4385,69,32,83,15,199
4386,52,32,83,15,182
4387,101,16,68,16,201
4389,149,31,118,17,315
4390,86,17,99,17,219
4391,66,17,99,17,199
4392,66,34,65,17,182
4394,68,31,118,17,234
4397,84,35,66,33,218
4398,82,18,66,33,199
4400,51,18,66,33,168
4401,85,33,134,15,267
4404,99,32,69,15,215
4405,83,32,69,15,199
4406,66,32,69,15,182
4407,67,15,69,15,166
4408,65,34,200,17,316
4411,84,32,133,17,266
4412,185,16,217,17,435
4413,135,33,66,18,252
4414,118,33,66,18,235
4415,65,35,82,17,199
4417,68,33,66,18,185
4419,68,16,217,17,318
4420,52,16,217,17,302
4421,117,31,51,16,215
4422,68,35,65,17,185
4424,68,31,51,16,166
4425,67,16,51,16,150
4427,83,33,135,16,267
4428,233,33,232,33,531
4429,67,16,135,16,234
4430,85,16,66,18,185
4431,84,34,134,16,268
4432,84,17,134,16,251
4434,84,16,102,16,218
4435,66,16,102,16,200
4437,84,33,232,33,382
4438,67,33,232,33,365
4439,118,31,52,17,218
4442,67,31,52,17,167
4443,82,35,82,17,216
4444,100,34,148,18,300
4445,100,17,148,18,283
4446,66,34,148,18,266
4448,69,33,65,33,200
4449,133,17,116,17,283
4450,67,32,66,17,182
4451,65,17,66,17,165
4452,98,50,66,17,231
4453,66,17,116,17,216
4454,98,17,66,17,198
4455,83,17,66,17,183
4457,67,18,233,16,334
4458,50,18,233,16,317
4460,117,17,134,16,284
4461,83,17,100,33,233
4465,51,34,151,15,251
4467,84,49,118,17,268
4468,83,33,118,17,251
4469,82,17,118,17,234
4470,132,34,51,15,232
4471,84,32,234,16,366
4472,67,32,234,16,349
4473,67,16,234,16,333
4474,51,16,234,16,317
4475,50,34,51,15,150
4477,84,32,184,17,317
4480,51,15,184,17,267
4481,117,51,82,17,267
4482,84,16,116,17,233
4483,83,51,82,17,233
4484,100,19,82,17,218
4485,51,51,82,17,201
4486,65,19,82,17,183
4487,67,15,84,33,199
4488,116,17,200,17,350
4489,65,17,51,33,166
4490,84,17,200,17,318
4491,65,17,200,17,299
4492,67,50,183,17,317
4493,68,33,183,17,301
4495,85,32,67,16,200
4497,83,34,66,17,200
4498,102,33,132,33,300
4499,101,16,132,33,282
4500,83,16,132,33,264
4501,68,16,132,33,249
4502,83,17,132,18,250
4503,100,16,134,16,266
4504,116,16,66,18,216
4505,66,16,134,16,232
4506,66,33,66,18,183
4507,67,16,66,18,167
4508,116,34,151,32,333
4509,67,15,134,17,233
4510,51,15,134,17,217
4512,66,18,151,32,267
4513,66,17,184,16,283
4517,50,33,134,33,250
4518,66,51,67,16,200
4520,66,18,67,16,167
4521,67,17,131,18,233
4522,68,32,99,18,217
4523,101,16,65,18,200
4524,67,34,65,18,184
4525,83,33,218,15,349
4526,99,50,168,15,332
4527,135,17,99,18,269
4528,67,50,168,15,300
4530,83,17,99,18,217
4533,150,35,66,16,267
4536,82,17,67,17,183
4538,65,35,66,16,182
4540,52,17,66,16,151
4542,67,34,66,17,184
4543,117,32,51,17,217
4545,83,32,51,17,183
4546,68,32,51,17,168
4547,51,32,51,17,151
4548,66,34,68,15,183
4549,67,17,68,15,167
4550,83,17,100,30,230
4551,118,32,64,18,232
4552,102,32,64,18,216
4553,51,34,181,17,283
4554,116,18,115,17,266
4555,66,17,64,18,165
4556,82,18,115,17,232
4557,65,18,115,17,215
4559,51,48,67,17,183
4560,64,18,67,17,166
4561,84,34,232,33,383
4562,265,17,83,17,382
4565,52,32,133,17,234
4566,84,15,66,18,183
4567,117,49,99,17,282
4568,50,15,66,18,149
4569,50,35,148,17,250
4571,66,33,99,17,215
4572,100,17,83,17,217
4573,66,33,83,17,199
4574,65,17,83,17,182
4575,66,17,100,17,200
4576,51,17,100,17,185
4577,83,33,67,17,200
4578,83,17,67,17,184
4581,66,17,66,18,167
4582,67,33,101,17,218
4583,84,33,85,15,217
4584,84,16,85,15,200
4585,67,16,85,15,183
4587,67,16,217,17,317
4588,84,17,83,17,201
4589,84,32,235,15,366
4590,85,15,235,15,350
4591,116,34,66,17,233
4593,117,32,51,17,217
4594,66,34,66,17,183
4595,99,16,51,17,183
4596,68,32,51,17,168
4597,66,16,51,17,150
4599,66,17,67,17,167
4601,67,17,67,15,166
4603,69,15,67,17,168
4605,99,18,133,34,284
4606,133,49,85,16,283
4607,64,18,133,34,249
4608,84,16,82,18,200
4609,67,16,82,18,183
4610,50,16,82,18,166
4611,83,17,85,16,201
4612,82,19,66,16,183
4613,84,32,66,17,199
4614,82,18,66,17,183
4615,65,18,66,17,166
4616,68,34,115,18,235
4621,51,34,67,16,168
4623,66,17,100,17,200
4624,67,34,66,17,184
4625,66,18,66,17,167
4628,83,17,66,18,184
4629,134,16,68,17,235
4630,83,16,201,17,317
4631,67,16,201,17,301
4632,84,16,68,17,185
4633,83,34,68,16,201
4634,100,34,165,17,316
4635,117,34,100,15,266
4636,51,16,68,16,151
4638,85,17,100,15,217
4641,52,33,67,15,167
4642,67,33,165,17,282
4644,100,48,83,17,248
4645,182,33,67,16,298
4646,98,17,83,17,215
4647,115,33,200,17,365
4648,82,17,66,17,182
4649,65,17,66,17,165
4650,65,33,200,17,315
4652,67,33,67,16,183
4653,135,31,84,17,267
4654,66,34,183,17,300
4656,85,31,84,17,217
4657,68,31,84,17,200
4658,52,31,84,17,184
4659,66,18,116,17,217
4660,67,50,66,17,200
4662,84,16,85,31,216
4663,68,16,85,31,200
4664,101,32,183,17,333
4666,84,17,183,17,301
4667,101,31,52,17,201
4668,134,34,82,17,267
4669,50,49,52,17,168
4670,99,34,82,17,232
4671,66,18,116,17,217
4673,65,18,82,17,182
4674,119,17,67,16,219
4675,52,32,134,17,235
4676,100,33,67,17,217
4677,67,17,67,16,167
4678,133,33,100,33,299
4679,65,17,67,17,166
4680,67,34,66,17,184
4682,83,17,100,33,233
4683,67,17,100,33,217
4684,50,17,100,33,200
4686,66,34,66,17,183
4687,67,17,66,17,167
4688,67,33,100,16,216
4689,99,17,267,16,399
4690,83,17,267,16,383
4691,100,16,100,17,233
4692,133,34,100,15,282
4694,66,34,100,17,217
4695,67,17,100,17,201
4696,67,34,100,15,216
4697,84,32,68,15,199
4698,100,34,100,16,250
4701,118,34,82,17,251
4702,83,17,66,16,182
4703,84,34,82,17,217
4704,68,34,82,17,201
4705,85,32,50,17,184
4708,66,33,101,16,216
4710,65,34,133,17,249
4711,68,17,133,17,235
4714,101,34,65,34,234
4716,83,18,65,34,200
4718,68,32,67,16,183
4719,100,16,284,17,417
4721,99,18,66,16,199
4723,83,34,65,17,199
4724,67,34,65,17,183
4725,116,33,66,17,232
4726,116,17,66,17,216
4727,235,33,67,16,351
4728,99,35,116,17,267
4729,66,17,66,17,166
4731,102,31,101,16,250
4732,50,18,116,17,201
4733,100,35,66,16,217
4735,66,35,66,16,183
4737,66,33,67,16,182
4741,66,16,166,17,265
4742,85,16,67,17,185
4743,67,16,67,17,167
4745,67,17,165,19,268
4750,50,33,82,19,184
4753,65,17,117,17,216
4754,50,17,117,17,201
4759,100,17,66,18,201
4760,67,34,66,18,185
4761,65,17,66,18,166
4762,50,17,66,18,151
4763,84,50,82,17,233
4766,66,18,82,17,183
4768,66,33,84,16,199
4770,134,33,68,15,250
4771,82,34,499,19,634
4772,83,17,499,19,618
4773,66,17,499,19,601
4774,67,33,68,15,183
4775,67,16,68,15,166
4776,51,16,68,15,150
4777,50,34,67,17,168
4778,84,17,165,16,282
4779,67,17,165,16,265
4780,118,15,66,19,218
4783,167,31,51,17,266
4784,50,15,66,19,150
4785,50,34,66,16,166
4787,65,35,82,17,199
4788,151,16,104,14,285
4789,67,31,51,17,166
4791,117,34,317,16,484
4792,68,33,104,14,219
4793,82,34,317,16,449
4794,134,37,81,15,267
4795,68,17,317,16,418
4796,67,33,99,19,218
4797,120,29,135,16,300
4799,87,29,135,16,267
4804,81,15,234,16,346
4805,115,35,83,16,249
4806,117,18,83,16,234
4808,102,32,134,16,284
4810,68,32,134,16,250
4811,67,16,134,16,233
4814,99,33,133,17,282
4815,83,33,133,17,266
4816,67,33,133,17,250
4818,66,34,166,16,282
4820,67,33,66,17,183
4821,83,34,133,17,267
4823,85,32,101,17,235
4825,51,32,101,17,201
4826,66,34,67,17,184
4827,84,33,233,17,367
4828,66,33,233,17,349
4829,66,16,233,17,332
4831,66,18,166,17,267
4833,67,15,202,15,299
4834,83,34,234,16,367
4835,67,34,234,16,351
4836,83,17,66,17,183
4837,149,33,67,17,266
4838,68,33,66,17,184
4840,85,16,134,17,252
4841,83,33,67,17,200
4842,66,33,67,17,183
4845,84,32,51,16,183
4847,184,32,135,17,368
4849,67,17,67,16,167
4850,66,33,117,17,233
4853,84,32,135,17,268
4855,66,16,135,17,234
4856,83,34,166,16,299
4857,67,34,166,16,283
4859,84,33,167,15,299
4861,84,34,82,16,216
4862,68,34,82,16,200
4864,100,33,249,17,399
4867,151,32,69,14,266
4868,115,18,182,17,332
4870,82,18,182,17,299
4871,67,18,182,17,284
4872,67,32,69,14,182
4873,118,34,166,16,334
4874,136,47,85,16,284
4877,133,19,66,16,234
4881,66,19,66,16,167
4882,98,34,132,17,281
4883,84,34,132,17,267
4884,67,34,132,17,250
4885,119,33,99,17,268
4887,51,34,163,19,267
4888,68,33,99,17,217
4889,85,34,132,16,267
4890,67,34,132,16,249
4892,67,31,185,17,300
4893,116,50,84,17,267
4894,82,17,67,16,182
4895,65,17,67,16,165
4896,65,50,84,17,216
4898,84,17,67,17,185
4899,67,17,67,17,168
4900,83,17,51,17,168
4902,52,17,51,17,137
4903,66,18,65,19,168
4904,67,34,132,17,250
4906,51,17,132,17,217
4907,52,50,66,16,184
4909,83,33,66,17,199
4911,50,33,66,17,166
4912,85,16,66,17,184
4913,82,33,67,16,198
4914,66,33,67,16,182
4915,82,33,67,17,199
4917,66,16,67,17,166
4918,66,34,67,16,183
4919,83,50,83,20,236
4920,67,50,83,20,220
4921,66,34,83,20,203
4922,117,17,53,31,218
4923,67,17,86,31,201
4924,116,17,118,15,266
4925,67,17,53,31,168
4927,83,51,67,15,216
4930,166,34,66,17,283
4931,68,17,65,17,167
4932,51,17,65,17,150
4933,64,17,66,16,163
4934,100,34,66,17,217
4935,67,15,134,34,250
4937,83,33,101,16,233
4939,65,17,101,16,199
4940,134,34,99,17,284
4942,66,34,167,17,284
4943,50,34,167,17,268
4945,117,33,117,34,301
4946,68,33,100,17,218
4949,84,33,183,17,317
4951,50,33,183,17,283
4952,66,34,84,16,200
4954,84,33,284,17,418
4955,67,33,284,17,401
4956,84,34,149,19,286
4957,101,16,133,19,269
4958,84,16,133,19,252
4960,85,16,100,19,220
4962,83,17,135,16,251
4964,66,35,165,18,284
4965,66,18,165,18,267
4966,119,15,133,17,284
4967,152,33,66,17,268
4968,86,15,133,17,251
4969,151,32,201,16,400
4970,66,34,99,17,216
4972,68,33,66,17,184
4973,165,16,67,17,265
4974,67,32,201,16,316
4976,65,34,67,16,182
4977,67,16,67,16,166
4978,83,16,67,17,183
4980,83,18,132,18,251
4981,99,17,67,16,199
4982,67,33,67,16,183
4985,85,33,66,34,218
4987,84,32,68,16,200
4988,67,32,68,16,183
4989,100,16,69,16,201
4992,116,19,81,17,233
4996,69,47,68,16,200
4997,83,17,68,16,184
4998,82,17,67,34,200
4999,100,17,67,16,200
5000,115,16,100,17,248
5001,65,17,67,16,165
5002,85,16,100,17,218
5004,134,33,67,17,251
5006,67,33,100,17,217
5007,50,33,100,17,200
5010,133,34,198,17,382
5011,50,35,166,32,283
5013,83,34,198,17,332
5014,67,34,198,17,316
5018,67,32,168,17,284
5019,67,15,168,17,267
5020,83,17,266,17,383
5021,67,17,266,17,367
5022,133,49,84,17,283
5024,101,49,84,17,251
5025,66,17,100,17,200
5026,66,49,84,17,216
5027,51,49,84,17,201
5029,66,18,66,17,167
5032,52,16,100,17,185
5034,83,17,68,16,184
5035,182,18,100,17,317
5036,151,33,100,17,301
5038,67,35,64,18,184
5039,101,33,100,17,251
5040,99,18,100,17,234
5041,67,33,100,17,217
5042,66,18,100,17,201
5043,67,33,84,32,216
5044,64,18,84,32,198
5045,66,17,183,18,284
5048,68,34,65,17,184
5049,50,34,65,17,166
5050,99,33,51,18,201
5053,66,16,51,18,151
5054,65,35,66,17,183
5055,50,35,66,17,168
5056,68,34,149,15,266
5060,66,33,66,18,183
5061,67,16,66,18,167
5062,81,17,51,15,164
5064,83,34,183,17,317
5065,66,34,183,17,300
5066,84,15,102,16,217
5067,68,15,102,16,201
5068,51,15,102,16,184
5070,100,35,66,17,218
5073,67,17,66,17,167
5076,84,17,67,16,184
5077,100,16,100,17,233
5078,66,33,100,17,216
5079,67,16,100,17,200
5082,100,33,67,16,216
5083,66,17,67,16,166
5084,83,17,67,16,183
5085,66,17,67,16,166
5086,83,17,149,17,266
5087,67,17,149,17,250
5088,83,17,116,17,233
5095,66,34,84,16,200
5096,85,17,67,16,185
5098,85,17,199,17,318
5099,51,34,199,17,301
5102,117,17,133,17,284
5103,133,17,66,17,233
5104,66,34,133,17,250
5105,83,33,66,17,199
5108,50,17,66,17,150
5109,50,33,67,17,167
5110,99,34,67,17,217
5112,83,17,67,17,184
5114,50,17,67,17,151
5115,68,16,51,31,166
5116,67,34,65,17,183
5119,132,17,133,19,301
5120,82,34,68,16,200
5121,65,34,68,16,183
5122,99,33,100,19,251
5123,65,17,133,19,234
5124,50,17,133,19,219
5125,51,33,100,19,203
5126,67,34,66,19,186
5127,68,16,66,19,169
5128,67,34,66,17,184
5129,52,34,66,17,169
5131,67,15,134,17,233
5132,85,15,200,17,317
5137,81,34,100,17,232
5138,66,34,100,17,217
5139,167,16,99,35,317
5140,67,33,67,17,184
5141,67,16,67,17,167
5144,67,33,99,35,234
5145,132,17,68,16,233
5146,67,33,66,35,201
5148,82,17,68,16,183
5149,65,17,68,16,166
5150,66,33,234,35,368
5151,149,17,51,15,232
5152,133,17,51,15,216
5153,134,17,67,17,235
5154,84,33,51,15,183
5157,67,17,67,17,168
5158,66,34,99,35,234
5159,84,33,101,15,233
5160,51,17,99,35,202
5161,51,33,101,15,200
5162,67,33,83,34,217
5163,67,16,83,34,200
5164,99,35,66,16,216
5165,68,16,50,34,168
5167,84,49,83,17,233
5168,68,49,83,17,217
5169,51,49,83,17,200
5172,66,33,100,16,215
5176,66,34,65,17,182
5177,50,34,65,17,166
5178,50,17,65,17,149
5179,69,16,66,18,169
5181,134,15,168,16,333
5182,99,33,168,16,316
5183,65,17,183,18,283
5184,165,19,65,18,267
5185,100,17,134,16,267
5187,67,17,134,16,234
5188,99,19,65,18,201
5190,101,49,68,17,235
5191,133,18,100,15,266
5192,99,17,68,17,201
5193,81,17,68,17,183
5196,67,33,116,17,233
5197,68,17,116,17,218
5198,102,33,66,17,218
5199,68,17,82,17,184
5201,51,33,66,17,167
5202,99,34,66,17,216
5203,99,17,66,17,199
5205,100,16,68,16,200
5206,66,33,68,16,183
5207,68,16,68,16,168
5208,100,35,164,18,317
5209,83,35,164,18,300
5210,83,18,164,18,283
5211,66,18,164,18,266
5212,68,33,66,17,184
5215,85,32,65,18,200
5218,66,34,133,17,250
5219,114,18,67,17,216
5220,66,49,67,17,199
5221,82,18,67,17,184
5222,83,17,67,17,184
5223,100,16,233,18,367
5224,83,16,233,18,350
5225,67,16,233,18,334
5227,84,33,149,17,283
5230,84,16,133,18,251
5232,116,17,84,32,249
5233,99,17,84,32,232
5237,82,33,118,16,249
5239,83,50,68,16,217
5240,66,50,68,16,200
5241,68,32,68,16,184
5242,83,17,167,18,285
5244,67,51,148,18,284
5245,100,16,66,18,200
5246,52,33,148,18,251
5247,84,34,98,18,234
5248,67,34,98,18,217
5249,65,18,98,18,199
5251,116,50,200,16,382
5252,66,34,118,16,234
5253,102,32,200,16,350
5254,66,50,200,16,332
5256,84,17,99,17,217
5257,83,34,215,18,350
5258,67,34,215,18,334
5259,65,18,215,18,316
5260,69,33,65,17,184
5261,51,33,65,17,166
5262,51,16,65,17,149
5263,116,51,167,17,351
5266,82,34,167,17,300
5267,100,16,151,17,284
5268,66,18,167,17,268
5269,117,34,67,16,234
5271,50,34,117,17,218
5272,102,33,50,17,202
5273,66,18,67,16,167
5274,68,33,50,17,168
5275,50,33,50,17,150
5279,67,17,167,15,266
5280,100,33,101,15,249
5281,117,33,68,15,233
5285,66,17,68,15,166
5286,66,34,66,17,183
5287,118,32,66,18,234
5288,67,34,98,18,217
5289,85,32,66,18,201
5291,200,17,133,16,366
5292,167,33,133,16,349
5293,67,17,116,17,217
5295,51,50,83,17,201
5297,67,17,166,16,266
5298,67,33,133,16,249
5299,66,17,133,16,232
5302,100,33,67,16,216
5303,84,33,67,16,200
5304,83,17,67,16,183
5305,101,16,100,17,234
5306,116,18,98,17,249
5307,67,16,100,17,200
5308,66,34,98,17,215
5314,66,49,68,16,199
5315,67,32,68,16,183
5316,82,18,66,16,182
5317,64,18,66,16,164
5318,83,17,168,16,284
5319,66,17,168,16,267
5321,68,16,67,17,168
5322,66,33,135,15,249
5323,117,33,234,17,401
5324,133,35,332,17,517
5325,83,33,234,17,367
5327,51,33,234,17,335
5329,85,33,116,17,251
5331,99,17,67,17,200
5332,68,32,67,17,184
5333,65,17,67,17,166
5334,99,33,217,17,366
5338,67,34,133,16,250
5339,101,16,66,17,200
5340,50,17,133,16,216
5342,67,33,117,17,234
5343,83,33,84,17,217
5345,66,16,84,17,183
5346,100,33,200,16,349
5347,66,17,151,15,249
5349,66,17,200,16,299
5350,67,34,66,18,185
5351,50,34,66,18,168
5353,67,17,232,18,334
5354,67,33,84,16,200
5355,66,17,84,16,183
5356,150,16,99,18,283
5357,134,16,99,18,267
5358,51,15,100,17,183
5359,83,34,99,18,234
5360,133,34,116,17,300
5361,66,16,99,18,199
5362,51,16,99,18,184
5363,83,34,116,17,250
5365,115,18,66,17,216
5367,51,50,66,17,184
5368,84,18,65,33,200
5369,85,48,67,17,217
5370,68,48,67,17,200
5371,69,32,67,17,185
5373,83,33,84,16,216
5374,81,17,84,16,198
5375,65,17,84,16,182
5376,67,34,132,35,268
5378,67,34,98,35,234
5380,84,16,66,35,201
5381,67,16,66,35,184
5383,83,33,102,16,234
5384,98,35,233,33,399
5385,184,32,67,16,299
5387,84,33,66,16,199
5388,68,33,66,16,183
5390,68,34,133,15,250
5391,85,32,67,16,200
5394,66,33,101,33,233
5395,82,34,67,33,216
5397,66,17,67,33,183
5399,151,33,67,17,268
5401,51,33,265,18,367
5403,51,33,67,16,167
5406,83,17,165,18,283
5407,85,33,66,17,201
5408,67,33,66,17,183
5409,117,32,167,17,333
5412,67,32,167,17,283
5413,51,32,167,17,267
5414,66,33,51,17,167
5415,66,16,51,17,150
5416,65,51,83,17,216
5417,66,34,83,17,200
5418,66,18,83,17,184
5421,68,16,66,35,185
5422,101,33,52,15,201
5423,83,33,52,15,183
5424,151,15,50,17,233
5427,84,32,50,17,183
5428,68,32,50,17,167
5429,51,32,50,17,150
5432,82,17,200,17,316
5433,98,18,100,16,232
5434,83,18,100,16,217
5435,84,32,134,17,267
5437,67,16,134,17,234
5438,117,17,133,16,283
5439,101,17,133,16,267
5440,100,33,67,16,216
5441,84,33,67,16,200
5443,67,17,67,16,167
5444,101,34,67,15,217
5446,66,34,67,15,182
5447,67,17,67,15,166
5448,83,17,66,17,183
5449,117,32,68,16,233
5450,83,18,148,18,267
5451,66,18,148,18,250
5452,82,17,68,16,183
5453,66,17,68,16,167
5454,66,50,133,17,266
5455,100,18,66,16,200
5456,65,17,133,17,232
5457,101,32,117,17,267
5458,84,32,117,17,250
5459,67,32,117,17,233
5460,83,18,66,16,183
5461,100,16,67,17,200
5462,66,32,67,17,182
5463,82,34,101,16,233
5464,67,34,101,16,218
5465,67,17,101,16,201
5466,82,17,166,18,283
5468,100,35,65,33,233
5469,67,16,51,16,150
5470,83,18,65,33,199
5471,85,32,66,18,201
5472,68,32,66,18,184
5475,83,51,83,18,235
5476,98,18,83,18,217
5477,100,16,67,18,201
5478,185,15,66,19,285
5479,68,16,67,18,169
5480,51,16,67,18,152
5482,52,16,51,15,134
5483,67,16,99,19,201
5484,85,15,66,19,185
5485,67,15,66,19,167
5487,134,15,134,17,300
5489,66,34,82,17,199
5490,85,15,134,17,251
5491,101,16,66,17,200
5492,51,15,134,17,217
5493,67,16,66,17,166
5494,134,17,85,17,253
5495,132,17,68,17,234
5497,66,33,85,17,201
5498,66,17,85,17,185
5500,101,34,82,16,233
5502,51,17,51,14,133
5503,85,31,235,17,368
5504,68,31,235,17,351
5505,100,16,84,16,216
5506,116,16,101,17,250
5507,100,16,101,17,234
5508,82,16,101,17,216
5511,64,19,67,17,167
5512,67,33,134,17,251
5513,67,16,134,17,234
5514,67,34,234,16,351
5518,83,18,167,16,284
5519,84,33,83,17,217
5520,100,33,67,16,216
5522,66,33,67,16,182
5523,51,33,67,16,167
5524,50,16,67,16,149
5526,83,17,66,17,183
5531,67,16,67,17,167
5533,84,33,133,34,284
5534,66,33,133,34,266
5535,167,19,97,17,300
5536,200,34,65,19,318
5537,117,36,97,17,267
5538,83,17,66,34,200
5539,67,17,66,34,184
5540,67,36,97,17,217
5541,86,30,67,17,200
5543,99,18,65,19,201
5544,100,33,116,35,284
5547,85,51,166,16,318
5548,67,51,166,16,300
5551,68,15,85,15,183
5553,66,17,117,16,216
5555,100,15,167,16,298
5556,85,15,167,16,283
5557,68,15,167,16,266
5558,51,15,167,16,249
5559,68,17,66,16,167
5560,69,32,100,16,217
5561,66,16,100,16,198
5562,67,34,66,16,183
5563,66,17,66,16,165
5564,66,33,67,16,182
5567,117,33,68,16,234
5568,66,34,101,16,217
5570,67,33,68,16,184
5572,67,37,130,17,251
5573,51,37,130,17,235
5575,66,19,65,17,167
5576,68,32,67,17,184
5579,68,16,134,16,234
5580,65,34,100,16,215
5581,66,17,100,16,199
5582,67,34,66,16,183
5583,117,33,67,17,234
5584,51,17,66,16,150
5592,67,34,65,17,183
5594,68,33,100,16,217
5595,117,35,132,17,301
5596,67,32,68,16,183
5598,65,35,132,17,249
5599,85,33,165,18,301
5600,67,33,165,18,283
5601,66,17,165,18,266
5602,68,32,67,17,184
5603,51,32,67,17,167
5604,115,17,199,19,350
5605,66,33,67,16,182
5609,67,17,100,16,200
5610,51,17,100,16,184
5611,118,33,99,16,266
5613,117,33,66,16,232
5614,82,18,99,16,215
5615,66,18,99,16,199
5616,68,33,66,16,183
5617,50,33,66,16,165
5618,148,17,68,16,249
5619,51,51,65,18,185
5620,84,15,167,34,300
5621,99,17,68,16,200
5622,51,15,167,34,267
5623,65,17,68,16,166
5625,65,18,133,33,249
5626,68,33,100,33,234
5627,85,34,66,33,218
5628,84,18,66,33,201
5629,85,32,100,16,233
5630,67,32,100,16,215
5631,217,33,166,17,433
5632,82,18,99,17,216
5633,84,33,216,18,351
5634,66,33,216,18,333
5635,51,33,216,18,318
5637,84,33,351,16,484
5638,116,16,166,17,315
5639,51,33,351,16,451
5640,83,16,166,17,282
5641,132,17,99,17,265
5642,84,32,67,18,201
5643,68,32,67,18,185
5644,83,17,99,17,216
5645,66,17,99,17,199
5646,67,33,150,18,268
5647,66,16,150,18,250
5648,102,48,67,18,235
5650,68,48,67,18,201
5651,51,48,67,18,184
5652,168,33,66,17,284
5653,66,18,117,16,217
5654,66,49,68,16,199
5655,118,33,66,17,234
5656,135,33,66,17,251
5659,85,33,66,17,201
5661,201,17,50,15,283
5663,67,16,84,17,184
5664,133,34,50,15,232
5666,66,34,67,17,184
5667,66,17,67,17,167
5668,84,17,50,15,166
5669,67,17,50,15,149
5671,51,33,67,16,167
5673,133,17,66,17,233
5674,65,35,67,15,182
5675,51,35,67,15,168
5677,66,17,66,17,166
5678,68,34,131,19,252
5679,85,32,68,15,200
5680,67,32,68,15,182
5682,66,33,66,19,184
5684,65,35,66,16,182
5686,83,35,82,17,217
5687,66,35,82,17,200
5689,69,16,66,17,168
5690,99,33,67,16,215
5691,84,33,67,16,200
5692,101,34,65,19,219
5693,49,33,67,16,165
5695,50,34,65,19,168
5697,115,19,66,17,217
5698,99,19,66,17,201
5700,84,31,85,34,234
5701,68,31,85,34,218
5702,65,17,85,34,201
5703,101,17,116,17,251
5706,69,33,100,17,219
5707,168,17,133,17,335
5708,100,32,67,17,216
5710,83,16,67,17,183
5711,99,17,133,17,266
5712,66,34,133,17,250
5715,67,16,66,17,166
5716,84,17,66,17,184
5717,67,17,66,17,167
5718,84,15,134,16,249
5721,117,32,134,33,316
5723,66,17,82,17,182
5724,68,32,134,33,267
5726,116,17,67,33,233
5727,99,17,67,33,216
5728,82,17,67,33,199
5730,84,16,85,17,202
5731,67,16,85,17,185
5733,68,16,51,17,152
5734,67,33,67,16,183
5736,102,32,117,16,267
5737,67,17,199,17,300
5739,54,32,117,16,219
5741,65,18,83,16,182
5742,115,17,166,17,315
5743,51,33,133,17,234
5744,51,16,133,17,217
5745,67,17,166,17,267
5747,82,34,134,16,266
5748,83,17,134,16,250
5749,84,33,66,17,200
5750,84,16,66,17,183
5751,67,16,66,17,166
5752,51,16,66,17,150
5753,67,17,133,17,234
5754,134,33,65,17,249
5755,66,33,84,17,200
5758,133,32,102,15,282
5759,67,17,65,17,166
5760,101,32,102,15,250
5761,84,32,102,15,233
5762,115,19,98,17,249
5763,99,19,98,17,233
5765,115,35,133,15,298
5766,134,32,133,17,316
5767,66,16,100,17,199
5769,85,32,133,17,267
5770,66,32,133,17,248
5771,51,32,133,17,233
5772,84,16,100,17,217
5773,66,16,100,17,199
5774,100,33,66,16,215
5775,67,18,65,17,167
5776,50,18,65,17,150
5777,51,33,66,16,166
5778,117,17,100,17,251
5779,83,34,100,17,234
5781,84,33,67,17,201
5782,66,33,67,17,183
5783,84,33,133,34,284
5784,67,33,133,34,267
5785,83,34,51,17,185
5786,100,34,65,34,233
5788,84,17,65,34,200
5789,201,16,67,17,301
5790,68,34,65,17,184
5791,51,34,65,17,167
5793,116,33,67,17,233
5794,99,33,67,17,216
5795,99,16,67,17,199
5796,148,17,67,17,249
5797,67,16,67,17,167
5798,51,16,67,17,151
5799,50,34,201,16,301
5803,66,17,117,17,217
5804,67,33,117,17,234
5805,68,16,117,17,218
5806,100,34,50,17,201
5807,67,16,68,16,167
5809,65,18,50,17,150
5813,68,17,66,17,168
5814,50,17,66,17,150
5815,50,32,51,17,150
5816,65,34,67,16,182
5817,83,34,66,17,200
5819,67,17,66,17,167
5820,51,17,66,17,151
5821,118,34,116,17,285
5825,51,34,116,17,218
5826,249,34,216,18,517
5827,101,16,166,18,301
5828,67,33,166,18,284
5832,66,34,65,18,183
5833,66,17,65,18,166
5834,50,17,65,18,150
5835,52,33,117,17,219
5836,67,50,216,18,351
5838,65,18,216,18,317
5840,66,34,67,17,184
5841,50,34,67,17,168
5842,52,16,67,17,152
5844,68,33,99,18,218
5847,67,15,250,20,352
5848,65,34,68,33,200
5849,135,17,168,14,334
5850,117,17,168,14,316
5852,102,33,65,19,219
5853,67,17,168,14,266
5854,68,33,65,19,185
5855,102,33,85,14,234
5856,85,33,85,14,217
5857,67,33,85,14,199
5859,68,15,200,17,300
5860,84,17,66,16,183
5862,103,32,98,17,250
5863,65,20,64,32,181
5864,102,32,133,17,284
5865,83,32,133,17,265
5866,98,50,51,15,214
5867,84,50,51,15,200
5868,96,18,51,15,180
5869,183,34,67,16,300
5870,64,18,51,15,148
5871,117,32,67,17,233
5872,66,35,66,16,183
5873,67,18,66,16,167
5874,101,34,67,16,218
5875,51,32,67,17,167
5876,67,34,67,16,184
5877,67,17,67,16,167
5880,84,17,134,32,267
5881,84,33,101,32,250
5882,67,33,101,32,233
5884,83,18,199,17,317
5885,84,34,182,17,317
5887,68,17,182,17,284
5888,68,33,65,17,183
5890,99,33,168,17,317
5892,65,33,168,17,283
5895,50,33,51,17,151
5896,117,17,84,31,249
5897,83,34,84,31,232
5898,134,34,83,16,267
5899,67,17,84,31,199
5900,101,34,83,16,234
5901,65,17,51,31,164
5902,84,17,83,16,200
5903,67,17,83,16,183
5904,115,18,83,18,234
5906,100,33,100,17,250
5908,66,33,100,17,216
5909,82,34,66,17,199
5910,67,34,66,17,184
5911,219,32,134,17,402
5915,83,33,118,16,250
5916,66,33,118,16,233
5917,99,19,83,16,217
5918,65,35,83,16,199
5919,65,19,83,16,183
5920,68,32,134,17,251
5921,83,34,100,17,234
5922,101,33,99,18,251
5923,51,34,100,17,202
5924,66,33,99,18,216
5925,68,16,99,18,201
5927,83,34,133,17,267
5928,66,34,133,17,250
5930,67,32,67,18,184
5931,101,17,216,17,351
5932,51,15,67,18,151
5934,50,17,216,17,300
5935,100,16,101,15,232
5937,67,16,101,15,199
5939,66,16,68,15,165
5941,65,18,216,33,332
5942,101,32,166,17,316
5943,65,19,182,33,299
5944,68,32,166,17,283
5945,52,32,166,17,267
5946,150,17,116,16,299
5947,68,17,67,15,167
5948,66,33,150,16,265
5949,183,17,83,17,300
5950,84,17,116,16,233
5951,67,17,116,16,216
5953,83,50,83,17,233
5954,166,33,103,16,318
5955,82,17,83,17,199
5956,99,33,84,34,250
5958,67,33,84,34,218
5960,67,33,103,16,219
5962,66,34,201,17,318
5963,100,34,83,17,234
5965,100,18,115,17,250
5966,51,34,83,17,185
5967,68,18,115,17,218
5970,52,16,83,17,168
5971,100,33,68,14,215
5972,65,50,68,14,197
5973,99,17,65,18,199
5974,100,34,66,16,216
5975,67,17,65,18,167
5977,67,17,66,16,166
5978,235,50,132,18,435
5979,68,14,185,34,301
5980,51,14,185,34,284
5981,83,33,117,34,267
5982,99,33,167,16,315
5983,65,17,117,34,233
5984,68,33,167,16,284
5988,99,18,132,18,267
5990,66,18,132,18,234
5991,68,34,182,16,300
5992,65,19,182,16,282
5995,132,18,100,16,266
5998,83,18,100,16,217
