序号,发送->接收,接收->转发,转发->接收,接收->处理,总计
2,6,17,852,20,895
3,272,11,586,20,889
4,255,11,586,20,872
5,239,11,586,20,856
7,205,11,586,20,822
8,189,11,586,20,806
9,172,11,586,20,789
11,139,11,586,20,756
12,122,11,586,20,739
13,104,11,586,20,721
14,88,11,586,20,705
16,55,11,586,20,672
17,164,17,452,20,653
20,117,17,452,20,606
21,98,17,452,20,587
22,83,17,452,20,572
23,64,17,452,20,553
24,200,34,285,20,539
25,183,34,285,20,522
26,165,34,285,20,504
27,150,34,285,20,489
30,99,34,285,20,438
31,82,34,285,20,421
33,48,34,285,20,387
35,185,32,1377,16,1610
36,168,32,1377,16,1593
39,119,32,1377,16,1544
40,101,32,1377,16,1526
41,85,32,1377,16,1510
42,69,32,1377,16,1494
43,100,17,1342,16,1475
44,84,17,1342,16,1459
45,69,17,1342,16,1444
46,50,17,1342,16,1425
47,34,17,1342,16,1409
48,18,17,1342,16,1393
49,17,32,1310,16,1375
50,14,18,1310,16,1358
52,137,32,1141,16,1326
53,119,32,1141,16,1308
55,85,32,1141,16,1274
56,65,32,1141,16,1254
57,84,34,1107,16,1241
58,68,34,1107,16,1225
59,86,33,1074,16,1209
61,52,33,1074,16,1175
64,17,16,1074,16,1123
66,14,20,1040,16,1090
67,119,33,908,16,1076
68,99,33,908,16,1056
70,67,33,908,16,1024
71,50,33,908,16,1007
73,16,33,908,16,973
74,33,33,875,16,957
75,32,16,875,16,939
76,33,34,841,16,924
77,16,34,841,16,907
78,16,18,841,16,891
80,33,46,762,16,857
81,33,29,762,16,840
83,159,30,602,16,807
86,100,30,602,16,748
87,85,30,602,16,733
89,283,34,368,16,701
90,267,34,368,16,685
91,247,34,368,16,665
92,230,34,368,16,648
94,200,34,368,16,618
95,181,34,368,16,599
97,149,34,368,16,567
100,98,34,368,16,516
101,83,34,368,16,501
102,64,34,368,16,482
103,150,33,266,16,465
106,103,33,266,16,418
107,83,33,266,16,398
108,150,15,203,16,384
109,131,15,203,16,365
110,117,15,203,16,351
111,98,15,203,16,332
112,81,15,203,16,315
115,32,15,203,16,266
117,15,34,169,16,234
118,169,34,16,15,234
119,151,34,16,15,216
120,135,34,16,15,200
121,115,34,16,15,180
123,83,34,16,15,148
127,34,17,16,15,82
128,102,31,18,17,168
129,85,31,18,17,151
130,365,33,219,15,632
131,349,33,219,15,616
132,334,33,219,15,601
133,317,33,219,15,584
135,282,33,219,15,549
136,266,33,219,15,533
137,248,33,219,15,515
138,231,33,219,15,498
140,200,33,219,15,467
141,184,33,219,15,451
142,165,33,219,15,432
143,149,33,219,15,416
144,132,33,219,15,399
146,99,33,219,15,366
151,200,16,52,15,283
152,184,16,52,15,267
153,167,16,52,15,250
154,151,16,52,15,234
156,116,16,52,15,199
157,100,16,52,15,183
158,84,16,52,15,167
159,98,18,234,18,368
161,65,18,234,18,335
162,46,18,234,18,316
163,68,15,200,18,301
164,52,15,200,18,285
165,85,35,132,18,270
166,67,35,132,18,252
167,149,33,33,18,233
169,117,33,33,18,201
170,101,33,33,18,185
171,83,33,33,18,167
172,83,16,33,18,150
173,67,16,33,18,134
175,33,16,33,18,100
176,33,33,18,17,101
177,16,33,18,17,84
181,0,17,32,16,65
182,66,34,48,16,164
183,51,34,48,16,149
185,18,34,48,16,116
186,165,34,18,15,232
189,115,34,18,15,182
190,95,34,18,15,162
191,83,34,18,15,150
192,67,34,18,15,134
193,100,15,84,18,217
194,85,15,84,18,202
196,52,15,84,18,169
198,84,17,16,18,135
199,66,17,16,18,117
201,34,17,16,18,85
203,17,34,33,17,101
204,16,18,33,17,84
205,84,33,50,16,183
206,132,33,49,17,231
207,115,33,49,17,214
208,99,33,49,17,198
209,82,33,49,17,181
210,183,16,34,18,251
211,166,16,34,18,234
212,150,16,34,18,218
214,117,16,34,18,185
216,84,16,34,18,152
220,18,16,34,18,86
221,16,34,249,17,316
223,197,19,50,17,283
224,180,19,50,17,266
225,162,19,50,17,248
226,145,19,50,17,231
228,112,19,50,17,198
229,97,19,50,17,183
231,65,19,50,17,151
232,47,19,50,17,133
234,14,19,50,17,100
235,35,17,84,18,154
237,34,17,50,18,119
239,17,33,17,18,85
241,83,34,17,15,149
242,84,17,17,15,133
243,67,17,17,15,116
245,33,17,17,15,82
246,34,32,18,16,100
247,17,32,18,16,83
249,33,16,16,19,84
251,415,36,149,16,616
254,364,36,149,16,565
255,348,36,149,16,549
256,331,36,149,16,532
257,315,36,149,16,516
258,299,36,149,16,500
260,265,36,149,16,466
263,215,36,149,16,416
264,199,36,149,16,400
265,183,36,149,16,384
267,150,36,149,16,351
269,116,36,149,16,317
270,99,36,149,16,300
271,81,36,149,16,282
272,66,36,149,16,267
274,33,36,149,16,234
277,83,33,51,16,183
278,65,33,51,16,165
280,32,33,51,16,132
281,15,33,51,16,115
282,33,35,16,16,100
283,17,35,16,16,84
284,86,14,33,18,151
285,81,33,18,18,150
289,147,35,199,17,398
290,168,34,165,17,384
293,117,34,165,17,333
294,99,34,165,17,315
295,83,34,165,17,299
296,66,34,165,17,282
297,51,34,165,17,267
298,35,34,165,17,251
299,18,34,165,17,234
301,31,19,132,17,199
302,14,19,132,17,182
303,34,18,99,17,168
306,82,17,251,15,365
309,33,17,251,15,316
310,149,18,150,17,334
311,133,18,150,17,318
312,116,18,150,17,301
313,99,18,150,17,284
314,82,18,150,17,267
315,65,18,150,17,250
318,17,18,150,17,202
319,185,32,149,18,384
320,167,32,149,18,366
321,149,32,149,18,348
322,135,32,149,18,334
324,100,32,149,18,299
325,83,32,149,18,282
326,67,32,149,18,266
327,349,35,1533,16,1933
328,334,35,1533,16,1918
329,316,35,1533,16,1900
331,1067,18,767,16,1868
333,1033,18,767,16,1834
334,1016,18,767,16,1817
335,998,18,767,16,1799
337,967,18,767,16,1768
339,934,18,767,16,1735
343,865,18,767,16,1666
344,850,18,767,16,1651
345,833,18,767,16,1634
346,816,18,767,16,1617
347,800,18,767,16,1601
348,783,18,767,16,1584
350,748,18,767,16,1549
351,733,18,767,16,1534
354,684,18,767,16,1485
355,665,18,767,16,1466
358,615,18,767,16,1416
360,582,18,767,16,1383
362,549,18,767,16,1350
365,500,18,767,16,1301
366,483,18,767,16,1284
367,465,18,767,16,1266
369,431,18,767,16,1232
372,383,18,767,16,1184
373,364,18,767,16,1165
374,349,18,767,16,1150
375,333,18,767,16,1134
376,318,18,767,16,1119
377,299,18,767,16,1100
378,283,18,767,16,1084
381,234,18,767,16,1035
382,217,18,767,16,1018
385,200,16,735,16,967
386,183,16,735,16,950
390,118,16,735,16,885
393,68,16,735,16,835
394,51,16,735,16,818
397,16,32,703,16,767
398,17,15,703,16,751
401,151,32,11332,17,11532
402,135,32,11332,17,11516
403,116,32,11332,17,11497
404,298,36,11130,17,11481
405,283,36,11130,17,11466
406,267,36,11130,17,11450
407,250,36,11130,17,11433
409,215,36,11130,17,11398
410,198,36,11130,17,11381
412,166,36,11130,17,11349
413,149,36,11130,17,11332
415,115,36,11130,17,11298
416,100,36,11130,17,11283
417,83,36,11130,17,11266
418,134,34,11064,17,11249
419,117,34,11064,17,11232
420,101,34,11064,17,11216
421,84,34,11064,17,11199
422,68,34,11064,17,11183
424,197,35,10898,17,11147
425,182,35,10898,17,11132
427,150,35,10898,17,11100
429,116,35,10898,17,11066
430,98,35,10898,17,11048
431,83,35,10898,17,11033
433,50,35,10898,17,11000
434,33,35,10898,17,10983
435,33,18,10898,17,10966
437,34,17,10865,17,10933
438,16,17,10865,17,10915
439,133,18,10731,17,10899
442,82,18,10731,17,10848
444,85,15,10700,17,10817
445,66,15,10700,17,10798
446,82,16,10664,17,10779
447,85,33,10631,17,10766
448,81,19,10631,17,10748
450,50,19,10631,17,10717
451,30,19,10631,17,10697
453,84,36,10530,17,10667
456,33,36,10530,17,10616
457,516,35,10100,18,10669
460,463,35,10100,18,10616
461,449,35,10100,18,10602
462,431,35,10100,18,10584
463,416,35,10100,18,10569
464,399,35,10100,18,10552
467,349,35,10100,18,10502
468,331,35,10100,18,10484
469,315,35,10100,18,10468
470,298,35,10100,18,10451
471,283,35,10100,18,10436
472,264,35,10100,18,10417
473,250,35,10100,18,10403
474,231,35,10100,18,10384
475,216,35,10100,18,10369
476,199,35,10100,18,10352
477,180,35,10100,18,10333
478,165,35,10100,18,10318
479,149,35,10100,18,10302
480,131,35,10100,18,10284
482,98,35,10100,18,10251
483,81,35,10100,18,10234
484,65,35,10100,18,10218
485,48,35,10100,18,10201
486,150,22,9995,18,10185
488,118,22,9995,18,10153
490,151,17,9932,18,10118
492,117,17,9932,18,10084
493,101,17,9932,18,10068
494,84,17,9932,18,10051
495,68,17,9932,18,10035
497,34,17,9932,18,10001
499,17,32,9900,18,9967
500,16,16,9900,18,9950
502,17,15,9868,18,9918
503,15,35,9833,18,9901
504,85,16,9767,18,9886
506,50,16,9767,18,9851
508,33,35,9732,18,9818
509,16,35,9732,18,9801
511,34,16,9700,18,9768
514,17,17,9666,18,9718
515,17,33,9633,18,9701
516,33,34,9599,18,9684
517,32,19,9599,18,9668
518,15,19,9599,18,9651
519,35,18,9565,18,9636
523,31,16,9501,18,9566
524,83,17,9433,18,9551
525,67,17,9433,18,9535
526,51,17,9433,18,9519
527,35,17,9433,18,9503
528,99,35,9366,18,9518
529,82,35,9366,18,9501
531,83,34,9332,18,9467
532,134,31,9267,18,9450
533,118,31,9267,18,9434
534,103,31,9267,18,9419
536,68,31,9267,18,9384
538,34,31,9267,18,9350
539,19,31,9267,18,9335
541,16,34,9233,18,9301
542,200,34,9033,18,9285
544,166,34,9033,18,9251
545,150,34,9033,18,9235
546,132,34,9033,18,9217
548,98,34,9033,18,9183
552,32,34,9033,18,9117
553,16,34,9033,18,9101
554,135,32,8900,18,9085
555,117,32,8900,18,9067
556,101,32,8900,18,9051
558,68,32,8900,18,9018
559,50,32,8900,18,9000
560,34,32,8900,18,8984
563,16,34,8866,18,8934
565,32,19,8832,18,8901
566,82,17,8767,18,8884
567,67,17,8767,18,8869
568,48,17,8767,18,8850
569,84,33,8700,18,8835
570,67,33,8700,18,8818
571,84,32,8668,18,8802
574,83,18,8632,18,8751
575,86,31,8601,18,8736
576,68,31,8601,18,8718
577,82,36,8565,18,8701
578,67,36,8565,18,8686
579,49,36,8565,18,8668
581,15,36,8565,18,8634
582,135,34,8432,18,8619
583,118,34,8432,18,8602
584,99,34,8432,18,8583
587,65,18,8432,18,8533
588,50,18,8432,18,8518
589,33,18,8432,18,8501
590,16,18,8432,18,8484
591,82,34,8370,13,8499
594,51,15,8370,13,8449
595,34,15,8370,13,8432
596,19,15,8370,13,8417
597,15,34,8336,13,8398
598,18,16,8336,13,8383
599,32,19,8301,13,8365
600,183,18,8135,13,8349
601,167,18,8135,13,8333
603,131,18,8135,13,8297
604,117,18,8135,13,8283
605,100,18,8135,13,8266
606,84,18,8135,13,8250
607,66,18,8135,13,8232
608,82,18,8102,13,8215
609,66,18,8102,13,8199
610,49,18,8102,13,8182
612,15,18,8102,13,8148
613,18,32,8070,13,8133
614,32,36,8034,13,8115
615,16,36,8034,13,8099
616,36,31,8003,13,8083
619,16,33,7970,13,8032
620,17,16,7970,13,8016
622,36,32,7902,13,7983
624,81,18,7835,13,7947
626,49,18,7835,13,7915
627,31,18,7835,13,7897
628,35,34,7801,13,7883
630,16,18,7801,13,7848
631,18,31,7770,13,7832
632,49,16,7736,13,7814
633,35,16,7736,13,7800
636,33,33,7670,13,7749
638,83,17,7603,13,7716
639,83,33,7570,13,7699
640,67,33,7570,13,7683
641,49,33,7570,13,7665
642,33,33,7570,13,7649
643,35,15,7570,13,7633
645,15,35,7535,13,7598
646,18,17,7535,13,7583
647,17,33,7502,13,7565
649,16,33,7469,13,7531
650,16,17,7469,13,7515
653,16,34,7401,13,7464
655,34,17,7368,13,7432
656,33,32,7336,13,7414
658,16,16,7336,13,7381
660,83,18,7235,13,7349
661,201,16,7102,13,7332
662,183,16,7102,13,7314
666,233,34,6968,13,7248
667,217,34,6968,13,7232
668,201,34,6968,13,7216
669,184,34,6968,13,7199
672,134,34,6968,13,7149
674,100,34,6968,13,7115
676,82,19,6968,13,7082
677,65,19,6968,13,7065
678,68,31,6937,13,7049
679,51,31,6937,13,7032
680,34,31,6937,13,7015
684,19,15,6903,13,6950
686,35,32,6836,13,6916
687,19,32,6836,13,6900
688,249,17,6602,13,6881
690,217,17,6602,13,6849
691,200,17,6602,13,6832
692,183,17,6602,13,6815
693,167,17,6602,13,6799
694,149,17,6602,13,6781
695,133,17,6602,13,6765
698,84,17,6602,13,6716
699,167,17,6502,13,6699
700,150,17,6502,13,6682
701,134,17,6502,13,6666
702,117,17,6502,13,6649
703,100,17,6502,13,6632
705,66,17,6502,13,6598
707,34,17,6502,13,6566
708,17,17,6502,13,6549
709,84,32,6403,13,6532
710,83,16,6403,13,6515
714,149,17,6350,16,6532
717,100,17,6350,16,6483
718,83,17,6350,16,6466
719,83,34,6316,16,6449
720,67,34,6316,16,6433
721,84,32,6284,16,6416
722,68,32,6284,16,6400
723,51,32,6284,16,6383
724,83,16,6251,16,6366
725,65,16,6251,16,6348
726,49,16,6251,16,6332
728,84,17,6183,16,6300
729,117,35,6115,16,6283
730,101,35,6115,16,6267
731,217,33,5984,16,6250
732,199,33,5984,16,6232
734,166,33,5984,16,6199
735,150,33,5984,16,6183
737,115,33,5984,16,6148
738,98,33,5984,16,6131
739,83,33,5984,16,6116
741,81,34,5950,16,6081
742,65,34,5950,16,6065
743,49,34,5950,16,6049
744,33,34,5950,16,6033
745,149,34,5817,16,6016
746,133,34,5817,16,6000
747,117,34,5817,16,5984
748,99,34,5817,16,5966
749,153,31,5751,16,5951
751,116,31,5751,16,5914
753,84,31,5751,16,5882
754,667,33,5235,14,5949
755,650,33,5235,14,5932
757,615,33,5235,14,5897
758,598,33,5235,14,5880
759,582,33,5235,14,5864
760,567,33,5235,14,5849
761,549,33,5235,14,5831
762,532,33,5235,14,5814
764,498,33,5235,14,5780
766,466,33,5235,14,5748
768,433,33,5235,14,5715
769,415,33,5235,14,5697
770,398,33,5235,14,5680
771,381,33,5235,14,5663
772,367,33,5235,14,5649
774,331,33,5235,14,5613
776,300,33,5235,14,5582
777,284,33,5235,14,5566
778,265,33,5235,14,5547
779,249,33,5235,14,5531
780,233,33,5235,14,5515
783,182,33,5235,14,5464
784,167,33,5235,14,5449
785,150,33,5235,14,5432
786,133,33,5235,14,5415
787,117,33,5235,14,5399
788,100,33,5235,14,5382
789,82,33,5235,14,5364
790,67,33,5235,14,5349
791,49,33,5235,14,5331
793,17,33,5235,14,5299
794,0,33,5235,14,5282
795,100,16,5135,14,5265
796,84,16,5135,14,5249
797,67,16,5135,14,5232
798,68,35,5100,14,5217
800,31,35,5100,14,5180
801,16,35,5100,14,5165
803,83,33,5001,14,5131
804,66,33,5001,14,5114
805,217,34,4832,14,5097
806,201,34,4832,14,5081
808,202,31,4801,14,5048
809,185,31,4801,14,5031
810,169,31,4801,14,5015
812,135,31,4801,14,4981
814,102,31,4801,14,4948
816,68,31,4801,14,4914
817,53,31,4801,14,4899
818,150,14,4702,14,4880
819,136,14,4702,14,4866
820,116,14,4702,14,4846
822,85,14,4702,14,4815
823,167,16,4601,14,4798
825,134,16,4601,14,4765
826,118,16,4601,14,4749
827,99,16,4601,14,4730
828,85,16,4601,14,4716
830,51,16,4601,14,4682
831,34,16,4601,14,4665
832,16,16,4601,14,4647
833,34,17,4566,14,4631
836,15,18,4533,14,4580
837,18,33,4500,14,4565
839,18,35,4465,14,4532
840,82,17,4401,14,4514
843,732,16,3715,18,4481
844,716,16,3715,18,4465
845,701,16,3715,18,4450
847,667,16,3715,18,4416
848,650,16,3715,18,4399
850,616,16,3715,18,4365
851,598,16,3715,18,4347
852,584,16,3715,18,4333
854,552,16,3715,18,4301
855,533,16,3715,18,4282
858,483,16,3715,18,4232
859,468,16,3715,18,4217
860,451,16,3715,18,4200
861,434,16,3715,18,4183
862,417,16,3715,18,4166
863,400,16,3715,18,4149
864,385,16,3715,18,4134
866,349,16,3715,18,4098
867,335,16,3715,18,4084
868,317,16,3715,18,4066
870,282,16,3715,18,4031
871,269,16,3715,18,4018
872,251,16,3715,18,4000
873,232,16,3715,18,3981
875,201,16,3715,18,3950
876,183,16,3715,18,3932
877,165,16,3715,18,3914
879,135,16,3715,18,3884
881,101,16,3715,18,3850
883,69,16,3715,18,3818
885,147,35,3581,18,3781
887,115,35,3581,18,3749
888,99,35,3581,18,3733
889,82,35,3581,18,3716
891,84,34,3547,18,3683
893,50,34,3547,18,3649
894,35,34,3547,18,3634
897,19,33,3514,18,3584
898,150,15,3382,18,3565
902,84,15,3382,18,3499
903,67,15,3382,18,3482
904,51,15,3382,18,3466
905,35,15,3382,18,3450
906,19,15,3382,18,3434
908,83,18,3281,18,3400
913,18,32,3318,18,3386
914,32,35,3283,18,3368
915,133,17,3184,18,3352
916,117,17,3184,18,3336
917,216,32,3051,18,3317
921,148,32,3051,18,3249
922,136,32,3051,18,3237
923,118,32,3051,18,3219
925,84,32,3051,18,3185
926,434,32,2684,18,3168
927,418,32,2684,18,3152
928,400,32,2684,18,3134
929,385,32,2684,18,3119
930,667,31,2385,18,3101
931,651,31,2385,18,3085
932,635,31,2385,18,3069
935,585,31,2385,18,3019
936,568,31,2385,18,3002
939,518,31,2385,18,2952
940,502,31,2385,18,2936
942,468,31,2385,18,2902
944,435,31,2385,18,2869
945,417,31,2385,18,2851
946,401,31,2385,18,2835
948,367,31,2385,18,2801
949,351,31,2385,18,2785
950,334,31,2385,18,2768
951,317,31,2385,18,2751
954,268,31,2385,18,2702
955,251,31,2385,18,2685
956,235,31,2385,18,2669
957,218,31,2385,18,2652
958,201,31,2385,18,2635
960,167,31,2385,18,2601
962,134,31,2385,18,2568
963,117,31,2385,18,2551
964,100,31,2385,18,2534
965,84,31,2385,18,2518
966,69,31,2385,18,2503
967,51,31,2385,18,2485
968,34,31,2385,18,2468
969,17,31,2385,18,2451
970,17,14,2385,18,2434
971,165,18,2216,18,2417
973,134,18,2216,18,2386
974,115,18,2216,18,2367
978,85,17,2182,18,2302
980,53,17,2182,18,2270
983,17,34,2148,18,2217
984,34,30,2118,18,2200
986,14,16,2118,18,2166
989,17,34,2050,18,2119
990,17,17,2050,18,2102
991,83,34,1950,18,2085
992,66,34,1950,18,2068
993,51,34,1950,18,2053
994,32,34,1950,18,2034
995,79,34,1884,18,2015
996,66,34,1884,18,2002
999,83,33,1817,18,1951
1001,49,33,1817,18,1917
1002,84,17,1783,18,1902
1003,67,17,1783,18,1885
1005,34,17,1783,18,1852
1006,17,17,1783,18,1835
1007,17,33,1750,18,1818
1008,181,20,1582,18,1801
1010,148,20,1582,18,1768
1012,166,34,1518,18,1736
1013,149,34,1518,18,1719
1014,131,34,1518,18,1701
1015,250,32,1434,17,1733
1016,233,32,1434,17,1716
1017,218,32,1434,17,1701
1018,201,32,1434,17,1684
1019,186,32,1434,17,1669
1020,166,32,1434,17,1649
1022,136,32,1434,17,1619
1023,116,32,1434,17,1599
1024,102,32,1434,17,1585
1025,83,32,1434,17,1566
1026,68,32,1434,17,1551
1027,51,32,1434,17,1534
1028,33,32,1434,17,1516
1029,18,32,1434,17,1501
1030,14,18,1434,17,1483
1031,0,18,1434,17,1469
1032,35,33,1366,17,1451
1033,166,16,1234,17,1433
1034,149,16,1234,17,1416
1035,135,16,1234,17,1402
1036,333,32,1001,17,1383
1037,319,32,1001,17,1369
1038,300,32,1001,17,1350
1039,284,32,1001,17,1334
1040,268,32,1001,17,1318
1041,250,32,1001,17,1300
1042,235,32,1001,17,1285
1043,217,32,1001,17,1267
1046,168,32,1001,17,1218
1048,135,32,1001,17,1185
1049,118,32,1001,17,1168
1051,151,34,932,17,1134
1052,134,34,932,17,1117
1053,118,34,932,17,1101
1054,100,34,932,17,1083
1055,84,34,932,17,1067
1056,67,34,932,17,1050
1057,51,34,932,17,1034
1061,18,33,899,17,967
1062,149,17,766,17,949
1064,116,17,766,17,916
1066,84,17,766,17,884
1068,184,17,633,17,851
1069,167,17,633,17,834
1070,150,17,633,17,817
1071,133,17,633,17,800
1072,116,17,633,17,783
1074,85,17,633,17,752
1075,468,16,351,15,850
1076,452,16,351,15,834
1078,483,16,285,15,799
1079,467,16,285,15,783
1080,450,16,285,15,766
1082,416,16,285,15,732
1083,401,16,285,15,717
1084,385,16,285,15,701
1085,367,16,285,15,683
1086,351,16,285,15,667
1087,335,16,285,15,651
1088,316,16,285,15,632
1090,284,16,285,15,600
1094,218,16,285,15,534
1095,201,16,285,15,517
1096,184,16,285,15,500
1098,151,16,285,15,467
1101,102,16,285,15,418
1102,99,34,251,15,399
1103,82,34,251,15,382
1104,66,34,251,15,366
1105,150,35,150,15,350
1106,134,35,150,15,334
1107,116,35,150,15,316
1108,100,35,150,15,300
1109,83,35,150,15,283
1110,83,18,150,15,266
1113,34,18,150,15,217
1114,17,18,150,15,200
1115,50,34,84,15,183
1116,32,34,84,15,165
1117,22,34,84,15,155
1119,0,17,84,15,116
1120,33,32,50,17,132
1121,17,32,50,17,116
1122,82,17,150,18,267
1123,83,35,115,18,251
1124,67,35,115,18,235
1125,48,35,115,18,216
1126,33,35,115,18,201
1128,35,32,83,18,168
1129,17,32,83,18,150
1130,14,18,83,18,133
1133,35,15,16,18,84
1134,34,34,19,13,100
1135,149,31,86,15,281
1137,118,31,86,15,250
1139,81,31,86,15,213
1140,68,31,86,15,200
1142,33,31,86,15,165
1143,18,31,86,15,150
1144,18,13,86,15,132
1145,32,17,50,15,114
1146,19,17,50,15,101
1147,17,32,18,15,82
1154,17,15,217,16,265
1157,149,33,33,19,234
1158,132,33,33,19,217
1159,116,33,33,19,201
1160,99,33,33,19,184
1161,2268,15,16,19,2318
1164,2217,15,16,19,2267
1168,2152,15,16,19,2202
1171,2100,15,16,19,2150
1173,2068,15,16,19,2118
1176,2017,15,16,19,2067
1177,2001,15,16,19,2051
1178,1984,15,16,19,2034
1179,1968,15,16,19,2018
1180,1951,15,16,19,2001
1182,1917,15,16,19,1967
1183,1901,15,16,19,1951
1185,1867,15,16,19,1917
1187,1834,15,16,19,1884
1189,1802,15,16,19,1852
1191,1769,15,16,19,1819
1192,1752,15,16,19,1802
1193,1734,15,16,19,1784
1195,1699,15,16,19,1749
1196,1685,15,16,19,1735
1197,1666,15,16,19,1716
1198,1652,15,16,19,1702
1199,1633,15,16,19,1683
1201,1602,15,16,19,1652
1202,1585,15,16,19,1635
1203,1567,15,16,19,1617
1204,1549,15,16,19,1599
1205,1533,15,16,19,1583
1206,1518,15,16,19,1568
1208,1485,15,16,19,1535
1209,1467,15,16,19,1517
1210,1452,15,16,19,1502
1211,1434,15,16,19,1484
1213,1401,15,16,19,1451
1216,1350,15,16,19,1400
1217,1333,15,16,19,1383
1218,1318,15,16,19,1368
1219,1300,15,16,19,1350
1220,1285,15,16,19,1335
1221,1269,15,16,19,1319
1223,1233,15,16,19,1283
1224,1218,15,16,19,1268
1225,1201,15,16,19,1251
1226,1185,15,16,19,1235
1228,1152,15,16,19,1202
1229,1133,15,16,19,1183
1230,1118,15,16,19,1168
1231,1101,15,16,19,1151
1232,1085,15,16,19,1135
1233,1066,15,16,19,1116
1235,1034,15,16,19,1084
1236,1018,15,16,19,1068
1239,968,15,16,19,1018
1240,951,15,16,19,1001
1242,916,15,16,19,966
1243,900,15,16,19,950
1244,885,15,16,19,935
1245,867,15,16,19,917
1246,852,15,16,19,902
1247,834,15,16,19,884
1249,800,15,16,19,850
1250,785,15,16,19,835
1251,767,15,16,19,817
1252,749,15,16,19,799
1253,748,35,17,15,815
1257,681,35,17,15,748
1258,665,35,17,15,732
1259,648,35,17,15,715
1260,632,35,17,15,699
1263,583,35,17,15,650
1264,564,35,17,15,631
1265,550,35,17,15,617
1266,532,35,17,15,599
1267,516,35,17,15,583
1268,498,35,17,15,565
1269,481,35,17,15,548
1270,467,35,17,15,534
1273,415,35,17,15,482
1274,399,35,17,15,466
1277,353,35,17,15,420
1278,332,35,17,15,399
1281,284,35,17,15,351
1283,249,35,17,15,316
1284,232,35,17,15,299
1285,214,35,17,15,281
1286,198,35,17,15,265
1287,183,35,17,15,250
1288,165,35,17,15,232
1289,150,35,17,15,217
1293,81,35,17,15,148
1297,15,35,17,15,82
1298,683,20,33,16,752
1299,667,20,33,16,736
1300,648,20,33,16,717
1301,631,20,33,16,700
1302,616,20,33,16,685
1303,598,20,33,16,667
1304,583,20,33,16,652
1306,1533,33,18,17,1601
1307,1516,33,18,17,1584
1309,1484,33,18,17,1552
1310,1468,33,18,17,1536
1311,1448,33,18,17,1516
1316,1365,33,18,17,1433
1317,1349,33,18,17,1417
1318,1331,33,18,17,1399
1319,1316,33,18,17,1384
1322,1267,33,18,17,1335
1323,1250,33,18,17,1318
1325,1217,33,18,17,1285
1327,1183,33,18,17,1251
1328,1167,33,18,17,1235
1330,1133,33,18,17,1201
1331,1114,33,18,17,1182
1332,1098,33,18,17,1166
1335,1047,33,18,17,1115
1336,1031,33,18,17,1099
1337,1017,33,18,17,1085
1338,1000,33,18,17,1068
1339,984,33,18,17,1052
1340,964,33,18,17,1032
1341,951,33,18,17,1019
1343,915,33,18,17,983
1344,900,33,18,17,968
1346,866,33,18,17,934
1347,849,33,18,17,917
1348,833,33,18,17,901
1349,817,33,18,17,885
1350,798,33,18,17,866
1352,766,33,18,17,834
1354,733,33,18,17,801
1355,716,33,18,17,784
1356,699,33,18,17,767
1357,683,33,18,17,751
1359,650,33,18,17,718
1360,631,33,18,17,699
1361,617,33,18,17,685
1362,600,33,18,17,668
1364,565,33,18,17,633
1366,534,33,18,17,602
1367,517,33,18,17,585
1368,501,33,18,17,569
1369,484,33,18,17,552
1371,449,33,18,17,517
1373,417,33,18,17,485
1374,401,33,18,17,469
1375,382,33,18,17,450
1376,365,33,18,17,433
1378,333,33,18,17,401
1379,317,33,18,17,385
1380,300,33,18,17,368
1381,281,33,18,17,349
1382,266,33,18,17,334
1384,232,33,18,17,300
1385,217,33,18,17,285
1386,199,33,18,17,267
1388,167,33,18,17,235
1389,150,33,18,17,218
1391,116,33,18,17,184
1392,100,33,18,17,168
1393,84,33,18,17,152
1394,65,33,18,17,133
1395,66,16,18,17,117
1396,50,16,18,17,101
1397,33,16,18,17,84
1398,17,16,18,17,68
1399,83,33,18,17,151
1400,84,16,18,17,135
1402,49,16,18,17,100
1403,117,35,18,13,183
1405,83,35,18,13,149
1407,84,31,20,15,150
1408,67,31,20,15,133
1409,51,31,20,15,117
1410,35,31,20,15,101
1411,152,33,250,16,451
1412,133,33,250,16,432
1413,115,33,250,16,414
1414,102,33,250,16,401
1415,82,33,250,16,381
1416,67,33,250,16,366
1418,185,17,116,16,334
1419,168,17,116,16,317
1421,134,17,116,16,283
1422,117,17,116,16,266
1423,183,33,18,16,250
1424,165,33,18,16,232
1428,100,33,18,16,167
1429,82,33,18,16,149
1430,65,33,18,16,132
1431,49,33,18,16,116
1432,84,16,16,19,135
1433,67,16,16,19,118
1434,102,29,20,16,167
1436,69,29,20,16,134
1438,35,29,20,16,100
1440,81,18,17,14,130
1441,84,31,36,17,168
1442,70,31,36,17,154
1443,50,31,36,17,134
1444,34,31,36,17,118
1446,31,36,34,14,115
1447,34,16,34,14,98
1448,36,34,31,17,118
1449,165,16,383,18,582
1451,132,16,383,18,549
1453,101,16,383,18,518
1454,84,16,383,18,501
1455,67,16,383,18,484
1456,100,35,315,18,468
1457,81,35,315,18,449
1460,33,35,315,18,401
1461,15,35,315,18,383
1462,35,31,284,18,368
1464,15,16,284,18,333
1465,16,34,250,18,318
1469,18,32,183,18,251
1471,17,36,147,18,218
1475,84,33,16,18,151
1477,49,33,16,18,116
1478,34,33,16,18,101
1480,33,34,17,16,100
1481,18,34,17,16,85
1482,34,33,16,18,101
1483,85,32,16,19,152
1484,83,16,16,19,134
1487,85,31,17,17,150
1488,98,34,34,18,184
1489,82,34,34,18,168
1490,83,17,34,18,152
1491,67,17,34,18,136
1492,133,34,16,15,198
1493,117,34,16,15,182
1494,102,34,16,15,167
1495,85,34,16,15,150
1496,85,17,16,15,133
1497,65,17,16,15,113
1499,33,17,16,15,81
1500,65,33,37,16,151
1501,48,33,37,16,134
1502,83,18,32,17,150
1503,67,18,32,17,134
1505,34,18,32,17,101
1507,100,16,16,17,149
1508,82,16,16,17,131
1509,66,16,16,17,115
1512,17,16,16,17,66
1513,0,16,16,17,49
1514,33,34,81,19,167
1515,17,34,81,19,151
1516,115,19,99,17,250
1518,81,19,99,17,216
1520,48,19,99,17,183
1521,32,19,99,17,167
1523,19,34,82,17,152
1524,0,34,82,17,133
1525,32,18,50,17,117
1526,14,18,50,17,99
1528,33,34,16,17,100
1529,85,35,14,19,153
1531,50,35,14,19,118
1533,33,19,14,19,85
1534,35,33,16,16,100
1535,19,33,16,16,84
1536,33,32,17,15,97
1538,16,16,17,15,64
1540,17,15,35,17,84
1542,35,33,49,19,136
1543,15,33,49,19,116
1544,33,33,35,16,117
1545,16,33,35,16,100
1546,33,35,49,16,133
1548,0,35,49,16,100
1549,19,31,18,16,84
1550,83,16,117,17,233
1552,150,19,33,16,218
1553,132,19,33,16,200
1554,116,19,33,16,184
1556,266,35,83,16,400
1557,248,35,83,16,382
1558,233,35,83,16,367
1560,199,35,83,16,333
1561,184,35,83,16,318
1563,149,35,83,16,283
1564,132,35,83,16,266
1565,116,35,83,16,250
1566,100,35,83,16,234
1568,166,34,84,15,299
1569,148,34,84,15,281
1570,134,34,84,15,267
1571,116,34,84,15,249
1572,100,34,84,15,233
1573,183,33,83,18,317
1576,133,33,83,18,267
1579,82,33,83,18,216
1582,33,33,83,18,167
1583,35,15,83,18,151
1585,15,33,84,18,150
1586,83,18,34,17,152
1590,15,18,34,17,84
1591,18,34,17,15,84
1592,148,18,17,17,200
1593,150,34,17,16,217
1596,100,34,17,16,167
1597,82,34,17,16,149
1600,33,34,17,16,100
1601,85,33,18,16,152
1603,50,33,18,16,117
1604,33,33,18,16,100
1606,267,33,71,29,400
1607,250,33,71,29,383
1608,234,33,71,29,367
1609,216,33,71,29,349
1611,184,33,71,29,317
1613,151,33,71,29,284
1615,115,33,71,29,248
1616,101,33,71,29,234
1617,83,33,71,29,216
1618,116,16,38,29,199
1619,101,16,38,29,184
1621,65,16,38,29,148
1623,33,16,38,29,116
1624,17,16,38,29,100
1625,16,38,45,17,116
1626,235,31,17,17,300
1629,185,31,17,17,250
1630,168,31,17,17,233
1632,135,31,17,17,200
1633,117,31,17,17,182
1634,101,31,17,17,166
1635,84,31,17,17,149
1636,68,31,17,17,133
1637,50,31,17,17,115
1639,33,16,17,17,83
1640,48,17,151,16,232
1641,83,35,83,16,217
1642,67,35,83,16,201
1643,50,35,83,16,184
1644,33,35,83,16,167
1645,35,17,83,16,151
1647,33,15,83,19,150
1648,83,16,34,15,148
1649,166,17,33,17,233
1653,99,17,33,17,166
1654,83,17,33,17,150
1655,268,16,118,17,419
1657,234,16,118,17,385
1658,217,16,118,17,368
1659,251,33,149,18,451
1660,234,33,149,18,434
1661,218,33,149,18,418
1662,201,33,149,18,401
1664,166,33,149,18,366
1665,150,33,149,18,350
1667,116,33,149,18,316
1668,99,33,149,18,299
1669,85,33,149,18,285
1670,68,33,149,18,268
1672,35,33,149,18,235
1674,17,16,149,18,200
1675,16,34,115,18,183
1677,33,17,82,18,150
1678,16,17,82,18,133
1679,17,32,50,18,117
1681,35,16,15,18,84
1683,16,33,17,16,82
1684,83,16,50,17,166
1685,68,16,50,17,151
1686,50,16,50,17,133
1689,16,32,18,17,83
1690,151,16,16,16,199
1692,119,16,16,16,167
1695,199,19,298,19,535
1696,183,19,298,19,519
1697,164,19,298,19,500
1698,149,19,298,19,485
1700,115,19,298,19,451
1701,99,19,298,19,435
1702,83,19,298,19,419
1703,65,19,298,19,401
1704,48,19,298,19,384
1705,302,14,86,14,416
1707,269,14,86,14,383
1708,250,14,86,14,364
1709,235,14,86,14,349
1710,216,14,86,14,330
1711,201,14,86,14,315
1712,185,14,86,14,299
1713,169,14,86,14,283
1714,152,14,86,14,266
1715,134,14,86,14,248
1716,117,14,86,14,231
1717,100,14,86,14,214
1718,164,33,82,19,298
1719,148,33,82,19,282
1720,131,33,82,19,265
1721,115,33,82,19,249
1722,96,33,82,19,230
1724,67,33,82,19,201
1726,33,33,82,19,167
1727,14,33,82,19,148
1728,33,35,47,19,134
1731,149,32,218,16,415
1732,250,17,651,15,933
1734,216,17,651,15,899
1737,167,17,651,15,850
1738,151,17,651,15,834
1739,135,17,651,15,818
1740,116,17,651,15,799
1741,99,17,651,15,782
1742,116,17,619,15,767
1743,98,17,619,15,749
1745,66,17,619,15,717
1746,47,17,619,15,698
1747,32,17,619,15,683
1748,15,17,619,15,666
1749,300,18,318,15,651
1751,265,18,318,15,616
1753,231,18,318,15,582
1754,215,18,318,15,566
1755,198,18,318,15,549
1756,182,18,318,15,533
1757,164,18,318,15,515
1758,149,18,318,15,500
1759,131,18,318,15,482
1760,115,18,318,15,466
1763,84,33,285,15,417
1764,68,33,285,15,401
1765,50,33,285,15,383
1766,34,33,285,15,367
1767,83,35,218,15,351
1768,65,35,218,15,333
1769,49,35,218,15,317
1770,32,35,218,15,300
1772,35,33,185,15,268
1774,16,17,185,15,233
1775,35,15,152,15,217
1777,15,33,119,15,182
1778,83,18,51,15,167
1779,85,35,80,17,217
1781,51,35,80,17,183
1782,34,35,80,17,166
1783,18,35,80,17,150
1785,34,15,49,17,115
1786,164,36,163,17,380
1787,148,36,163,17,364
1789,152,33,130,17,332
1791,120,33,130,17,300
1793,87,33,130,17,267
1794,69,33,130,17,249
1795,51,33,130,17,231
1797,136,16,31,17,200
1798,116,16,31,17,180
1799,102,16,31,17,166
1800,83,16,31,17,147
1801,69,16,31,17,133
1802,132,33,84,18,267
1803,116,33,84,18,251
1806,66,33,84,18,201
1807,46,33,84,18,181
1808,35,33,84,18,170
1810,84,17,83,15,199
1811,67,17,83,15,182
1812,84,18,49,15,166
1813,67,18,49,15,149
1814,50,18,49,15,132
1817,116,34,33,17,200
1818,98,34,33,17,182
1819,148,34,49,16,247
1823,84,34,49,16,183
1825,417,34,16,19,486
1826,399,34,16,19,468
1828,366,34,16,19,435
1829,349,34,16,19,418
1830,332,34,16,19,401
1832,301,34,16,19,370
1833,283,34,16,19,352
1834,267,34,16,19,336
1835,247,34,16,19,316
1838,199,34,16,19,268
1839,184,34,16,19,253
1840,200,35,34,14,283
1842,168,35,34,14,251
1843,150,35,34,14,233
1844,132,35,34,14,215
1847,82,35,34,14,165
1848,67,35,34,14,150
1850,34,35,34,14,117
1851,15,35,34,14,98
1852,16,19,34,14,83
1854,16,18,463,18,515
1855,18,31,432,18,499
1856,14,17,432,18,481
1857,333,19,97,18,467
1858,316,19,97,18,450
1859,299,19,97,18,433
1860,282,19,97,18,416
1861,266,19,97,18,400
1862,250,19,97,18,384
1863,650,35,124,28,837
1864,633,35,124,28,820
1865,615,35,124,28,802
1866,599,35,124,28,786
1867,584,35,124,28,771
1868,565,35,124,28,752
1869,549,35,124,28,736
1870,533,35,124,28,720
1872,499,35,124,28,686
1873,482,35,124,28,669
1875,449,35,124,28,636
1876,432,35,124,28,619
1878,398,35,124,28,585
1879,384,35,124,28,571
1880,368,35,124,28,555
1881,349,35,124,28,536
1882,332,35,124,28,519
1883,333,19,124,28,504
1884,317,19,124,28,488
1885,299,19,124,28,470
1886,282,19,124,28,453
1887,266,19,124,28,437
1888,250,19,124,28,421
1889,233,19,124,28,404
1890,217,19,124,28,388
1891,655,31,353,16,1055
1892,637,31,353,16,1037
1893,623,31,353,16,1023
1894,606,31,353,16,1006
1895,589,31,353,16,989
1896,572,31,353,16,972
1897,554,31,353,16,954
1899,521,31,353,16,921
1900,504,31,353,16,904
1901,486,31,353,16,886
1902,472,31,353,16,872
1904,437,31,353,16,837
1905,418,31,353,16,818
1906,404,31,353,16,804
1907,313,31,353,16,713
1908,308,31,353,16,708
1909,301,31,353,16,701
1911,267,31,353,16,667
1912,251,31,353,16,651
1913,233,31,353,16,633
1914,219,31,353,16,619
1915,199,31,353,16,599
1917,167,31,353,16,567
1918,150,31,353,16,550
1919,135,31,353,16,535
1923,83,16,353,16,468
1924,81,19,334,16,450
1926,49,19,334,16,418
1927,31,19,334,16,400
1928,16,19,334,16,385
1930,17,33,284,16,350
1932,84,18,201,16,319
1933,217,49,34,16,316
1934,200,49,34,16,299
1936,168,49,34,16,267
1938,217,16,17,37,287
1940,183,16,17,37,253
1944,120,16,17,37,190
1945,100,16,17,37,170
1946,83,16,17,37,153
1948,52,16,17,37,122
1949,34,16,17,37,104
1951,2284,32,168,18,2502
1955,2214,32,168,18,2432
1957,2182,32,168,18,2400
1958,2166,32,168,18,2384
1959,2148,32,168,18,2366
1960,2132,32,168,18,2350
1961,2115,32,168,18,2333
1962,2101,32,168,18,2319
1964,2350,17,16,17,2400
1965,2333,17,16,17,2383
1967,2300,17,16,17,2350
1969,2266,17,16,17,2316
1970,2250,17,16,17,2300
1971,2231,17,16,17,2281
1972,2217,17,16,17,2267
1974,2184,17,16,17,2234
1975,2166,17,16,17,2216
1976,2150,17,16,17,2200
1978,2115,17,16,17,2165
1980,2083,17,16,17,2133
1981,2065,17,16,17,2115
1982,2050,17,16,17,2100
1985,2001,17,16,17,2051
1986,1983,17,16,17,2033
1987,1966,17,16,17,2016
1988,1949,17,16,17,1999
1989,1933,17,16,17,1983
1990,1916,17,16,17,1966
1991,1900,17,16,17,1950
1992,1882,17,16,17,1932
1993,1867,17,16,17,1917
1994,1849,17,16,17,1899
1997,1801,17,16,17,1851
1999,1766,17,16,17,1816
2000,1749,17,16,17,1799
2001,1734,17,16,17,1784
2002,1715,17,16,17,1765
2003,1701,17,16,17,1751
2004,1684,17,16,17,1734
2005,1667,17,16,17,1717
2006,1700,35,17,16,1768
2007,1682,35,17,16,1750
2008,1665,35,17,16,1733
2009,1651,35,17,16,1719
2010,1632,35,17,16,1700
2011,1618,35,17,16,1686
2013,1582,35,17,16,1650
2014,1565,35,17,16,1633
2015,1549,35,17,16,1617
2016,1534,35,17,16,1602
2018,1501,35,17,16,1569
2025,1383,35,17,16,1451
2026,1363,35,17,16,1431
2027,1351,35,17,16,1419
2028,1334,35,17,16,1402
2029,1316,35,17,16,1384
2030,1300,35,17,16,1368
2031,1282,35,17,16,1350
2033,1249,35,17,16,1317
2034,1233,35,17,16,1301
2035,1217,35,17,16,1285
2036,1200,35,17,16,1268
2037,1182,35,17,16,1250
2039,1149,35,17,16,1217
2040,1133,35,17,16,1201
2043,1083,35,17,16,1151
2045,1049,35,17,16,1117
2046,1032,35,17,16,1100
2047,1016,35,17,16,1084
2049,984,35,17,16,1052
2050,966,35,17,16,1034
2052,933,35,17,16,1001
2053,985,32,117,16,1150
2054,968,32,117,16,1133
2055,951,32,117,16,1116
2056,936,32,117,16,1101
2058,902,32,117,16,1067
2059,883,32,117,16,1048
2060,869,32,117,16,1034
2061,852,32,117,16,1017
2062,835,32,117,16,1000
2063,818,32,117,16,983
2064,800,32,117,16,965
2067,750,32,117,16,915
2068,734,32,117,16,899
2069,719,32,117,16,884
2070,700,32,117,16,865
2071,684,32,117,16,849
2072,667,32,117,16,832
2073,651,32,117,16,816
2074,634,32,117,16,799
2075,618,32,117,16,783
2078,568,32,117,16,733
2080,534,32,117,16,699
2081,517,32,117,16,682
2082,502,32,117,16,667
2083,485,32,117,16,650
2084,468,32,117,16,633
2085,453,32,117,16,618
2086,433,32,117,16,598
2087,417,32,117,16,582
2088,401,32,117,16,566
2090,369,32,117,16,534
2092,334,32,117,16,499
2093,384,33,49,16,482
2094,368,33,49,16,466
2095,352,33,49,16,450
2096,335,33,49,16,433
2097,317,33,49,16,415
2098,302,33,49,16,400
2100,268,33,49,16,366
2102,234,33,49,16,332
2103,219,33,49,16,317
2104,201,33,49,16,299
2105,185,33,49,16,283
2106,168,33,49,16,266
2107,152,33,49,16,250
2108,135,33,49,16,233
2111,83,33,49,16,181
2112,67,33,49,16,165
2113,51,33,49,16,149
2114,35,33,49,16,133
2115,19,33,49,16,117
2116,15,18,49,16,98
2117,18,33,16,16,83
2119,150,35,114,18,317
2121,116,35,114,18,283
2122,100,35,114,18,267
2123,84,35,114,18,251
2124,234,35,33,16,318
2125,217,35,33,16,301
2127,182,35,33,16,266
2128,167,35,33,16,251
2130,132,35,33,16,216
2131,117,35,33,16,201
2132,99,35,33,16,183
2133,83,35,33,16,167
2134,151,17,115,17,300
2135,134,17,115,17,283
2137,102,17,115,17,251
2138,84,17,115,17,233
2139,67,17,115,17,216
2140,49,17,115,17,198
2141,33,17,115,17,182
2144,233,33,17,17,300
2145,216,33,17,17,283
2146,200,33,17,17,267
2148,167,33,17,17,234
2149,152,33,17,17,219
2151,118,33,17,17,185
2152,101,33,17,17,168
2154,82,17,17,17,133
2155,83,34,17,15,149
2156,183,18,35,16,252
2157,167,18,35,16,236
2160,116,18,35,16,185
2161,99,18,35,16,168
2162,135,32,48,17,232
2163,118,32,48,17,215
2164,103,32,48,17,200
2165,85,32,48,17,182
2166,69,32,48,17,166
2167,53,32,48,17,150
2169,18,32,48,17,115
2170,0,32,48,17,97
2171,81,33,50,17,181
2172,65,33,50,17,165
2173,50,33,50,17,150
2176,100,34,82,18,234
2177,83,34,82,18,217
2178,67,34,82,18,201
2179,50,34,82,18,184
2180,34,34,82,18,168
2181,17,34,82,18,151
2182,0,34,82,18,134
2183,33,17,49,18,117
2184,149,18,17,15,199
2185,133,18,17,15,183
2186,116,18,17,15,166
2187,100,18,17,15,150
2188,82,18,17,15,132
2190,84,15,83,18,200
2191,83,37,46,18,184
2192,65,37,46,18,166
2193,50,37,46,18,151
2194,32,37,46,18,133
2195,15,37,46,18,116
2197,33,18,15,18,84
2198,13,18,15,18,64
2199,85,32,18,16,151
2200,133,32,51,17,233
2202,100,32,51,17,200
2203,115,35,149,19,318
2204,98,35,149,19,301
2205,81,35,149,19,284
2206,66,35,149,19,269
2207,48,35,149,19,251
2208,32,35,149,19,235
2209,15,35,149,19,218
2211,17,33,116,19,185
2212,33,33,83,19,168
2213,217,33,50,18,318
2215,184,33,50,18,285
2216,167,33,50,18,268
2217,151,33,50,18,252
2220,100,33,50,18,201
2221,84,33,50,18,185
2222,65,33,50,18,166
2224,116,18,16,16,166
2225,98,18,16,16,148
2226,83,18,16,16,133
2227,66,18,16,16,116
2228,50,18,16,16,100
2230,16,18,16,16,66
2231,1050,37,297,17,1401
2232,1032,37,297,17,1383
2233,1016,37,297,17,1367
2234,1000,37,297,17,1351
2235,982,37,297,17,1333
2237,949,37,297,17,1300
2238,934,37,297,17,1285
2239,918,37,297,17,1269
2240,900,37,297,17,1251
2242,865,37,297,17,1216
2243,849,37,297,17,1200
2248,767,37,297,17,1118
2249,749,37,297,17,1100
2250,733,37,297,17,1084
2251,715,37,297,17,1066
2252,700,37,297,17,1051
2253,684,37,297,17,1035
2254,667,37,297,17,1018
2256,633,37,297,17,984
2257,616,37,297,17,967
2259,583,37,297,17,934
2260,565,37,297,17,916
2261,549,37,297,17,900
2262,533,37,297,17,884
2268,433,37,297,17,784
2269,417,37,297,17,768
2271,384,37,297,17,735
2272,365,37,297,17,716
2273,350,37,297,17,701
2274,334,37,297,17,685
2275,317,37,297,17,668
2276,301,37,297,17,652
2277,384,49,185,17,635
2278,368,49,185,17,619
2279,351,49,185,17,602
2280,333,49,185,17,584
2281,316,49,185,17,567
2284,266,49,185,17,517
2287,215,49,185,17,466
2288,199,49,185,17,450
2289,182,49,185,17,433
2290,166,49,185,17,417
2291,150,49,185,17,401
2292,133,49,185,17,384
2293,117,49,185,17,368
2294,100,49,185,17,351
2295,84,49,185,17,335
2296,80,32,185,17,314
2297,69,32,185,17,303
2298,83,18,167,17,285
2299,66,18,167,17,268
2300,251,17,34,16,318
2301,234,17,34,16,301
2302,220,17,34,16,287
2303,202,17,34,16,269
2308,119,17,34,16,186
2310,85,17,34,16,152
2311,67,17,34,16,134
2312,51,17,34,16,118
2313,34,17,34,16,101
2314,17,17,34,16,84
2315,149,35,32,16,232
2316,132,35,32,16,215
2317,117,35,32,16,200
2318,98,35,32,16,181
2319,82,35,32,16,165
2322,32,35,32,16,115
2323,15,35,32,16,98
2326,16,16,16,17,65
2327,16,33,33,18,100
2328,0,33,33,18,84
2329,35,15,84,17,151
2330,18,15,84,17,134
2331,33,16,50,17,116
2332,18,16,50,17,101
2333,16,34,16,17,83
2334,34,33,34,16,117
2335,32,17,34,16,99
2336,16,17,34,16,83
2339,88,29,150,17,284
2340,69,29,150,17,265
2341,82,36,114,17,249
2342,66,36,114,17,233
2343,48,36,114,17,215
2344,145,19,15,17,196
2346,116,19,15,17,167
2347,99,19,15,17,150
2348,80,19,15,17,131
2349,136,14,19,16,185
2352,86,14,19,16,135
2353,70,14,19,16,119
2354,1484,18,48,17,1567
2355,1469,18,48,17,1552
2356,1452,18,48,17,1535
2357,1433,18,48,17,1516
2358,1419,18,48,17,1502
2360,1384,18,48,17,1467
2363,1338,18,48,17,1421
2364,1317,18,48,17,1400
2365,1303,18,48,17,1386
2366,1285,18,48,17,1368
2367,1267,18,48,17,1350
2372,1184,18,48,17,1267
2373,1167,18,48,17,1250
2374,1150,18,48,17,1233
2375,1134,18,48,17,1217
2376,1119,18,48,17,1202
2377,1100,18,48,17,1183
2378,1084,18,48,17,1167
2379,1068,18,48,17,1151
2380,1051,18,48,17,1134
2381,1036,18,48,17,1119
2382,1018,18,48,17,1101
2384,984,18,48,17,1067
2385,968,18,48,17,1051
2387,934,18,48,17,1017
2388,918,18,48,17,1001
2390,884,18,48,17,967
2391,867,18,48,17,950
2392,850,18,48,17,933
2394,814,18,48,17,897
2395,802,18,48,17,885
2396,784,18,48,17,867
2397,835,17,82,18,952
2398,817,17,82,18,934
2399,801,17,82,18,918
2400,783,17,82,18,900
2401,766,17,82,18,883
2404,719,17,82,18,836
2405,700,17,82,18,817
2407,666,17,82,18,783
2408,652,17,82,18,769
2411,600,17,82,18,717
2412,583,17,82,18,700
2413,567,17,82,18,684
2414,550,17,82,18,667
2415,534,17,82,18,651
2417,501,17,82,18,618
2418,484,17,82,18,601
2419,468,17,82,18,585
2420,452,17,82,18,569
2421,433,17,82,18,550
2422,417,17,82,18,534
2423,400,17,82,18,517
2424,385,17,82,18,502
2425,368,17,82,18,485
2427,334,17,82,18,451
2428,317,17,82,18,434
2429,302,17,82,18,419
2430,284,17,82,18,401
2431,267,17,82,18,384
2432,250,17,82,18,367
2433,236,17,82,18,353
2434,217,17,82,18,334
2435,200,17,82,18,317
2436,200,32,118,15,365
2437,185,32,118,15,350
2438,166,32,118,15,331
2439,150,32,118,15,315
2440,135,32,118,15,300
2441,118,32,118,15,283
2443,83,32,118,15,248
2444,65,32,118,15,230
2445,52,32,118,15,217
2446,36,32,118,15,201
2447,17,32,118,15,182
2448,17,15,118,15,165
2449,32,16,85,15,148
2450,33,35,50,15,133
2451,150,33,50,17,250
2453,117,33,50,17,217
2454,99,33,50,17,199
2456,66,33,50,17,166
2457,49,33,50,17,149
2458,34,33,50,17,134
2459,16,33,50,17,116
2462,167,34,115,18,334
2463,149,34,115,18,316
2464,132,34,115,18,299
2465,117,34,115,18,284
2466,184,15,50,18,267
2468,150,15,50,18,233
2469,133,15,50,18,216
2471,102,15,50,18,185
2475,149,34,150,18,351
2476,133,34,150,18,335
2479,81,34,150,18,283
2481,69,15,150,18,252
2482,51,15,150,18,234
2483,33,15,150,18,216
2484,19,15,150,18,202
2485,32,18,115,18,183
2486,17,18,115,18,168
2487,18,31,84,18,151
2488,15,16,84,18,133
2489,34,16,50,18,118
2490,84,18,16,17,135
2492,50,18,16,17,101
2493,499,16,468,15,998
2494,483,16,468,15,982
2495,467,16,468,15,966
2496,449,16,468,15,948
2497,433,16,468,15,932
2498,416,16,468,15,915
2499,398,16,468,15,897
2500,381,16,468,15,880
2501,367,16,468,15,866
2502,350,16,468,15,849
2503,334,16,468,15,833
2504,318,16,468,15,817
2506,285,16,468,15,784
2508,250,16,468,15,749
2509,234,16,468,15,733
2510,216,16,468,15,715
2511,200,16,468,15,699
2512,183,16,468,15,682
2513,167,16,468,15,666
2516,116,16,468,15,615
2518,82,16,468,15,581
2520,51,16,468,15,550
2521,33,16,468,15,532
2522,16,16,468,15,515
2523,118,31,335,15,499
2524,102,31,335,15,483
2525,284,34,149,17,484
2526,267,34,149,17,467
2527,249,34,149,17,449
2529,217,34,149,17,417
2530,198,34,149,17,398
2533,149,34,149,17,349
2534,134,34,149,17,334
2535,116,34,149,17,316
2536,100,34,149,17,300
2537,252,32,151,17,452
2538,235,32,151,17,435
2539,218,32,151,17,418
2541,185,32,151,17,385
2542,168,32,151,17,368
2543,149,32,151,17,349
2544,134,32,151,17,334
2545,300,17,83,17,417
2548,249,17,83,17,366
2550,218,17,83,17,335
2552,183,17,83,17,300
2553,168,17,83,17,285
2554,151,17,83,17,268
2556,118,17,83,17,235
2557,104,17,83,17,221
2559,66,17,83,17,183
2561,33,17,83,17,150
2562,18,17,83,17,135
2563,117,32,18,16,183
2564,100,32,18,16,166
2566,68,32,18,16,134
2567,51,32,18,16,117
2568,34,32,18,16,100
2569,17,32,18,16,83
2570,16,16,18,16,66
2573,16,33,84,32,165
2574,17,16,84,32,149
2575,82,50,1001,17,1150
2577,50,50,1001,17,1118
2578,152,17,915,17,1101
2580,119,17,915,17,1068
2581,101,17,915,17,1050
2582,86,17,915,17,1035
2583,69,17,915,17,1018
2584,49,17,915,17,998
2586,20,17,915,17,969
2587,130,20,782,17,949
2588,113,20,782,17,932
2589,97,20,782,17,916
2590,81,20,782,17,900
2591,65,20,782,17,884
2592,49,20,782,17,868
2593,32,20,782,17,851
2594,36,31,751,17,835
2595,34,17,751,17,819
2596,81,17,684,17,799
2597,67,17,684,17,785
2598,50,17,684,17,768
2599,33,17,684,17,751
2600,17,17,684,17,735
2601,17,34,650,17,718
2602,34,33,617,17,701
2603,16,33,617,17,683
2604,33,33,584,17,667
2606,17,16,584,17,634
2608,34,33,517,17,601
2609,16,33,517,17,583
2611,16,35,482,17,550
2612,0,35,482,17,534
2613,32,17,450,17,516
2614,97,34,351,17,499
2615,82,34,351,17,484
2617,84,35,316,17,452
2618,65,35,316,17,433
2619,48,35,316,17,416
2622,17,18,316,17,368
2623,33,16,285,17,351
2624,15,16,285,17,333
2625,16,35,250,17,318
2626,68,33,184,17,302
2627,49,33,184,17,283
2628,33,33,184,17,267
2629,16,33,184,17,250
2632,16,18,150,17,201
2633,18,34,116,17,185
2635,33,17,84,17,151
2637,35,15,51,17,118
2638,33,35,16,17,101
2639,15,35,16,17,83
2640,284,17,32,17,350
2641,265,17,32,17,331
2642,249,17,32,17,315
2644,216,17,32,17,282
2645,201,17,32,17,267
2647,167,17,32,17,233
2648,149,17,32,17,215
2649,132,17,32,17,198
2650,117,17,32,17,183
2651,101,17,32,17,167
2652,83,17,32,17,149
2654,67,32,17,18,134
2655,51,32,17,18,118
2656,35,32,17,18,102
2657,17,32,17,18,84
2658,82,17,20,14,133
2659,82,34,14,21,151
2661,50,34,14,21,119
2663,135,16,985,16,1152
2664,118,16,985,16,1135
2665,98,16,985,16,1115
2666,84,16,985,16,1101
2669,34,16,985,16,1051
2671,149,33,917,18,1117
2672,133,33,917,18,1101
2673,117,33,917,18,1085
2675,83,33,917,18,1051
2678,82,18,882,18,1000
2679,66,18,882,18,984
2680,50,18,882,18,968
2681,32,18,882,18,950
2683,32,19,849,18,918
2684,33,32,817,18,900
2685,19,32,817,18,886
2687,83,34,716,18,851
2688,67,34,716,18,835
2689,333,16,449,18,816
2690,317,16,449,18,800
2691,302,16,449,18,785
2692,285,16,449,18,768
2694,251,16,449,18,734
2695,235,16,449,18,718
2696,218,16,449,18,701
2697,200,16,449,18,683
2698,183,16,449,18,666
2700,152,16,449,18,635
2701,134,16,449,18,617
2702,119,16,449,18,602
2703,102,16,449,18,585
2704,84,16,449,18,567
2705,66,16,449,18,549
2706,51,16,449,18,534
2707,33,16,449,18,516
2710,84,17,348,18,467
2711,66,17,348,18,449
2712,51,17,348,18,434
2713,36,17,348,18,419
2714,17,17,348,18,400
2716,33,31,284,18,366
2717,118,33,365,17,533
2718,100,33,365,17,515
2719,85,33,365,17,500
2722,35,33,365,17,450
2723,19,33,365,17,434
2724,366,32,151,18,567
2726,333,32,151,18,534
2727,315,32,151,18,516
2729,283,32,151,18,484
2730,267,32,151,18,468
2731,249,32,151,18,450
2732,233,32,151,18,434
2734,201,32,151,18,402
2735,184,32,151,18,385
2736,168,32,151,18,369
2737,151,32,151,18,352
2738,133,32,151,18,334
2739,117,32,151,18,318
2741,84,32,151,18,285
2742,68,32,151,18,269
2743,52,32,151,18,253
2745,19,32,151,18,220
2746,32,35,116,18,201
2747,17,35,116,18,186
2749,0,18,116,18,152
2750,0,32,84,18,134
2751,12,35,49,18,114
2752,135,33,34,15,217
2754,100,33,34,15,182
2755,83,33,34,15,165
2756,69,33,34,15,151
2757,84,34,31,17,166
2758,66,34,31,17,148
2759,48,34,31,17,130
2760,33,34,31,17,115
2761,33,17,31,17,98
2763,84,34,17,15,150
2767,19,34,17,15,85
2768,115,16,21,31,183
2770,81,16,21,31,149
2771,64,16,21,31,132
2772,86,31,148,19,284
2774,303,32,84,15,434
2775,285,32,84,15,416
2776,269,32,84,15,400
2780,201,32,84,15,332
2782,168,32,84,15,299
2783,153,32,84,15,284
2784,136,32,84,15,267
2785,118,32,84,15,249
2786,102,32,84,15,233
2787,117,33,51,15,216
2788,101,33,51,15,200
2789,82,33,51,15,181
2790,67,33,51,15,166
2791,50,33,51,15,149
2792,32,33,51,15,131
2793,34,16,51,15,116
2794,17,16,51,15,99
2798,16,15,18,17,66
2799,33,17,15,18,83
2800,35,33,17,16,101
2802,33,33,18,15,99
2803,35,16,18,15,84
2804,33,33,182,20,268
2805,34,15,182,20,251
2806,18,15,182,20,235
2807,15,36,146,20,217
2808,18,18,146,20,202
2810,113,19,249,18,399
2811,99,19,249,18,385
2812,101,34,215,18,368
2813,85,34,215,18,352
2814,67,34,215,18,334
2815,50,34,215,18,317
2816,35,34,215,18,302
2817,19,34,215,18,286
2819,34,17,217,15,283
2821,17,33,184,15,249
2822,17,16,184,15,232
2823,16,33,151,15,215
2827,32,19,81,15,147
2828,15,19,81,15,130
2829,19,32,149,15,215
2830,32,34,148,18,232
2831,80,34,84,18,216
2832,133,31,18,18,200
2833,117,31,18,18,184
2834,99,31,18,18,166
2835,84,31,18,18,151
2836,69,31,18,18,136
2837,48,31,18,18,115
2838,35,31,18,18,102
2839,19,31,18,18,86
2841,149,35,115,19,318
2842,134,35,115,19,303
2844,98,35,115,19,267
2845,82,35,115,19,251
2849,16,35,115,19,185
2850,83,18,49,19,169
2851,63,18,49,19,149
2852,48,18,49,19,134
2855,18,33,35,16,102
2856,33,35,99,16,183
2857,12,35,99,16,162
2858,35,32,67,16,150
2859,19,32,67,16,134
2860,0,32,67,16,115
2861,83,36,13,18,150
2863,52,36,13,18,119
2865,84,31,34,18,167
2866,67,31,34,18,150
2867,51,31,34,18,134
2869,83,34,184,16,317
2870,65,34,184,16,299
2871,99,18,149,16,282
2872,85,18,149,16,268
2873,67,18,149,16,250
2874,51,18,149,16,234
2875,200,16,251,17,484
2876,184,16,251,17,468
2879,169,16,217,17,419
2880,151,16,217,17,401
2881,134,16,217,17,384
2882,118,16,217,17,368
2883,102,16,217,17,352
2885,69,16,217,17,319
2886,51,16,217,17,301
2887,34,16,217,17,284
2888,18,16,217,17,268
2889,16,34,183,17,250
2890,16,18,183,17,234
2891,467,18,217,14,716
2892,449,18,217,14,698
2893,433,18,217,14,682
2895,401,18,217,14,650
2896,384,18,217,14,633
2897,367,18,217,14,616
2899,333,18,217,14,582
2901,301,18,217,14,550
2903,266,18,217,14,515
2904,249,18,217,14,498
2905,233,18,217,14,482
2906,217,18,217,14,466
2907,201,18,217,14,450
2908,182,18,217,14,431
2909,170,18,217,14,419
2910,150,18,217,14,399
2911,132,18,217,14,381
2912,115,18,217,14,364
2913,100,18,217,14,349
2914,84,18,217,14,333
2916,49,18,217,14,298
2917,31,18,217,14,280
2918,15,18,217,14,264
2922,16,19,151,14,200
2924,15,17,283,18,333
2926,33,34,216,18,301
2927,148,33,149,20,350
2928,134,33,149,20,336
2930,100,33,149,20,302
2932,84,15,149,20,268
2934,85,17,114,20,236
2936,85,15,82,20,202
2937,67,15,82,20,184
2939,151,31,19,14,215
2942,102,31,19,14,166
2943,86,31,19,14,150
2945,50,31,19,14,114
2946,34,31,19,14,98
2947,35,16,19,14,84
2949,16,33,267,17,333
2951,32,15,234,17,298
2952,300,35,1065,17,1417
2954,267,35,1065,17,1384
2955,248,35,1065,17,1365
2957,216,35,1065,17,1333
2959,181,35,1065,17,1298
2960,167,35,1065,17,1284
2962,148,18,1065,17,1248
2963,132,18,1065,17,1232
2964,115,18,1065,17,1215
2967,749,34,717,15,1515
2968,733,34,717,15,1499
2972,665,34,717,15,1431
2973,649,34,717,15,1415
2975,617,34,717,15,1383
2976,600,34,717,15,1366
2977,584,34,717,15,1350
2978,567,34,717,15,1333
2979,550,34,717,15,1316
2980,532,34,717,15,1298
2981,517,34,717,15,1283
2984,464,34,717,15,1230
2987,414,34,717,15,1180
2988,400,34,717,15,1166
2989,382,34,717,15,1148
2990,366,34,717,15,1132
2993,317,34,717,15,1083
2995,281,34,717,15,1047
2996,266,34,717,15,1032
2999,216,34,717,15,982
3000,198,34,717,15,964
3002,167,34,717,15,933
3003,148,34,717,15,914
3004,367,33,483,15,898
3005,351,33,483,15,882
3006,335,33,483,15,866
3008,301,33,483,15,832
3010,266,33,483,15,797
3011,250,33,483,15,781
3012,235,33,483,15,766
3014,201,33,483,15,732
3015,184,33,483,15,715
3016,168,33,483,15,699
3017,150,33,483,15,681
3018,135,33,483,15,666
3019,116,33,483,15,647
3021,83,33,483,15,614
3022,67,33,483,15,598
3023,52,33,483,15,583
3024,32,33,483,15,563
3027,17,34,565,16,632
3031,14,36,498,16,564
3032,84,21,647,16,768
3033,65,21,647,16,749
3034,48,21,647,16,732
3037,0,21,647,16,684
3039,82,35,517,16,650
3040,65,35,517,16,633
3042,32,35,517,16,600
3043,15,35,517,16,583
3044,135,33,384,16,568
3047,84,33,384,16,517
3051,16,33,384,16,449
3053,16,34,350,16,416
3054,34,31,319,16,400
3055,34,15,319,16,384
3056,16,15,319,16,366
3057,132,17,185,16,350
3060,83,17,185,16,301
3062,49,17,185,16,267
3063,32,17,185,16,250
3064,16,17,185,16,234
3065,0,17,185,16,218
3066,18,16,151,16,201
3067,84,32,67,17,200
3070,35,32,67,17,151
3071,150,33,150,18,351
3073,149,33,316,17,515
3074,134,33,316,17,500
3075,118,33,316,17,484
3077,83,33,316,17,449
3078,149,17,250,17,433
3080,115,17,250,17,399
3082,82,17,250,17,366
3083,66,17,250,17,350
3084,149,18,149,17,333
3085,132,18,149,17,316
3086,117,18,149,17,301
3089,65,18,149,17,249
3090,49,18,149,17,233
3091,84,33,149,16,282
3092,165,33,50,16,264
3093,151,33,50,16,250
3096,99,33,50,16,198
3097,83,33,50,16,182
3098,267,33,82,16,398
3099,250,33,82,16,381
3100,234,33,82,16,365
3103,185,33,82,16,316
3106,135,33,82,16,266
3108,102,33,82,16,233
3109,85,33,82,16,216
3110,148,21,47,15,231
3113,100,21,47,15,183
3116,48,21,47,15,131
3120,81,15,284,17,397
3121,68,15,284,17,384
3123,34,15,284,17,350
3124,19,15,284,17,335
3125,84,33,182,17,316
3126,169,32,83,17,301
3127,152,32,83,17,284
3129,119,32,83,17,251
3130,100,32,83,17,232
3131,85,32,83,17,217
3132,67,32,83,17,199
3134,34,32,83,17,166
3135,32,17,83,17,149
3136,148,17,17,18,200
3137,133,17,17,18,185
3138,116,17,17,18,168
3140,83,17,17,18,135
3141,67,17,17,18,119
3142,49,17,17,18,101
3143,33,17,17,18,85
3144,16,17,17,18,68
3145,34,18,16,15,83
3146,35,31,18,15,99
3147,34,15,18,15,82
3148,49,15,118,16,198
3149,33,15,118,16,182
3150,18,15,118,16,167
3151,15,34,84,16,149
3155,82,34,199,18,333
3156,82,18,199,18,317
3159,32,18,199,18,267
3160,84,18,131,18,251
3162,50,18,131,18,217
3164,16,18,131,18,183
3165,33,16,100,18,167
3166,31,34,66,18,149
3167,33,17,66,18,134
3168,17,17,66,18,118
3169,17,33,33,18,101
3170,1051,16,1417,16,2500
3171,1034,16,1417,16,2483
3172,1018,16,1417,16,2467
3175,967,16,1417,16,2416
3177,935,16,1417,16,2384
3178,917,16,1417,16,2366
3179,902,16,1417,16,2351
3180,885,16,1417,16,2334
3181,868,16,1417,16,2317
3186,783,16,1417,16,2232
3187,767,16,1417,16,2216
3191,701,16,1417,16,2150
3193,666,16,1417,16,2115
3195,635,16,1417,16,2084
3197,602,16,1417,16,2051
3200,550,16,1417,16,1999
3202,517,16,1417,16,1966
3204,484,16,1417,16,1933
3205,463,16,1417,16,1912
3206,450,16,1417,16,1899
3207,433,16,1417,16,1882
3208,418,16,1417,16,1867
3211,367,16,1417,16,1816
3212,351,16,1417,16,1800
3213,333,16,1417,16,1782
3215,300,16,1417,16,1749
3217,266,16,1417,16,1715
3219,234,16,1417,16,1683
3220,217,16,1417,16,1666
3221,202,16,1417,16,1651
3222,183,16,1417,16,1632
3223,169,16,1417,16,1618
3224,151,16,1417,16,1600
3225,133,16,1417,16,1582
3226,119,16,1417,16,1568
3227,102,16,1417,16,1551
3228,83,16,1417,16,1532
3229,68,16,1417,16,1517
3230,51,16,1417,16,1500
3232,18,16,1417,16,1467
3234,15,20,1382,16,1433
3235,35,17,1350,16,1418
3236,32,32,1318,16,1398
3237,17,32,1318,16,1383
3238,16,16,1318,16,1366
3239,16,33,1285,16,1350
3240,252,14,1153,16,1435
3241,249,34,1119,16,1418
3244,199,34,1119,16,1368
3247,149,34,1119,16,1318
3248,131,34,1119,16,1300
3252,84,16,1119,16,1235
3253,267,18,917,16,1218
3254,250,18,917,16,1201
3256,218,18,917,16,1169
3257,200,18,917,16,1151
3258,184,18,917,16,1135
3259,169,18,917,16,1120
3260,149,18,917,16,1100
3261,133,18,917,16,1084
3263,103,18,917,16,1054
3265,64,18,917,16,1015
3267,83,34,850,16,983
3268,151,17,785,16,969
3269,133,17,785,16,951
3270,115,17,785,16,933
3272,82,17,785,16,900
3273,66,17,785,16,884
3277,17,34,751,16,818
3278,1534,33,50,16,1633
3279,1517,33,50,16,1616
3280,1500,33,50,16,1599
3281,1483,33,50,16,1582
3282,1468,33,50,16,1567
3283,1451,33,50,16,1550
3285,1417,33,50,16,1516
3286,1400,33,50,16,1499
3287,1383,33,50,16,1482
3288,1367,33,50,16,1466
3289,1351,33,50,16,1450
3296,1233,33,50,16,1332
3297,1218,33,50,16,1317
3298,1200,33,50,16,1299
3299,1183,33,50,16,1282
3300,1168,33,50,16,1267
3301,1150,33,50,16,1249
3302,1133,33,50,16,1232
3303,1118,33,50,16,1217
3304,1102,33,50,16,1201
3305,1084,33,50,16,1183
3306,1066,33,50,16,1165
3307,1050,33,50,16,1149
3308,1034,33,50,16,1133
3309,1017,33,50,16,1116
3310,1000,33,50,16,1099
3312,966,33,50,16,1065
3313,950,33,50,16,1049
3314,934,33,50,16,1033
3315,965,17,216,19,1217
3316,949,17,216,19,1201
3317,934,17,216,19,1186
3318,916,17,216,19,1168
3319,899,17,216,19,1151
3321,867,17,216,19,1119
3322,849,17,216,19,1101
3323,833,17,216,19,1085
3324,815,17,216,19,1067
3325,798,17,216,19,1050
3326,782,17,216,19,1034
3327,765,17,216,19,1017
3328,748,17,216,19,1000
3329,732,17,216,19,984
3330,715,17,216,19,967
3331,700,17,216,19,952
3332,682,17,216,19,934
3334,649,17,216,19,901
3337,598,17,216,19,850
3339,567,17,216,19,819
3341,533,17,216,19,785
3343,498,17,216,19,750
3344,481,17,216,19,733
3345,465,17,216,19,717
3346,450,17,216,19,702
3347,431,17,216,19,683
3351,367,17,216,19,619
3354,315,17,216,19,567
3356,282,17,216,19,534
3357,265,17,216,19,517
3358,250,17,216,19,502
3359,234,17,216,19,486
3360,233,33,183,19,468
3361,215,33,183,19,450
3362,199,33,183,19,434
3364,167,33,183,19,402
3366,134,33,183,19,369
3367,116,33,183,19,351
3369,84,33,183,19,319
3370,66,33,183,19,301
3372,33,33,183,19,268
3373,17,33,183,19,252
3375,251,33,51,16,351
3376,235,33,51,16,335
3378,201,33,51,16,301
3379,183,33,51,16,283
3380,166,33,51,16,266
3382,134,33,51,16,234
3384,168,34,16,18,236
3389,85,34,16,18,153
3390,66,34,16,18,134
3391,50,34,16,18,118
3392,33,34,16,18,101
3393,16,34,16,18,84
3395,66,15,84,15,180
3396,50,15,84,15,164
3397,34,15,84,15,148
3398,16,15,84,15,130
3399,15,35,83,16,149
3401,31,19,50,16,116
3403,35,15,19,16,85
3404,16,15,19,16,66
3406,35,34,49,18,136
3407,16,34,49,18,117
3410,17,14,36,17,84
3411,14,36,17,16,83
3412,0,36,17,16,69
3414,17,16,249,16,298
3415,30,17,218,16,281
3416,14,17,218,16,265
3418,17,17,184,16,234
3420,119,15,50,16,200
3421,102,15,50,16,183
3423,113,33,84,18,248
3424,101,33,84,18,236
3425,134,15,50,18,217
3426,118,15,50,18,201
3427,100,15,50,18,183
3428,85,15,50,18,168
3432,34,33,17,18,102
3433,15,33,17,18,83
3434,16,17,17,18,68
3435,85,32,16,17,150
3437,83,33,34,33,183
3439,48,33,34,33,148
3440,32,33,34,33,132
3441,31,17,34,33,115
3442,16,17,34,33,100
3445,14,33,33,18,98
3447,33,18,18,15,84
3448,266,34,202,14,516
3450,233,34,202,14,483
3451,215,34,202,14,465
3453,182,34,202,14,432
3454,166,34,202,14,416
3456,132,34,202,14,382
3457,115,34,202,14,365
3458,98,34,202,14,348
3459,82,34,202,14,332
3461,49,34,202,14,299
3462,117,18,133,14,282
3463,99,18,133,14,264
3464,85,18,133,14,250
3465,67,18,133,14,232
3466,51,18,133,14,216
3467,101,16,69,14,200
3468,84,16,69,14,183
3469,66,16,69,14,165
3470,48,16,69,14,147
3471,32,16,69,14,131
3472,116,18,18,16,168
3473,99,18,18,16,151
3474,83,18,18,16,135
3475,102,16,15,18,151
3476,84,16,15,18,133
3478,50,16,15,18,99
3480,18,16,15,18,67
3481,16,33,117,16,182
3482,33,33,84,16,166
3483,18,33,84,16,151
3486,33,34,17,16,100
3487,16,34,17,16,83
3488,34,33,34,16,117
3492,16,18,16,15,65
3493,18,31,18,17,84
3494,82,18,33,17,150
3495,84,33,99,17,233
3496,69,33,99,17,218
3497,51,33,99,17,200
3499,34,17,99,17,167
3500,132,52,32,17,233
3501,116,52,32,17,217
3502,99,52,32,17,200
3504,67,52,32,17,168
3505,50,52,32,17,151
3507,16,52,32,17,117
3508,167,34,99,18,318
3509,150,34,99,18,301
3510,135,34,99,18,286
3511,133,16,99,18,266
3512,118,16,99,18,251
3513,101,16,99,18,234
3517,35,16,99,18,168
3518,317,16,17,18,368
3522,250,16,17,18,301
3523,232,16,17,18,283
3525,201,16,17,18,252
3526,184,16,17,18,235
3527,166,16,17,18,217
3530,116,16,17,18,167
3531,100,16,17,18,151
3533,83,35,17,14,149
3537,16,35,17,14,82
3538,17,18,17,14,66
3539,35,14,217,18,284
3540,266,33,33,17,349
3541,249,33,33,17,332
3542,419,17,150,14,600
3543,400,17,150,14,581
3546,351,17,150,14,532
3547,333,17,150,14,514
3548,319,17,150,14,500
3549,301,17,150,14,482
3551,268,17,150,14,449
3553,234,17,150,14,415
3554,217,17,150,14,398
3555,202,17,150,14,383
3556,184,17,150,14,365
3559,133,17,150,14,314
3561,101,17,150,14,282
3562,103,32,118,14,267
3563,85,32,118,14,249
3564,68,32,118,14,232
3565,82,33,85,14,214
3566,66,33,85,14,198
3569,182,33,233,17,465
3571,147,33,233,17,430
3572,133,33,233,17,416
3573,116,33,233,17,399
3574,99,33,233,17,382
3575,83,33,233,17,366
3576,67,33,233,17,350
3577,48,33,233,17,331
3578,34,33,233,17,317
3582,16,20,197,17,250
3583,36,18,163,17,234
3584,34,30,133,17,214
3587,32,18,98,17,165
3588,202,33,15,19,269
3590,167,33,15,19,234
3591,152,33,15,19,219
3592,134,33,15,19,201
3593,119,33,15,19,186
3595,83,33,15,19,150
3596,83,19,15,19,136
3597,66,19,15,19,119
3598,49,19,15,19,102
3599,86,32,33,16,167
3602,81,18,499,17,615
3603,66,18,499,17,600
3604,47,18,499,17,581
3605,32,18,499,17,566
3606,33,35,464,17,549
3608,35,31,433,17,516
3609,33,17,433,17,500
3610,14,17,433,17,481
3611,168,16,266,17,467
3612,151,16,266,17,450
3614,116,16,266,17,415
3615,100,16,266,17,399
3616,82,16,266,17,381
3617,100,19,230,17,366
3618,82,19,230,17,348
3622,17,19,230,17,283
3623,19,32,198,17,266
3624,80,18,216,20,334
3626,48,18,216,20,302
3627,32,18,216,20,286
3629,18,33,183,20,254
3630,16,17,183,20,236
3631,17,34,149,20,220
3633,152,35,48,16,251
3635,119,35,48,16,218
3636,101,35,48,16,200
3637,85,35,48,16,184
3638,69,35,48,16,168
3639,118,33,217,17,385
3641,85,33,217,17,352
3642,66,33,217,17,333
3643,51,33,217,17,318
3644,31,33,217,17,298
3645,35,16,217,17,285
3646,17,16,217,17,267
3647,33,16,184,17,250
3648,17,16,184,17,234
3650,16,17,151,17,201
3651,17,34,117,17,185
3652,34,34,83,17,168
3653,16,34,83,17,150
3654,34,32,51,17,134
3658,34,34,49,16,133
3661,0,17,49,16,82
3664,17,16,17,17,67
3669,132,18,16,16,182
3672,82,18,16,16,132
3673,66,18,16,16,116
3674,51,18,16,16,101
3675,82,35,216,17,350
3676,62,35,216,17,330
3678,32,35,216,17,300
3682,34,33,149,17,233
3684,33,48,101,17,199
3685,32,33,101,17,183
3686,116,16,17,17,166
3688,85,16,17,17,135
3689,68,16,17,17,118
3691,32,16,17,17,82
3692,17,16,17,17,67
3693,683,34,83,33,833
3694,667,34,83,33,817
3697,617,34,83,33,767
3698,599,34,83,33,749
3699,582,34,83,33,732
3700,567,34,83,33,717
3702,533,34,83,33,683
3703,518,34,83,33,668
3705,484,34,83,33,634
3708,432,34,83,33,582
3709,416,34,83,33,566
3710,400,34,83,33,550
3711,383,34,83,33,533
3712,368,34,83,33,518
3713,350,34,83,33,500
3714,333,34,83,33,483
3715,317,34,83,33,467
3716,299,34,83,33,449
3717,282,34,83,33,432
3718,267,34,83,33,417
3719,250,34,83,33,400
3720,234,34,83,33,384
3722,200,34,83,33,350
3723,184,34,83,33,334
3724,166,34,83,33,316
3725,150,34,83,33,300
3726,133,34,83,33,283
3727,116,34,83,33,266
3728,99,34,83,33,249
3729,84,34,83,33,234
3731,50,34,83,33,200
3735,133,18,82,16,249
3736,116,18,82,16,232
3737,99,18,82,16,215
3739,68,18,82,16,184
3740,50,18,82,16,166
3741,33,18,82,16,149
3742,18,18,82,16,134
3744,32,33,17,16,98
3745,32,18,17,16,83
3746,83,16,34,17,150
3750,33,34,17,17,101
3751,33,17,17,17,84
3752,17,17,17,17,68
3753,83,35,16,18,152
3754,66,35,16,18,135
3755,49,35,16,18,118
3756,32,35,16,18,101
3757,15,35,16,18,84
3758,19,16,16,18,69
3760,217,16,17,17,267
3761,201,16,17,17,251
3762,183,16,17,17,233
3763,166,16,17,17,216
3766,117,16,17,17,167
3768,85,16,17,17,135
3769,68,16,17,17,118
3770,52,16,17,17,102
3771,35,16,17,17,85
3772,18,16,17,17,68
3774,84,15,117,17,233
3775,67,15,117,17,216
3777,35,15,117,17,184
3780,17,17,83,17,134
3781,17,32,51,17,117
3782,117,17,150,16,300
3783,101,17,150,16,284
3784,85,17,150,16,268
3785,68,17,150,16,251
3786,51,17,150,16,234
3788,86,13,101,18,218
3789,69,13,101,18,201
3791,37,13,101,18,169
3792,19,13,101,18,151
3793,66,14,34,18,132
3794,53,14,34,18,119
3795,36,14,34,18,102
3796,20,14,34,18,86
3797,32,16,34,17,99
3798,85,16,16,16,133
3800,51,16,16,16,99
3801,148,34,51,16,249
3802,151,15,51,16,233
3803,134,15,51,16,216
3804,118,15,51,16,200
3806,86,15,51,16,168
3807,202,15,118,15,350
3808,184,15,118,15,332
3809,167,15,118,15,315
3810,152,15,118,15,300
3811,133,15,118,15,281
3812,118,15,118,15,266
3814,85,15,118,15,233
3816,51,15,118,15,199
3817,83,35,399,17,534
3818,65,35,399,17,516
3819,83,32,367,17,499
3822,35,32,367,17,451
3827,15,36,298,17,366
3829,166,16,133,17,332
3830,149,16,133,17,315
3831,135,16,133,17,301
3832,117,16,133,17,283
3833,102,16,133,17,268
3834,84,16,133,17,250
3835,68,16,133,17,234
3836,115,18,151,15,299
3837,99,18,151,15,283
3838,82,18,151,15,266
3839,82,33,118,15,248
3841,48,33,118,15,214
3842,33,33,118,15,199
3843,18,33,118,15,184
3844,114,20,84,16,234
3845,97,20,84,16,217
3846,81,20,84,16,201
3847,63,20,84,16,183
3850,12,20,84,16,132
3851,37,15,250,17,319
3852,234,31,51,17,333
3853,217,31,51,17,316
3854,202,31,51,17,301
3855,183,31,51,17,282
3857,150,31,51,17,249
3860,102,31,51,17,201
3861,83,31,51,17,182
3864,33,31,51,17,132
3865,32,15,51,17,115
3866,16,15,51,17,99
3867,15,34,17,17,83
3868,86,17,48,18,169
3870,69,48,35,16,168
3871,52,48,35,16,151
3873,17,48,35,16,116
3874,16,32,35,16,99
3876,18,18,17,16,69
3878,0,33,548,19,600
3879,16,33,515,19,583
3880,0,33,515,19,567
3881,83,33,416,19,551
3882,183,16,316,19,534
3883,167,16,316,19,518
3885,133,16,316,19,484
3886,117,16,316,19,468
3888,84,16,316,19,435
3890,84,15,282,19,400
3892,51,15,282,19,367
3893,35,15,282,19,351
3894,19,15,282,19,335
3896,32,35,215,19,301
3897,15,35,215,19,284
3899,86,31,116,19,252
3900,215,19,82,17,333
3901,199,19,82,17,317
3903,166,19,82,17,284
3905,131,19,82,17,249
3907,98,19,82,17,216
3909,2283,33,35,17,2368
3910,2267,33,35,17,2352
3911,2251,33,35,17,2336
3912,2234,33,35,17,2319
3914,2199,33,35,17,2284
3915,2184,33,35,17,2269
3917,2150,33,35,17,2235
3918,2131,33,35,17,2216
3919,2117,33,35,17,2202
3920,2100,33,35,17,2185
3922,2066,33,35,17,2151
3923,2050,33,35,17,2135
3925,2016,33,35,17,2101
3926,1999,33,35,17,2084
3927,1984,33,35,17,2069
3928,1967,33,35,17,2052
3929,1950,33,35,17,2035
3930,1936,33,35,17,2021
3931,1917,33,35,17,2002
3932,1900,33,35,17,1985
3933,1883,33,35,17,1968
3935,1849,33,35,17,1934
3937,1816,33,35,17,1901
3939,1784,33,35,17,1869
3942,1734,33,35,17,1819
3943,1717,33,35,17,1802
3944,1700,33,35,17,1785
3945,1682,33,35,17,1767
3946,1666,33,35,17,1751
3947,1650,33,35,17,1735
3950,1598,33,35,17,1683
3951,1583,33,35,17,1668
3952,1584,16,35,17,1652
3953,1566,16,35,17,1634
3955,1534,16,35,17,1602
3956,1517,16,35,17,1585
3957,1503,16,35,17,1571
3958,1485,16,35,17,1553
3959,1468,16,35,17,1536
3960,1451,16,35,17,1519
3961,1433,16,35,17,1501
3962,1416,16,35,17,1484
3964,1385,16,35,17,1453
3966,1350,16,35,17,1418
3967,1333,16,35,17,1401
3970,1284,16,35,17,1352
3973,1233,16,35,17,1301
3974,1215,16,35,17,1283
3975,1201,16,35,17,1269
3976,1183,16,35,17,1251
3978,1151,16,35,17,1219
3980,1117,16,35,17,1185
3981,1100,16,35,17,1168
3983,1067,16,35,17,1135
3984,1048,16,35,17,1116
3986,1015,16,35,17,1083
3987,1001,16,35,17,1069
3988,984,16,35,17,1052
3990,951,16,35,17,1019
3991,933,16,35,17,1001
3992,916,16,35,17,984
3993,900,16,35,17,968
3994,884,16,35,17,952
3995,867,16,35,17,935
3996,933,33,155,14,1135
3997,916,33,155,14,1118
3999,880,33,155,14,1082
4000,866,33,155,14,1068
4002,832,33,155,14,1034
4005,781,33,155,14,983
4006,766,33,155,14,968
4007,750,33,155,14,952
4008,731,33,155,14,933
4010,698,33,155,14,900
4011,682,33,155,14,884
4012,666,33,155,14,868
4014,629,33,155,14,831
4016,598,33,155,14,800
4019,548,33,155,14,750
4020,531,33,155,14,733
4021,515,33,155,14,717
4022,499,33,155,14,701
4023,482,33,155,14,684
4024,466,33,155,14,668
4026,432,33,155,14,634
4027,416,33,155,14,618
4028,400,33,155,14,602
4029,381,33,155,14,583
4030,366,33,155,14,568
4031,349,33,155,14,551
4032,333,33,155,14,535
4033,314,33,155,14,516
4034,299,33,155,14,501
4035,281,33,155,14,483
4036,265,33,155,14,467
4037,249,33,155,14,451
4042,165,33,155,14,367
4043,148,33,155,14,350
4045,114,33,155,14,316
4046,99,33,155,14,301
4047,82,33,155,14,284
4048,66,33,155,14,268
4049,50,33,155,14,252
4051,14,33,155,14,216
4052,85,16,87,14,202
4053,249,32,19,17,317
4055,217,32,19,17,285
4057,183,32,19,17,251
4058,167,32,19,17,235
4060,134,32,19,17,202
4061,115,32,19,17,183
4062,100,32,19,17,168
4063,80,32,19,17,148
4064,182,17,119,16,334
4065,165,17,119,16,317
4066,148,17,119,16,300
4067,135,17,119,16,287
4068,116,17,119,16,268
4069,98,17,119,16,250
4070,84,17,119,16,236
4071,65,17,119,16,217
4072,48,17,119,16,200
4073,33,17,119,16,185
4074,15,17,119,16,167
4075,17,35,84,16,152
4076,18,17,84,16,135
4077,32,16,86,17,151
4081,36,16,17,17,86
4082,35,34,82,16,167
4083,16,34,82,16,148
4084,17,17,82,16,132
4085,48,37,46,17,148
4087,36,18,46,17,117
4089,18,30,33,16,97
4090,46,17,84,17,164
4093,33,19,49,17,118
4094,84,17,17,16,134
4095,85,33,33,16,167
4096,66,33,33,16,148
4098,34,33,33,16,116
4100,0,33,33,16,82
4101,16,33,16,18,83
4103,317,33,365,18,733
4104,301,33,365,18,717
4105,285,33,365,18,701
4106,267,33,365,18,683
4107,251,33,365,18,667
4108,235,33,365,18,651
4109,218,33,365,18,634
4110,201,33,365,18,617
4111,184,33,365,18,600
4112,169,33,365,18,585
4114,133,33,365,18,549
4115,117,33,365,18,533
4116,99,33,365,18,515
4117,117,32,333,18,500
4119,84,32,333,18,467
4120,67,32,333,18,450
4121,50,32,333,18,433
4122,33,32,333,18,416
4123,48,34,299,18,399
4124,32,34,299,18,383
4127,439,13,115,18,585
4128,421,13,115,18,567
4129,405,13,115,18,551
4130,388,13,115,18,534
4131,372,13,115,18,518
4133,339,13,115,18,485
4135,306,13,115,18,452
4137,270,13,115,18,416
4138,254,13,115,18,400
4139,236,13,115,18,382
4140,220,13,115,18,366
4142,188,13,115,18,334
4144,154,13,115,18,300
4146,122,13,115,18,268
4147,104,13,115,18,250
4148,87,13,115,18,233
4149,71,13,115,18,217
4150,54,13,115,18,200
4152,20,13,115,18,166
4153,13,33,82,18,146
4154,33,34,48,18,133
4155,82,34,15,18,149
4158,81,18,16,17,132
4161,84,33,217,16,350
4162,66,33,217,16,332
4164,33,33,217,16,299
4165,35,15,217,16,283
4166,150,18,82,16,266
4168,117,18,82,16,233
4169,99,18,82,16,215
4170,82,18,82,16,198
4173,33,18,82,16,149
4175,18,33,49,16,116
4177,81,33,51,16,181
4178,266,34,182,16,498
4179,250,34,182,16,482
4180,234,34,182,16,466
4181,217,34,182,16,449
4182,201,34,182,16,433
4183,181,34,182,16,413
4186,133,34,182,16,365
4187,117,34,182,16,349
4188,101,34,182,16,333
4189,82,34,182,16,314
4190,67,34,182,16,299
4191,51,34,182,16,283
4193,33,18,182,16,249
4195,134,18,282,17,451
4196,116,18,282,17,433
4197,100,18,282,17,417
4198,184,17,183,17,401
4199,167,17,183,17,384
4201,133,17,183,17,350
4202,117,17,183,17,334
4203,100,17,183,17,317
4204,82,17,183,17,299
4206,51,17,183,17,268
4207,34,17,183,17,251
4208,18,17,183,17,235
4209,17,36,147,17,217
4212,18,11,118,17,164
4213,146,32,151,17,346
4214,135,32,151,17,335
4216,150,19,115,17,301
4217,133,19,115,17,284
4218,115,19,115,17,266
4220,101,31,84,17,233
4223,50,31,84,17,182
4225,19,31,84,17,151
4226,49,15,84,17,165
4227,34,15,84,17,150
4228,18,15,84,17,134
4229,199,17,17,15,248
4231,167,17,17,15,216
4232,149,17,17,15,198
4233,133,17,17,15,182
4234,116,17,17,15,165
4235,100,17,17,15,149
4236,83,17,17,15,132
4237,66,17,17,15,115
4238,51,17,17,15,100
4239,34,17,17,15,83
4242,17,15,19,17,68
4244,19,17,14,17,67
4245,31,17,150,18,216
4247,17,34,116,18,185
4248,18,16,116,18,168
4249,32,19,81,18,150
4250,16,19,81,18,134
4251,85,33,17,15,150
4253,49,33,17,15,114
4255,19,33,17,15,84
4257,1535,15,84,17,1651
4259,1500,15,84,17,1616
4260,1485,15,84,17,1601
4263,1434,15,84,17,1550
4264,1417,15,84,17,1533
4265,1400,15,84,17,1516
4266,1384,15,84,17,1500
4268,1351,15,84,17,1467
4269,1334,15,84,17,1450
4270,1316,15,84,17,1432
4271,1301,15,84,17,1417
4273,1267,15,84,17,1383
4276,1217,15,84,17,1333
4277,1202,15,84,17,1318
4279,1168,15,84,17,1284
4282,1119,15,84,17,1235
4283,1101,15,84,17,1217
4285,1068,15,84,17,1184
4286,1051,15,84,17,1167
4287,1035,15,84,17,1151
4288,1016,15,84,17,1132
4290,983,15,84,17,1099
4291,969,15,84,17,1085
4292,949,15,84,17,1065
4293,933,15,84,17,1049
4296,883,15,84,17,999
4297,867,15,84,17,983
4298,850,15,84,17,966
4300,816,15,84,17,932
4301,800,15,84,17,916
4302,785,15,84,17,901
4305,735,15,84,17,851
4309,833,15,101,17,966
4310,816,15,101,17,949
4312,783,15,101,17,916
4314,751,15,101,17,884
4315,733,15,101,17,866
4317,700,15,101,17,833
4319,668,15,101,17,801
4320,649,15,101,17,782
4321,633,15,101,17,766
4322,617,15,101,17,750
4324,583,15,101,17,716
4326,551,15,101,17,684
4328,518,15,101,17,651
4330,483,15,101,17,616
4331,467,15,101,17,600
4332,451,15,101,17,584
4334,418,15,101,17,551
4336,383,15,101,17,516
4337,366,15,101,17,499
4338,351,15,101,17,484
4340,317,15,101,17,450
4341,301,15,101,17,434
4343,266,15,101,17,399
4344,248,15,101,17,381
4346,218,15,101,17,351
4349,166,15,101,17,299
4350,151,15,101,17,284
4351,134,15,101,17,267
4352,115,15,101,17,248
4353,100,15,101,17,233
4354,84,15,101,17,217
4355,67,15,101,17,200
4356,515,18,50,17,600
4359,465,18,50,17,550
4360,450,18,50,17,535
4361,432,18,50,17,517
4363,399,18,50,17,484
4364,383,18,50,17,468
4365,366,18,50,17,451
4367,332,18,50,17,417
4368,314,18,50,17,399
4369,300,18,50,17,385
4371,265,18,50,17,350
4376,485,15,116,19,635
4377,469,15,116,19,619
4378,450,15,116,19,600
4379,435,15,116,19,585
4381,402,15,116,19,552
4385,335,15,116,19,485
4386,318,15,116,19,468
4387,303,15,116,19,453
4388,285,15,116,19,435
4389,333,17,83,19,452
4390,315,17,83,19,434
4392,282,17,83,19,401
4393,264,17,83,19,383
4394,244,17,83,19,363
4395,651,32,168,17,868
4396,633,32,168,17,850
4397,618,32,168,17,835
4398,599,32,168,17,816
4399,583,32,168,17,800
4402,534,32,168,17,751
4404,500,32,168,17,717
4406,467,32,168,17,684
4408,433,32,168,17,650
4409,418,32,168,17,635
4410,401,32,168,17,618
4411,382,32,168,17,599
4412,366,32,168,17,583
4414,332,32,168,17,549
4419,245,32,168,17,462
4421,218,32,168,17,435
4422,200,32,168,17,417
4423,183,32,168,17,400
4424,166,32,168,17,383
4425,149,32,168,17,366
4427,117,32,168,17,334
4428,101,32,168,17,318
4429,83,32,168,17,300
4431,83,35,133,17,268
4432,86,16,133,17,252
4433,67,16,133,17,233
4434,51,16,133,17,217
4436,185,17,84,16,302
4437,166,17,84,16,283
4438,150,17,84,16,267
4440,118,17,84,16,235
4441,100,17,84,16,217
4442,149,17,19,16,201
4444,116,17,19,16,168
4445,99,17,19,16,151
4446,82,17,19,16,134
4447,65,17,19,16,117
4449,33,17,19,16,85
4450,15,17,19,16,67
4451,36,16,17,14,83
4452,35,31,19,16,101
4454,31,35,216,16,298
4455,33,16,216,16,281
4456,86,16,149,16,267
4457,67,16,149,16,248
4459,35,16,149,16,216
4460,86,15,134,16,251
4461,67,15,134,16,232
4462,51,15,134,16,216
4464,19,15,134,16,184
4466,35,32,67,16,150
4468,32,32,35,16,115
4470,16,16,35,16,83
4471,16,35,34,17,102
4472,35,34,17,16,102
4473,18,34,17,16,85
4474,149,18,434,15,616
4476,115,18,434,15,582
4477,150,32,368,15,565
4478,134,32,368,15,549
4480,101,32,368,15,516
4482,69,32,368,15,484
4483,102,16,334,15,467
4484,84,16,334,15,449
4486,50,16,334,15,415
4489,16,34,300,15,365
4490,84,16,249,17,366
4491,67,16,249,17,349
4493,35,16,249,17,317
4494,17,16,249,17,299
4495,16,49,200,17,282
4496,31,18,200,17,266
4497,85,32,118,17,252
4499,50,32,118,17,217
4500,119,15,50,17,201
4501,102,15,50,17,184
4502,85,15,50,17,167
4503,70,15,50,17,152
4504,2284,17,2001,18,4320
4506,2250,17,2001,18,4286
4507,2231,17,2001,18,4267
4508,2216,17,2001,18,4252
4510,2181,17,2001,18,4217
4511,2166,17,2001,18,4202
4512,2149,17,2001,18,4185
4514,2115,17,2001,18,4151
4515,2099,17,2001,18,4135
4516,2083,17,2001,18,4119
4517,2065,17,2001,18,4101
4518,2050,17,2001,18,4086
4519,2033,17,2001,18,4069
4521,1998,17,2001,18,4034
4523,1966,17,2001,18,4002
4526,1914,17,2001,18,3950
4528,1881,17,2001,18,3917
4530,1850,17,2001,18,3886
4532,1816,17,2001,18,3852
4533,1798,17,2001,18,3834
4534,1782,17,2001,18,3818
4536,1750,17,2001,18,3786
4538,1716,17,2001,18,3752
4539,1698,17,2001,18,3734
4540,1684,17,2001,18,3720
4541,1666,17,2001,18,3702
4542,1649,17,2001,18,3685
4543,1633,17,2001,18,3669
4544,1616,17,2001,18,3652
4545,1599,17,2001,18,3635
4547,1566,17,2001,18,3602
4548,1548,17,2001,18,3584
4549,1698,17,1834,18,3567
4550,1681,17,1834,18,3550
4552,1649,17,1834,18,3518
4555,1599,17,1834,18,3468
4556,1582,17,1834,18,3451
4557,1566,17,1834,18,3435
4559,1533,17,1834,18,3402
4560,1516,17,1834,18,3385
4561,1499,17,1834,18,3368
4565,1433,17,1834,18,3302
4566,1417,17,1834,18,3286
4569,1366,17,1834,18,3235
4572,1316,17,1834,18,3185
4573,1298,17,1834,18,3167
4574,1284,17,1834,18,3153
4576,1249,17,1834,18,3118
4577,1233,17,1834,18,3102
4579,1194,17,1834,18,3063
4580,1184,17,1834,18,3053
4581,1166,17,1834,18,3035
4582,1148,17,1834,18,3017
4583,1133,17,1834,18,3002
4584,1116,17,1834,18,2985
4585,1101,17,1834,18,2970
4586,1082,17,1834,18,2951
4587,1067,17,1834,18,2936
4589,1034,17,1834,18,2903
4590,1017,17,1834,18,2886
4591,999,17,1834,18,2868
4592,983,17,1834,18,2852
4593,967,17,1834,18,2836
4594,949,17,1834,18,2818
4597,933,15,1801,18,2767
4600,883,15,1801,18,2717
4601,867,15,1801,18,2701
4602,852,15,1801,18,2686
4603,834,15,1801,18,2668
4606,785,15,1801,18,2619
4607,768,15,1801,18,2602
4608,750,15,1801,18,2584
4609,734,15,1801,18,2568
4611,700,15,1801,18,2534
4612,685,15,1801,18,2519
4613,669,15,1801,18,2503
4615,634,15,1801,18,2468
4617,602,15,1801,18,2436
4618,583,15,1801,18,2417
4619,569,15,1801,18,2403
4621,534,15,1801,18,2368
4622,518,15,1801,18,2352
4624,483,15,1801,18,2317
4627,435,15,1801,18,2269
4628,418,15,1801,18,2252
4629,401,15,1801,18,2235
4633,334,15,1801,18,2168
4634,317,15,1801,18,2151
4636,284,15,1801,18,2118
4637,268,15,1801,18,2102
4638,252,15,1801,18,2086
4639,235,15,1801,18,2069
4640,219,15,1801,18,2053
4641,202,15,1801,18,2036
4645,135,15,1801,18,1969
4646,119,15,1801,18,1953
4647,132,17,1768,18,1935
4649,98,17,1768,18,1901
4650,82,17,1768,18,1885
4652,49,17,1768,18,1852
4653,31,17,1768,18,1834
4655,17,36,1732,18,1803
4657,17,33,1699,18,1767
4658,33,31,1668,18,1750
4660,15,16,1668,18,1717
4661,184,32,1468,18,1702
4663,150,32,1468,18,1668
4664,134,32,1468,18,1652
4665,116,32,1468,18,1634
4667,83,32,1468,18,1601
4669,50,32,1468,18,1568
4670,83,17,1433,18,1551
4676,83,16,1334,18,1451
4677,66,16,1334,18,1434
4678,50,16,1334,18,1418
4679,83,33,1267,18,1401
4682,34,33,1267,18,1352
4683,17,33,1267,18,1335
4684,17,16,1267,18,1318
4685,31,19,1233,18,1301
4686,34,33,1200,18,1285
4687,19,33,1200,18,1270
4688,148,18,1085,14,1265
4689,132,18,1085,14,1249
4691,100,18,1085,14,1217
4694,48,18,1085,14,1165
4695,32,18,1085,14,1149
4697,18,33,1052,14,1117
4700,35,33,984,14,1066
4701,133,17,884,14,1048
4702,116,17,884,14,1031
4705,69,17,884,14,984
4707,33,17,884,14,948
4708,17,17,884,14,932
4709,17,31,853,14,915
4710,31,35,818,14,898
4711,15,35,818,14,882
4712,18,17,818,14,867
4713,82,34,719,14,849
4715,48,34,719,14,815
4716,33,34,719,14,800
4717,14,34,719,14,781
4720,33,33,653,14,733
4721,14,33,653,14,714
4722,33,34,619,14,700
4723,35,15,619,14,683
4725,15,33,586,14,648
4727,284,33,318,16,651
4728,267,33,318,16,634
4729,250,33,318,16,617
4730,234,33,318,16,601
4731,215,33,318,16,582
4732,199,33,318,16,566
4733,184,33,318,16,551
4734,199,34,284,16,533
4736,167,34,284,16,501
4738,133,34,284,16,467
4739,115,34,284,16,449
4741,84,34,284,16,418
4742,83,16,284,16,399
4745,35,16,284,16,351
4746,69,32,217,16,334
4747,51,32,217,16,316
4748,35,32,217,16,300
4749,35,16,217,16,284
4750,32,33,184,16,265
4751,16,33,184,16,249
4752,0,33,184,16,233
4753,34,16,150,16,216
4755,32,16,118,16,182
4756,32,33,85,16,166
4757,33,16,85,16,150
4758,100,34,51,16,201
4759,83,34,51,16,184
4762,32,34,51,16,133
4763,14,34,51,16,115
4765,16,34,17,16,83
4766,0,34,17,16,67
4767,33,16,18,14,81
4768,17,16,18,14,65
4769,149,33,50,34,266
4770,183,33,15,19,250
4772,151,33,15,19,218
4773,134,33,15,19,201
4774,118,33,15,19,185
4775,98,33,15,19,165
4777,67,33,15,19,134
4778,83,34,82,18,217
4779,65,34,82,18,199
4781,33,34,82,18,167
4782,336,34,3130,20,3520
4783,317,34,3130,20,3501
4785,283,34,3130,20,3467
4787,251,34,3130,20,3435
4788,232,34,3130,20,3416
4792,166,34,3130,20,3350
4793,150,34,3130,20,3334
4795,115,34,3130,20,3299
4797,84,34,3130,20,3268
4798,66,34,3130,20,3250
4799,48,34,3130,20,3232
4800,34,34,3130,20,3218
4801,17,34,3130,20,3201
4802,183,17,2964,20,3184
4803,165,17,2964,20,3166
4806,116,17,2964,20,3117
4808,82,17,2964,20,3083
4809,66,17,2964,20,3067
4810,50,17,2964,20,3051
4811,84,32,2897,20,3033
4812,66,32,2897,20,3015
4813,233,18,2730,20,3001
4814,216,18,2730,20,2984
4819,133,18,2730,20,2901
4820,117,18,2730,20,2885
4821,101,18,2730,20,2869
4822,83,18,2730,20,2851
4825,32,18,2730,20,2800
4826,33,34,2696,20,2783
4827,84,34,2630,20,2768
4828,215,35,2480,20,2750
4831,166,35,2480,20,2701
4832,149,35,2480,20,2684
4833,132,35,2480,20,2667
4834,115,35,2480,20,2650
4835,100,35,2480,20,2635
4836,83,35,2480,20,2618
4837,65,35,2480,20,2600
4839,33,35,2480,20,2568
4840,15,35,2480,20,2550
4842,19,16,2464,20,2519
4843,16,35,2429,20,2500
4844,133,34,2551,16,2734
4845,118,34,2551,16,2719
4846,98,34,2551,16,2699
4847,82,34,2551,16,2683
4849,49,34,2551,16,2650
4851,168,14,2419,16,2617
4854,118,14,2419,16,2567
4855,102,14,2419,16,2551
4856,85,14,2419,16,2534
4857,67,14,2419,16,2516
4858,51,14,2419,16,2500
4859,34,14,2419,16,2483
4860,83,16,2351,16,2466
4861,66,16,2351,16,2449
4862,52,16,2351,16,2435
4863,84,34,2284,16,2418
4864,65,34,2284,16,2399
4865,49,34,2284,16,2383
4866,33,34,2284,16,2367
4870,17,17,2250,16,2300
4871,198,19,2050,16,2283
4872,181,19,2050,16,2266
4874,149,19,2050,16,2234
4875,132,19,2050,16,2217
4876,115,19,2050,16,2200
4877,98,19,2050,16,2183
4878,81,19,2050,16,2166
4880,49,19,2050,16,2134
4881,32,19,2050,16,2117
4887,34,17,1951,16,2018
4888,633,33,1467,16,2149
4889,617,33,1467,16,2133
4891,584,33,1467,16,2100
4893,551,33,1467,16,2067
4894,534,33,1467,16,2050
4895,517,33,1467,16,2033
4898,467,33,1467,16,1983
4901,415,33,1467,16,1931
4902,401,33,1467,16,1917
4903,382,33,1467,16,1898
4904,367,33,1467,16,1883
4905,349,33,1467,16,1865
4906,334,33,1467,16,1850
4907,317,33,1467,16,1833
4908,301,33,1467,16,1817
4909,284,33,1467,16,1800
4910,266,33,1467,16,1782
4911,251,33,1467,16,1767
4914,200,33,1467,16,1716
4915,183,33,1467,16,1699
4916,168,33,1467,16,1684
4917,151,33,1467,16,1667
4918,132,33,1467,16,1648
4920,101,33,1467,16,1617
4922,68,33,1467,16,1584
4924,32,33,1467,16,1548
4925,34,16,1467,16,1533
4926,17,16,1467,16,1516
4927,16,37,1430,16,1499
4928,37,29,1401,16,1483
4929,164,17,1268,16,1465
4930,145,17,1268,16,1446
4931,135,17,1268,16,1436
4933,99,17,1268,16,1400
4934,82,17,1268,16,1383
4935,199,19,1133,16,1367
4936,181,19,1133,16,1349
4937,165,19,1133,16,1333
4938,149,19,1133,16,1317
4942,81,19,1133,16,1249
4943,84,33,1100,16,1233
4944,151,18,1032,16,1217
4945,135,18,1032,16,1201
4946,117,18,1032,16,1183
4947,102,18,1032,16,1168
4948,83,18,1032,16,1149
4950,184,17,899,16,1116
4952,152,17,899,16,1084
4953,134,17,899,16,1066
4954,116,17,899,16,1048
4956,102,32,867,16,1017
4957,83,32,867,16,998
4958,66,32,867,16,981
4959,51,32,867,16,966
4960,35,32,867,16,950
4961,150,32,734,16,932
4962,133,32,734,16,915
4963,118,32,734,16,900
4964,101,32,734,16,883
4965,85,32,734,16,867
4966,83,16,734,16,849
4968,49,16,734,16,815
4969,33,16,734,16,799
4970,146,19,601,16,782
4971,130,19,601,16,766
4972,114,19,601,16,750
4974,79,19,601,16,715
4978,31,35,566,16,648
4979,36,18,566,16,636
4980,17,18,566,16,617
4981,18,33,533,16,600
4982,148,35,383,16,582
4985,98,35,383,16,532
4986,83,35,383,16,517
4987,167,17,301,16,501
4988,147,17,301,16,481
4989,267,15,168,16,466
4991,235,15,168,16,434
4992,220,15,168,16,419
4995,167,15,168,16,366
4997,135,15,168,16,334
4999,101,15,168,16,300
5000,85,15,168,16,284
5003,83,34,99,16,232
5004,67,34,99,16,216
5006,35,34,99,16,184
5007,16,34,99,16,165
5008,0,34,99,16,149
5010,16,16,318,15,365
5013,35,16,251,15,317
5014,33,33,218,15,299
5015,32,17,218,15,282
5016,16,17,218,15,266
5019,18,33,150,15,216
5020,16,17,150,15,198
5021,48,35,84,15,182
5022,31,35,84,15,165
5023,15,35,84,15,149
5024,0,35,84,15,134
5026,65,34,67,18,184
5027,47,34,67,18,166
5028,31,34,67,18,150
5029,16,34,67,18,135
5030,34,33,34,18,119
5032,33,34,32,17,116
5033,82,17,133,23,255
5034,83,33,100,23,239
5035,151,32,16,23,222
5036,134,32,16,23,205
5037,148,39,44,17,248
5040,101,39,44,17,201
5042,66,39,44,17,166
5044,32,39,44,17,132
5045,16,39,44,17,116
5046,16,23,44,17,100
5047,23,29,15,17,84
5049,18,32,19,16,85
5050,15,17,19,16,67
5052,0,35,16,16,67
5053,150,32,283,16,481
5055,118,32,283,16,449
5057,86,32,283,16,417
5058,67,32,283,16,398
5060,34,32,283,16,365
5061,19,32,283,16,350
5062,166,32,117,16,331
5064,134,32,117,16,299
5065,119,32,117,16,284
5066,102,32,117,16,267
5067,85,32,117,16,250
5068,68,32,117,16,233
5070,35,32,117,16,200
5071,83,34,84,32,233
5072,82,17,84,32,215
5075,167,17,183,17,384
5076,150,17,183,17,367
5077,300,18,349,17,684
5078,283,18,349,17,667
5079,269,18,349,17,653
5080,250,18,349,17,634
5081,384,34,182,17,617
5083,350,34,182,17,583
5084,335,34,182,17,568
5085,368,18,148,17,551
5088,318,18,148,17,501
5090,283,18,148,17,466
5091,268,18,148,17,451
5092,251,18,148,17,434
5093,235,18,148,17,418
5094,216,18,148,17,399
5095,201,18,148,17,384
5096,183,18,148,17,366
5097,168,18,148,17,351
5098,151,18,148,17,334
5100,117,18,148,17,300
5101,100,18,148,17,283
5102,84,18,148,17,267
5103,67,18,148,17,250
5105,34,18,148,17,217
5108,65,33,50,17,165
5109,48,33,50,17,148
5110,34,33,50,17,134
5111,32,17,50,17,116
5113,17,33,34,16,100
5114,33,34,16,18,101
5116,34,34,16,18,102
5117,17,34,16,18,85
5118,118,32,100,16,266
5119,102,32,100,16,250
5124,19,32,100,16,167
5125,98,18,366,17,499
5126,84,18,366,17,485
5127,66,18,366,17,467
5129,83,34,300,17,434
5130,65,34,300,17,416
5133,33,17,300,17,367
5134,34,33,267,17,351
5135,33,17,267,17,334
5136,16,17,267,17,317
5137,17,49,218,17,301
5138,83,18,166,17,284
5139,68,18,166,17,269
5141,34,18,166,17,235
5142,33,33,133,17,216
5143,18,33,133,17,201
5144,15,18,133,17,183
5145,18,32,101,17,168
5146,83,18,83,16,200
5147,66,18,83,16,183
5148,434,32,436,16,918
5149,417,32,436,16,901
5150,400,32,436,16,884
5152,365,32,436,16,849
5154,333,32,436,16,817
5155,316,32,436,16,800
5156,299,32,436,16,783
5158,266,32,436,16,750
5161,216,32,436,16,700
5162,199,32,436,16,683
5164,167,32,436,16,651
5165,151,32,436,16,635
5166,133,32,436,16,617
5167,115,32,436,16,599
5168,100,32,436,16,584
5169,85,32,436,16,569
5170,65,32,436,16,549
5171,50,32,436,16,534
5172,33,32,436,16,517
5175,16,34,402,16,468
5176,152,15,269,16,452
5177,1051,32,3218,14,4315
5179,1017,32,3218,14,4281
5181,984,32,3218,14,4248
5182,967,32,3218,14,4231
5183,952,32,3218,14,4216
5184,936,32,3218,14,4200
5185,918,32,3218,14,4182
5187,885,32,3218,14,4149
5188,868,32,3218,14,4132
5189,852,32,3218,14,4116
5190,835,32,3218,14,4099
5191,817,32,3218,14,4081
5192,802,32,3218,14,4066
5193,785,32,3218,14,4049
5194,768,32,3218,14,4032
5196,736,32,3218,14,4000
5197,717,32,3218,14,3981
5198,702,32,3218,14,3966
5201,652,32,3218,14,3916
5202,634,32,3218,14,3898
5203,618,32,3218,14,3882
5204,602,32,3218,14,3866
5205,586,32,3218,14,3850
5206,567,32,3218,14,3831
5207,553,32,3218,14,3817
5208,535,32,3218,14,3799
5209,519,32,3218,14,3783
5210,502,32,3218,14,3766
5211,490,32,3218,14,3754
5213,452,32,3218,14,3716
5215,417,32,3218,14,3681
5216,402,32,3218,14,3666
5218,384,16,3218,14,3632
5219,368,16,3218,14,3616
5220,350,16,3218,14,3598
5222,317,16,3218,14,3565
5223,302,16,3218,14,3550
5225,267,16,3218,14,3515
5229,202,16,3218,14,3450
5231,168,16,3218,14,3416
5232,152,16,3218,14,3400
5233,134,16,3218,14,3382
5234,117,16,3218,14,3365
5235,97,16,3218,14,3345
5236,84,16,3218,14,3332
5238,51,16,3218,14,3299
5239,35,16,3218,14,3283
5240,16,16,3218,14,3264
5241,16,33,3185,14,3248
5243,16,34,3151,14,3215
5244,17,17,3151,14,3199
5247,169,15,2952,14,3150
5248,151,15,2952,14,3132
5249,134,15,2952,14,3115
5250,117,15,2952,14,3098
5252,84,15,2952,14,3065
5253,84,33,2919,14,3050
5256,32,33,2919,14,2998
5257,32,16,2919,14,2981
5258,135,33,2784,14,2966
5260,102,33,2784,14,2933
5261,85,33,2784,14,2916
5262,67,33,2784,14,2898
5265,18,33,2784,14,2849
5266,33,34,2750,14,2831
5267,15,34,2750,14,2813
5268,15,19,2750,14,2798
5269,118,32,2619,14,2783
5271,83,32,2619,14,2748
5272,348,18,2400,18,2784
5273,333,18,2400,18,2769
5274,316,18,2400,18,2752
5275,299,18,2400,18,2735
5276,282,18,2400,18,2718
5278,716,19,1933,18,2686
5279,698,19,1933,18,2668
5282,647,19,1933,18,2617
5283,633,19,1933,18,2603
5284,615,19,1933,18,2585
5286,583,19,1933,18,2553
5289,532,19,1933,18,2502
5290,515,19,1933,18,2485
5293,466,19,1933,18,2436
5294,448,19,1933,18,2418
5297,400,19,1933,18,2370
5298,383,19,1933,18,2353
5299,365,19,1933,18,2335
5300,349,19,1933,18,2319
5301,331,19,1933,18,2301
5302,314,19,1933,18,2284
5303,300,19,1933,18,2270
5305,265,19,1933,18,2235
5306,248,19,1933,18,2218
5307,232,19,1933,18,2202
5308,214,19,1933,18,2184
5310,182,19,1933,18,2152
5312,1001,33,1067,18,2119
5313,985,33,1067,18,2103
5315,949,33,1067,18,2067
5316,933,33,1067,18,2051
5317,917,33,1067,18,2035
5318,900,33,1067,18,2018
5322,833,33,1067,18,1951
5323,817,33,1067,18,1935
5324,800,33,1067,18,1918
5325,784,33,1067,18,1902
5326,767,33,1067,18,1885
5327,750,33,1067,18,1868
5328,732,33,1067,18,1850
5329,718,33,1067,18,1836
5330,702,33,1067,18,1820
5333,652,33,1067,18,1770
5335,617,33,1067,18,1735
5336,599,33,1067,18,1717
5337,585,33,1067,18,1703
5338,568,33,1067,18,1686
5339,550,33,1067,18,1668
5340,535,33,1067,18,1653
5341,519,33,1067,18,1637
5342,500,33,1067,18,1618
5343,483,33,1067,18,1601
5346,433,33,1067,18,1551
5347,419,33,1067,18,1537
5348,400,33,1067,18,1518
5349,383,33,1067,18,1501
5350,366,33,1067,18,1484
5351,349,33,1067,18,1467
5353,317,33,1067,18,1435
5355,400,18,966,18,1402
5357,365,18,966,18,1367
5358,349,18,966,18,1351
5359,334,18,966,18,1336
5361,300,18,966,18,1302
5362,284,18,966,18,1286
5364,249,18,966,18,1251
5366,217,18,966,18,1219
5367,200,18,966,18,1202
5368,182,18,966,18,1184
5369,167,18,966,18,1169
5371,133,18,966,18,1135
5372,116,18,966,18,1118
5374,83,18,966,18,1085
5375,67,18,966,18,1069
5378,17,18,966,18,1019
5380,148,16,802,18,984
5382,115,16,802,18,951
5385,67,16,802,18,903
5387,103,15,734,18,870
5388,86,15,734,18,853
5389,84,34,700,18,836
5390,68,34,700,18,820
5393,33,16,700,18,767
5394,34,34,666,18,752
5395,98,16,602,18,734
5397,66,16,602,18,702
5400,18,16,602,18,654
5401,16,36,566,18,636
5402,36,31,535,18,620
5403,251,35,299,18,603
5406,201,35,299,18,553
5407,184,35,299,18,536
5408,168,35,299,18,520
5411,117,35,299,18,469
5412,99,35,299,18,451
5413,84,35,299,18,436
5415,50,35,299,18,402
5416,34,35,299,18,386
5417,17,35,299,18,369
5418,85,14,235,18,352
5419,68,14,235,18,335
5421,82,34,167,18,301
5422,84,17,167,18,286
5425,34,17,167,18,236
5426,17,17,167,18,219
5427,34,17,133,18,202
5428,83,15,69,18,185
5429,66,15,69,18,168
5431,32,15,69,18,134
5432,31,34,35,18,118
5433,84,32,400,18,534
5434,69,32,400,18,519
5435,49,32,400,18,499
5436,35,32,400,18,485
5438,32,37,363,18,450
5440,84,17,299,18,418
5442,47,17,299,18,381
5444,18,17,299,18,352
5447,36,14,234,18,302
5448,19,14,234,18,285
5449,149,32,67,18,266
5450,135,32,67,18,252
5451,118,32,67,18,235
5453,82,32,67,18,199
5454,67,32,67,18,184
5455,50,32,67,18,167
5456,35,32,67,18,152
5457,18,32,67,18,135
5458,32,35,32,18,117
5459,15,35,32,18,100
5460,150,17,34,16,217
5461,132,17,34,16,199
5462,115,17,34,16,182
5464,83,17,34,16,150
5465,65,17,34,16,132
5466,50,17,34,16,117
5467,49,34,16,17,116
5468,33,34,16,17,100
5469,17,34,16,17,84
5470,34,33,16,19,102
5473,0,17,16,19,52
5474,35,33,83,17,168
5476,33,32,51,17,133
5479,17,33,216,19,285
5480,16,17,216,19,268
5481,35,17,181,19,252
5482,18,17,181,19,235
5483,82,33,83,19,217
5486,33,33,83,19,168
5487,14,33,83,19,149
5488,19,14,83,19,135
5489,49,34,49,18,150
5490,35,34,49,18,136
5492,15,19,49,18,101
5493,33,19,16,18,86
5494,14,19,16,18,67
5495,35,18,15,17,85
5497,33,17,17,16,83
5498,15,17,17,16,65
5499,184,33,150,16,383
5500,167,33,150,16,366
5501,199,18,116,16,349
5502,183,18,116,16,333
5504,149,18,116,16,299
5505,133,18,116,16,283
5506,115,18,116,16,265
5508,82,18,116,16,232
5509,66,18,116,16,216
5512,16,18,116,16,166
5513,84,34,16,16,150
5516,85,16,17,16,134
5519,33,16,17,16,82
5521,16,33,37,29,115
5522,0,33,37,29,99
5523,82,34,17,16,149
5524,66,34,17,16,133
5525,167,18,48,18,251
5528,118,18,48,18,202
5531,67,18,48,18,151
5534,17,18,48,18,101
5537,151,34,214,17,416
5538,151,17,214,17,399
5539,135,17,214,17,383
5541,102,17,214,17,350
5543,68,17,214,17,316
5544,82,18,182,17,299
5545,251,32,17,16,316
5546,233,32,17,16,298
5547,216,32,17,16,281
5548,199,32,17,16,264
5549,185,32,17,16,250
5550,167,32,17,16,232
5551,151,32,17,16,216
5553,117,32,17,16,182
5554,101,32,17,16,166
5555,84,32,17,16,149
5556,67,32,17,16,132
5557,49,32,17,16,114
5558,34,32,17,16,99
5561,17,33,34,18,102
5563,83,34,49,18,184
5564,83,18,49,18,168
5565,281,34,84,16,415
5567,248,34,84,16,382
5568,452,16,17,17,502
5569,436,16,17,17,486
5571,402,16,17,17,452
5572,385,16,17,17,435
5573,369,16,17,17,419
5574,351,16,17,17,401
5577,297,16,17,17,347
5578,285,16,17,17,335
5580,519,15,84,16,634
5582,486,15,84,16,601
5584,452,15,84,16,567
5587,400,15,84,16,515
5588,385,15,84,16,500
5589,368,15,84,16,483
5590,352,15,84,16,467
5593,302,15,84,16,417
5594,285,15,84,16,400
5595,267,15,84,16,382
5599,202,15,84,16,317
5600,186,15,84,16,301
5601,168,15,84,16,283
5602,152,15,84,16,267
5604,118,15,84,16,233
5605,148,35,49,16,248
5608,96,35,49,16,196
5610,66,35,49,16,166
5611,48,35,49,16,148
5613,16,35,49,16,116
5614,35,32,33,17,117
5615,18,32,33,17,100
5618,0,33,34,18,85
5620,17,17,249,17,300
5621,83,35,249,17,384
5622,83,18,249,17,367
5623,65,18,249,17,349
5625,34,18,249,17,318
5626,17,18,249,17,301
5629,16,33,183,17,249
5630,33,33,150,17,233
5631,149,34,217,17,417
5632,132,34,217,17,400
5633,116,34,217,17,384
5635,82,34,217,17,350
5637,84,34,183,17,318
5638,67,34,183,17,301
5640,488,14,16,15,533
5641,470,14,16,15,515
5642,454,14,16,15,499
5643,437,14,16,15,482
5644,420,14,16,15,465
5645,403,14,16,15,448
5646,386,14,16,15,431
5648,354,14,16,15,399
5652,288,14,16,15,333
5653,270,14,16,15,315
5654,253,14,16,15,298
5655,237,14,16,15,282
5657,203,14,16,15,248
5658,187,14,16,15,232
5661,138,14,16,15,183
5663,104,14,16,15,149
5664,86,14,16,15,131
5665,115,36,34,15,200
5666,98,36,34,15,183
5667,81,36,34,15,166
5668,66,36,34,15,151
5669,81,34,33,15,163
5671,332,17,83,17,449
5672,317,17,83,17,434
5673,298,17,83,17,415
5675,266,17,83,17,383
5677,232,17,83,17,349
5678,214,17,83,17,331
5679,199,17,83,17,316
5680,183,17,83,17,300
5681,165,17,83,17,282
5682,149,17,83,17,266
5684,116,17,83,17,233
5686,83,17,83,17,200
5687,66,17,83,17,183
5689,32,17,83,17,149
5690,17,17,83,17,134
5691,85,32,18,17,152
5693,51,32,18,17,118
5695,17,32,18,17,84
5697,85,34,149,16,284
5698,150,16,117,19,302
5699,132,16,117,19,284
5700,166,33,82,17,298
5703,116,33,82,17,248
5704,99,33,82,17,231
5705,83,33,82,17,215
5706,66,33,82,17,198
5707,317,34,32,18,401
5708,301,34,32,18,385
5709,283,34,32,18,367
5710,266,34,32,18,350
5712,233,34,32,18,317
5713,216,34,32,18,300
5715,184,34,32,18,268
5716,165,34,32,18,249
5717,151,34,32,18,235
5719,118,34,32,18,202
5721,368,16,85,16,485
5722,351,16,85,16,468
5723,335,16,85,16,452
5724,318,16,85,16,435
5729,234,16,85,16,351
5731,200,16,85,16,317
5732,184,16,85,16,301
5733,170,16,85,16,287
5736,118,16,85,16,235
5737,117,34,51,16,218
5738,100,34,51,16,201
5739,84,34,51,16,185
5741,48,34,51,16,149
5742,233,35,47,18,333
5743,216,35,47,18,316
5744,200,35,47,18,300
5746,699,33,217,18,967
5748,666,33,217,18,934
5751,617,33,217,18,885
5752,600,33,217,18,868
5753,582,33,217,18,850
5755,549,33,217,18,817
5756,533,33,217,18,801
5757,515,33,217,18,783
5758,498,33,217,18,766
5759,483,33,217,18,751
5760,467,33,217,18,735
5763,416,33,217,18,684
5765,384,33,217,18,652
5766,369,33,217,18,637
5767,349,33,217,18,617
5768,332,33,217,18,600
5769,315,33,217,18,583
5770,300,33,217,18,568
5773,249,33,217,18,517
5774,232,33,217,18,500
5778,166,33,217,18,434
5783,84,33,217,18,352
5784,67,33,217,18,335
5785,48,33,217,18,316
5786,315,18,1367,17,1717
5787,300,18,1367,17,1702
5788,283,18,1367,17,1685
5789,266,18,1367,17,1668
5791,232,18,1367,17,1634
5792,215,18,1367,17,1617
5793,200,18,1367,17,1602
5794,182,18,1367,17,1584
5795,166,18,1367,17,1568
5796,146,18,1367,17,1548
5797,131,18,1367,17,1533
5798,117,18,1367,17,1519
5799,98,18,1367,17,1500
5800,83,18,1367,17,1485
5801,66,18,1367,17,1468
5802,85,16,1334,17,1452
5803,68,16,1334,17,1435
5804,50,16,1334,17,1417
5805,83,34,1268,17,1402
5806,65,34,1268,17,1384
5807,48,34,1268,17,1367
5808,83,18,1233,17,1351
5809,148,35,1134,17,1334
5811,114,35,1134,17,1300
5813,82,35,1134,17,1268
5816,32,35,1134,17,1218
5817,32,18,1134,17,1201
5818,35,34,1100,17,1186
5819,18,34,1100,17,1169
5820,17,17,1100,17,1151
5821,33,17,1067,17,1134
5823,17,33,1034,17,1101
5824,33,34,1000,17,1084
5826,0,34,1000,17,1051
5827,18,32,968,17,1035
5828,19,13,968,17,1017
5829,13,33,935,17,998
5830,33,52,883,17,985
5831,83,35,832,17,967
5832,68,35,832,17,952
5834,168,33,701,17,919
5835,149,33,701,17,900
5836,133,33,701,17,884
5840,83,17,701,17,818
5842,50,17,701,17,785
5843,31,17,701,17,766
5844,249,17,553,15,834
5845,233,17,553,15,818
5846,233,34,519,15,801
5848,199,34,519,15,767
5849,183,34,519,15,751
5850,166,34,519,15,734
5854,98,34,519,15,666
5856,164,35,419,15,633
5857,149,35,419,15,618
5858,130,35,419,15,599
5859,116,35,419,15,585
5860,99,35,419,15,568
5861,82,35,419,15,551
5862,168,32,319,15,534
5863,151,32,319,15,517
5864,134,32,319,15,500
5865,119,32,319,15,485
5866,103,32,319,15,469
5867,85,32,319,15,451
5868,68,32,319,15,434
5869,50,32,319,15,416
5870,34,32,319,15,400
5871,19,32,319,15,385
5872,82,17,252,15,366
5874,100,34,185,15,334
5875,83,34,185,15,317
5876,67,34,185,15,301
5877,50,34,185,15,284
5880,17,17,185,15,234
5881,32,17,153,15,217
5882,83,17,85,15,200
5883,68,17,85,15,185
5884,85,15,53,15,168
5885,82,34,84,17,217
5886,67,34,84,17,202
5888,32,34,84,17,167
5889,83,33,182,17,315
5890,68,33,182,17,300
5891,84,34,148,17,283
5892,67,34,148,17,266
5893,48,34,148,17,247
5894,33,34,148,17,232
5896,34,33,115,17,199
5897,17,33,115,17,182
5898,14,19,115,17,165
5899,36,16,82,17,151
5900,17,16,82,17,132
5901,115,34,17,17,183
5902,99,34,17,17,167
5903,81,34,17,17,149
5904,66,34,17,17,134
5905,50,34,17,17,118
5906,85,17,16,16,134
5907,68,17,16,16,117
5909,33,17,16,16,82
5910,17,17,16,16,66
5911,33,16,217,16,282
5912,16,16,217,16,265
5914,17,17,183,16,233
5918,33,34,282,17,366
5919,134,16,183,17,350
5920,117,16,183,17,333
5922,83,16,183,17,299
5923,67,16,183,17,283
5924,45,16,183,17,261
5926,17,16,183,17,233
5927,16,34,149,17,216
5928,34,35,148,33,250
5930,35,33,215,18,301
5931,18,33,215,18,284
5935,18,33,148,18,217
5936,33,31,117,18,199
5937,18,31,117,18,184
5938,148,18,235,15,416
5941,100,18,235,15,368
5942,84,18,235,15,352
5945,33,18,235,15,301
5946,16,18,235,15,284
5947,35,18,200,15,268
5948,17,18,200,15,250
5949,82,34,102,15,233
5951,51,34,102,15,202
5952,34,34,102,15,185
5953,16,34,102,15,167
5954,136,32,150,16,334
5956,102,32,150,16,300
5957,83,32,150,16,281
5959,54,32,150,16,252
5960,35,32,150,16,233
5961,33,17,150,16,216
5962,82,15,85,16,198
5963,67,15,85,16,183
5964,50,15,85,16,166
5967,33,17,50,16,116
5970,15,17,34,16,82
5971,35,16,83,18,152
5973,83,34,16,17,150
5974,297,18,101,17,433
5976,264,18,101,17,400
5978,230,18,101,17,366
5979,214,18,101,17,350
5980,196,18,101,17,332
5981,180,18,101,17,316
5982,163,18,101,17,299
5983,148,18,101,17,284
5985,113,18,101,17,249
5986,134,34,49,17,234
5987,117,34,49,17,217
5988,99,34,49,17,199
5989,84,34,49,17,184
5990,67,34,49,17,167
5992,36,34,49,17,136
5993,18,34,49,17,118
5994,34,32,34,16,116
5995,17,32,34,16,99
5996,15,17,34,16,82
5997,34,17,16,16,83
